Exporter,Lotid,Date,Movement,Quantity,Inventory Balance,Days In Inventory,Variety,Packaging Style
AGL,BEAU9705215,12/30/2023,Entry,1600.0,1600.0,0,ALLISON,Clam
AGL,BEAU9705215,01/09/2024,Sale,-400.0,1200.0,10,ALLISON,Clam
AGL,BEAU9705215,01/09/2024,Sale,-720.0,480.0,10,ALLISON,Clam
AGL,BEAU9705215,01/13/2024,Sale,-480.0,0.0,14,ALLISON,Clam
AGL,BEAU9705637,12/27/2023,Entry,1600.0,1600.0,0,ALLISON,Clam
AGL,BEAU9705637,01/09/2024,Sale,-480.0,1120.0,13,ALLISON,Clam
AGL,BEAU9705637,01/09/2024,Sale,-1120.0,0.0,13,ALLISON,Clam
AGL,BEAU9708195,01/15/2024,Entry,1600.0,1600.0,0,ALLISON,Clam
AGL,BEAU9708195,01/24/2024,Sale,-1200.0,400.0,9,ALLISON,Clam
AGL,BEAU9708195,01/24/2024,Sale,-400.0,0.0,9,ALLISON,Clam
AGL,BEAU9710607,02/04/2024,Entry,1900.0,1900.0,0,SWEET GLOBE,Bag
AGL,BEAU9710607,02/16/2024,Sale,-1900.0,0.0,12,SWEET GLOBE,Bag
AGL,BEAU9719420,01/24/2024,Sale,-190.0,-190.0,0,SWEET GLOBE,Bag
AGL,BEAU9719420,01/25/2024,Sale,-760.0,-950.0,1,SWEET GLOBE,Bag
AGL,BEAU9719420,01/26/2024,Sale,-665.0,-1615.0,2,SWEET GLOBE,Bag
AGL,BEAU9719420,01/28/2024,Entry,1900.0,285.0,4,SWEET GLOBE,Bag
AGL,BEAU9719420,01/31/2024,Sale,-285.0,0.0,7,SWEET GLOBE,Bag
AGL,BMOU9274067,01/23/2024,Entry,1600.0,1600.0,0,TIMCO,Clam
AGL,BMOU9274067,02/02/2024,Sale,-320.0,1280.0,10,TIMCO,Clam
AGL,BMOU9274067,02/03/2024,Sale,-960.0,320.0,11,TIMCO,Clam
AGL,BMOU9274067,02/05/2024,Sale,-320.0,0.0,13,TIMCO,Clam
AGL,BMOU9309899,02/04/2024,Entry,1600.0,1600.0,0,SWEET GLOBE,Clam
AGL,BMOU9309899,02/10/2024,Sale,-160.0,1440.0,6,SWEET GLOBE,Clam
AGL,BMOU9309899,02/10/2024,Sale,-1360.0,80.0,6,SWEET GLOBE,Clam
AGL,BMOU9309899,02/14/2024,Sale,-80.0,0.0,10,SWEET GLOBE,Clam
AGL,BMOU9310230,12/31/2023,Entry,1700.0,1700.0,0,BI-COLOR,Clam
AGL,BMOU9310230,01/10/2024,Sale,-1700.0,0.0,10,BI-COLOR,Clam
AGL,BMOU9883335,12/30/2023,Entry,1600.0,1600.0,0,IVORY,Clam
AGL,BMOU9883335,01/11/2024,Sale,-100.0,1500.0,12,IVORY,Clam
AGL,BMOU9883335,01/12/2024,Sale,-1420.0,80.0,13,IVORY,Clam
AGL,BMOU9883335,01/13/2024,Sale,-80.0,0.0,14,IVORY,Clam
AGL,BMOU9889550,12/30/2023,Entry,1600.0,1600.0,0,IVORY,Clam
AGL,BMOU9889550,01/13/2024,Sale,-100.0,1500.0,14,IVORY,Clam
AGL,BMOU9889550,01/19/2024,Sale,-1500.0,0.0,20,IVORY,Clam
AGL,BMOU9889740,12/30/2023,Entry,1600.0,1600.0,0,ALLISON,Clam
AGL,BMOU9889740,01/02/2024,Sale,-400.0,1200.0,3,ALLISON,Clam
AGL,BMOU9889740,01/04/2024,Sale,-720.0,480.0,5,ALLISON,Clam
AGL,BMOU9889740,01/09/2024,Sale,-480.0,0.0,10,ALLISON,Clam
AGL,BMOU9890648,02/04/2024,Entry,1600.0,1600.0,0,SWEET GLOBE,Clam
AGL,BMOU9890648,02/14/2024,Sale,-1120.0,480.0,10,SWEET GLOBE,Clam
AGL,BMOU9890648,02/14/2024,Sale,-320.0,160.0,10,SWEET GLOBE,Clam
AGL,BMOU9890648,02/17/2024,Sale,-160.0,0.0,13,SWEET GLOBE,Clam
AGL,BMOU9891270,12/30/2023,Entry,1600.0,1600.0,0,IVORY,Clam
AGL,BMOU9891270,01/06/2024,Sale,-1040.0,560.0,7,IVORY,Clam
AGL,BMOU9891270,01/09/2024,Sale,-560.0,0.0,10,IVORY,Clam
AGL,BMOU9891921,12/21/2023,Sale,-800.0,-800.0,0,ALLISON,Clam
AGL,BMOU9891921,12/28/2023,Sale,-640.0,-1440.0,7,ALLISON,Clam
AGL,BMOU9891921,12/28/2023,Sale,-160.0,-1600.0,7,ALLISON,Clam
AGL,BMOU9891921,12/30/2023,Entry,1600.0,0.0,9,ALLISON,Clam
AGL,BMOU9892147,12/28/2023,Sale,-1700.0,-1700.0,0,BI-COLOR,Clam
AGL,BMOU9892147,12/30/2023,Entry,1700.0,0.0,2,BI-COLOR,Clam
AGL,BMOU9892770,02/04/2024,Entry,1600.0,1600.0,0,SWEET GLOBE,Clam
AGL,BMOU9892770,02/14/2024,Sale,-1120.0,480.0,10,SWEET GLOBE,Clam
AGL,BMOU9892770,02/22/2024,Sale,-80.0,400.0,18,SWEET GLOBE,Clam
AGL,BMOU9892770,02/23/2024,Sale,-313.0,87.0,19,SWEET GLOBE,Clam
AGL,BMOU9892980,12/26/2023,Sale,-240.0,-240.0,0,ALLISON,Clam
AGL,BMOU9892980,12/27/2023,Sale,-720.0,-960.0,1,ALLISON,Clam
AGL,BMOU9892980,12/28/2023,Sale,-80.0,-1040.0,2,ALLISON,Clam
AGL,BMOU9892980,12/28/2023,Sale,-560.0,-1600.0,2,ALLISON,Clam
AGL,BMOU9892980,12/30/2023,Entry,1600.0,0.0,4,ALLISON,Clam
AGL,BMOU9893061,01/28/2024,Entry,1600.0,1600.0,0,TIMCO,Clam
AGL,BMOU9893061,02/06/2024,Sale,-1600.0,0.0,9,TIMCO,Clam
AGL,BMOU9893816,02/04/2024,Entry,1600.0,1600.0,0,SWEET GLOBE,Clam
AGL,BMOU9893816,02/16/2024,Sale,-1200.0,400.0,12,SWEET GLOBE,Clam
AGL,BMOU9893816,02/17/2024,Sale,-400.0,0.0,13,SWEET GLOBE,Clam
AGL,CAIU5542270,01/23/2024,Entry,1600.0,1600.0,0,ALLISON,Clam
AGL,CAIU5542270,01/24/2024,Sale,-320.0,1280.0,1,ALLISON,Clam
AGL,CAIU5542270,01/24/2024,Sale,-80.0,1200.0,1,ALLISON,Clam
AGL,CAIU5542270,01/29/2024,Sale,-80.0,1120.0,6,ALLISON,Clam
AGL,CAIU5542270,01/31/2024,Sale,-1040.0,80.0,8,ALLISON,Clam
AGL,CAIU5542270,02/03/2024,Sale,-80.0,0.0,11,ALLISON,Clam
AGL,CAIU5553870,01/20/2024,Sale,-560.0,-560.0,0,SWEET GLOBE,Clam
AGL,CAIU5553870,01/20/2024,Sale,-1040.0,-1600.0,0,SWEET GLOBE,Clam
AGL,CAIU5553870,01/23/2024,Entry,1600.0,0.0,3,SWEET GLOBE,Clam
AGL,CRLU1324216,01/22/2024,Entry,1600.0,1600.0,0,SWEET GLOBE,Clam
AGL,CRLU1324216,02/01/2024,Sale,-720.0,880.0,10,SWEET GLOBE,Clam
AGL,CRLU1324216,02/02/2024,Sale,-560.0,320.0,11,SWEET GLOBE,Clam
AGL,CRLU1324216,02/09/2024,Sale,-320.0,0.0,18,SWEET GLOBE,Clam
AGL,CRSU6064441,12/30/2023,Entry,1600.0,1600.0,0,CANDY DREAMS,Clam
AGL,CRSU6064441,01/20/2024,Sale,-320.0,1280.0,21,CANDY DREAMS,Clam
AGL,CRSU6064441,01/22/2024,Sale,-640.0,640.0,23,CANDY DREAMS,Clam
AGL,CRSU6064441,01/24/2024,Sale,-640.0,0.0,25,CANDY DREAMS,Clam
AGL,CRSU6126939,12/30/2023,Entry,1600.0,1600.0,0,CANDY DREAMS,Clam
AGL,CRSU6126939,01/23/2024,Sale,-800.0,800.0,24,CANDY DREAMS,Clam
AGL,CRSU6126939,01/23/2024,Sale,-240.0,560.0,24,CANDY DREAMS,Clam
AGL,CRSU6126939,01/24/2024,Sale,-560.0,0.0,25,CANDY DREAMS,Clam
AGL,CRXU6955248,01/20/2024,Entry,1600.0,1600.0,0,SWEET FAVORS,Clam
AGL,CRXU6955248,02/14/2024,Sale,-720.0,880.0,25,SWEET FAVORS,Clam
AGL,CRXU6955248,02/14/2024,Sale,-80.0,800.0,25,SWEET FAVORS,Clam
AGL,CRXU6955248,02/15/2024,Sale,-640.0,160.0,26,SWEET FAVORS,Clam
AGL,CRXU6955248,02/17/2024,Sale,-160.0,0.0,28,SWEET FAVORS,Clam
AGL,CTWU1600440,12/28/2023,Sale,-1700.0,-1700.0,0,BI-COLOR,Clam
AGL,CTWU1600440,12/30/2023,Entry,1700.0,0.0,2,BI-COLOR,Clam
AGL,CTWU1600646,12/27/2023,Entry,1600.0,1600.0,0,ALLISON,Clam
AGL,CTWU1600646,01/04/2024,Sale,-720.0,880.0,8,ALLISON,Clam
AGL,CTWU1600646,01/04/2024,Sale,-800.0,80.0,8,ALLISON,Clam
AGL,CTWU1600646,01/08/2024,Sale,-80.0,0.0,12,ALLISON,Clam
AGL,CTWU1601025,12/30/2023,Entry,1600.0,1600.0,0,ALLISON,Clam
AGL,CTWU1601025,01/09/2024,Sale,-320.0,1280.0,10,ALLISON,Clam
AGL,CTWU1601025,01/09/2024,Sale,-320.0,960.0,10,ALLISON,Clam
AGL,CTWU1601025,01/13/2024,Sale,-720.0,240.0,14,ALLISON,Clam
AGL,CTWU1601025,01/15/2024,Sale,-240.0,0.0,16,ALLISON,Clam
AGL,CTWU1601278,12/15/2023,Entry,1600.0,1600.0,0,IVORY,Clam
AGL,CTWU1601278,01/04/2024,Sale,-320.0,1280.0,20,IVORY,Clam
AGL,CTWU1601278,01/06/2024,Sale,-880.0,400.0,22,IVORY,Clam
AGL,CTWU1601278,01/06/2024,Sale,-400.0,0.0,22,IVORY,Clam
AGL,CTWU1601365,12/27/2023,Entry,1600.0,1600.0,0,SWEET GLOBE,Clam
AGL,CTWU1601365,01/09/2024,Sale,-880.0,720.0,13,SWEET GLOBE,Clam
AGL,CTWU1601365,01/10/2024,Sale,-80.0,640.0,14,SWEET GLOBE,Clam
AGL,CTWU1601365,01/11/2024,Sale,-640.0,0.0,15,SWEET GLOBE,Clam
AGL,CTWU1602607,01/15/2024,Entry,1900.0,1900.0,0,SWEET FAVORS,Bag
AGL,CTWU1602607,01/19/2024,Sale,-190.0,1710.0,4,SWEET FAVORS,Bag
AGL,CTWU1602607,01/22/2024,Sale,-95.0,1615.0,7,SWEET FAVORS,Bag
AGL,CTWU1602607,01/22/2024,Sale,-190.0,1425.0,7,SWEET FAVORS,Bag
AGL,CTWU1602607,01/23/2024,Sale,-95.0,1330.0,8,SWEET FAVORS,Bag
AGL,CTWU1602607,01/25/2024,Sale,-95.0,1235.0,10,SWEET FAVORS,Bag
AGL,CTWU1602607,01/25/2024,Sale,-95.0,1140.0,10,SWEET FAVORS,Bag
AGL,CTWU1602607,01/25/2024,Sale,-380.0,760.0,10,SWEET FAVORS,Bag
AGL,CTWU1602607,01/25/2024,Sale,-475.0,285.0,10,SWEET FAVORS,Bag
AGL,CTWU1602607,01/26/2024,Sale,-190.0,95.0,11,SWEET FAVORS,Bag
AGL,CTWU1602607,01/26/2024,Sale,-95.0,0.0,11,SWEET FAVORS,Bag
AGL,CTWU1603162,01/28/2024,Entry,1600.0,1600.0,0,TIMCO,Clam
AGL,CTWU1603162,02/07/2024,Sale,-1200.0,400.0,10,TIMCO,Clam
AGL,CTWU1603162,02/09/2024,Sale,-400.0,0.0,12,TIMCO,Clam
AGL,CXRU1434990,01/23/2024,Entry,1600.0,1600.0,0,CANDY DREAMS,Clam
AGL,CXRU1434990,02/08/2024,Sale,-320.0,1280.0,16,CANDY DREAMS,Clam
AGL,CXRU1434990,02/10/2024,Sale,-240.0,1040.0,18,CANDY DREAMS,Clam
AGL,CXRU1434990,02/12/2024,Sale,-240.0,800.0,20,CANDY DREAMS,Clam
AGL,CXRU1434990,02/12/2024,Sale,-800.0,0.0,20,CANDY DREAMS,Clam
AGL,CXRU1457260,12/30/2023,Entry,1600.0,1600.0,0,IVORY,Clam
AGL,CXRU1457260,12/30/2023,Sale,-320.0,1280.0,0,IVORY,Clam
AGL,CXRU1457260,01/02/2024,Sale,-1280.0,0.0,3,IVORY,Clam
AGL,CXRU1636939,01/19/2024,Sale,-960.0,-960.0,0,SWEET GLOBE,Clam
AGL,CXRU1636939,01/23/2024,Entry,1600.0,640.0,4,SWEET GLOBE,Clam
AGL,CXRU1636939,01/23/2024,Sale,-640.0,0.0,4,SWEET GLOBE,Clam
AGL,EMCU5307609,01/01/2024,Sale,-1600.0,-1600.0,0,SWEET GLOBE,Clam
AGL,EMCU5307609,01/29/2024,Entry,1600.0,0.0,28,SWEET GLOBE,Clam
AGL,EMCU5326234,01/01/2024,Sale,-1600.0,-1600.0,0,SWEET GLOBE,Clam
AGL,EMCU5326234,01/29/2024,Entry,1600.0,0.0,28,SWEET GLOBE,Clam
AGL,EMCU5344285,01/03/2024,Sale,-1600.0,-1600.0,0,SWEET GLOBE,Clam
AGL,EMCU5344285,01/23/2024,Entry,1600.0,0.0,20,SWEET GLOBE,Clam
AGL,EMCU5350842,12/30/2023,Entry,1600.0,1600.0,0,SWEET GLOBE,Clam
AGL,EMCU5350842,01/03/2024,Sale,-1600.0,0.0,4,SWEET GLOBE,Clam
AGL,EMCU5374314,12/14/2023,Sale,-42.0,-42.0,0,SWEET GLOBE,Clam
AGL,EMCU5374314,12/14/2023,Sale,-1520.0,-1562.0,0,SWEET GLOBE,Clam
AGL,EMCU5374314,12/14/2023,Sale,-38.0,-1600.0,0,SWEET GLOBE,Clam
AGL,EMCU5374314,12/30/2023,Entry,1600.0,0.0,16,SWEET GLOBE,Clam
AGL,EMCU5385577,12/14/2023,Sale,-38.0,-38.0,0,SWEET GLOBE,Clam
AGL,EMCU5385577,12/14/2023,Sale,-1520.0,-1558.0,0,SWEET GLOBE,Clam
AGL,EMCU5385577,12/14/2023,Sale,-42.0,-1600.0,0,SWEET GLOBE,Clam
AGL,EMCU5385577,12/30/2023,Entry,1600.0,0.0,16,SWEET GLOBE,Clam
AGL,EMCU5387100,12/14/2023,Sale,-1600.0,-1600.0,0,SWEET GLOBE,Clam
AGL,EMCU5387100,12/30/2023,Entry,1600.0,0.0,16,SWEET GLOBE,Clam
AGL,EMCU5479022,12/21/2023,Sale,-1600.0,-1600.0,0,SWEET GLOBE,Clam
AGL,EMCU5479022,12/30/2023,Entry,1600.0,0.0,9,SWEET GLOBE,Clam
AGL,EMCU5567170,12/21/2023,Sale,-1600.0,-1600.0,0,SWEET GLOBE,Clam
AGL,EMCU5567170,12/30/2023,Entry,1600.0,0.0,9,SWEET GLOBE,Clam
AGL,EMCU5580043,12/21/2023,Sale,-1600.0,-1600.0,0,SWEET GLOBE,Clam
AGL,EMCU5580043,12/30/2023,Entry,1600.0,0.0,9,SWEET GLOBE,Clam
AGL,EMCU5585770,12/21/2023,Sale,-1600.0,-1600.0,0,SWEET GLOBE,Clam
AGL,EMCU5585770,12/30/2023,Entry,1600.0,0.0,9,SWEET GLOBE,Clam
AGL,EMCU5593502,01/01/2024,Sale,-1600.0,-1600.0,0,SWEET FAVORS,Clam
AGL,EMCU5593502,01/30/2024,Entry,1600.0,0.0,29,SWEET FAVORS,Clam
AGL,EMCU5594617,12/21/2023,Sale,-1600.0,-1600.0,0,SWEET GLOBE,Clam
AGL,EMCU5594617,12/30/2023,Entry,1600.0,0.0,9,SWEET GLOBE,Clam
AGL,EMCU5610750,01/01/2024,Sale,-1600.0,-1600.0,0,SWEET FAVORS,Clam
AGL,EMCU5610750,01/30/2024,Entry,1600.0,0.0,29,SWEET FAVORS,Clam
AGL,EMCU5648586,01/03/2024,Sale,-1600.0,-1600.0,0,SWEET GLOBE,Clam
AGL,EMCU5648586,01/23/2024,Entry,1600.0,0.0,20,SWEET GLOBE,Clam
AGL,FSCU5778149,12/30/2023,Entry,1600.0,1600.0,0,IVORY,Clam
AGL,FSCU5778149,12/30/2023,Sale,-1600.0,0.0,0,IVORY,Clam
AGL,FSCU5784368,01/20/2024,Entry,1600.0,1600.0,0,CANDY DREAMS,Clam
AGL,FSCU5784368,02/02/2024,Sale,-320.0,1280.0,13,CANDY DREAMS,Clam
AGL,FSCU5784368,02/05/2024,Sale,-1280.0,0.0,16,CANDY DREAMS,Clam
AGL,HLBU9076418,12/30/2023,Entry,1600.0,1600.0,0,ALLISON,Clam
AGL,HLBU9076418,01/08/2024,Sale,-1120.0,480.0,9,ALLISON,Clam
AGL,HLBU9076418,01/08/2024,Sale,-480.0,0.0,9,ALLISON,Clam
AGL,HLBU9113276,12/15/2023,Entry,1600.0,1600.0,0,CANDY SNAP,Clam
AGL,HLBU9113276,01/04/2024,Sale,-1600.0,0.0,20,CANDY SNAP,Clam
AGL,HLBU9130479,01/22/2024,Entry,1600.0,1600.0,0,ALLISON,Clam
AGL,HLBU9130479,01/27/2024,Sale,-1600.0,0.0,5,ALLISON,Clam
AGL,HLBU9182718,01/22/2024,Entry,1600.0,1600.0,0,SWEET GLOBE,Clam
AGL,HLBU9182718,01/30/2024,Sale,-400.0,1200.0,8,SWEET GLOBE,Clam
AGL,HLBU9182718,01/30/2024,Sale,-640.0,560.0,8,SWEET GLOBE,Clam
AGL,HLBU9182718,01/30/2024,Sale,-560.0,0.0,8,SWEET GLOBE,Clam
AGL,HLBU9458350,12/15/2023,Entry,1600.0,1600.0,0,CANDY SNAP,Clam
AGL,HLBU9458350,01/04/2024,Sale,-1600.0,0.0,20,CANDY SNAP,Clam
AGL,HLBU9534608,01/22/2024,Entry,1600.0,1600.0,0,SWEET GLOBE,Clam
AGL,HLBU9534608,01/29/2024,Sale,-1600.0,0.0,7,SWEET GLOBE,Clam
AGL,HLBU9535688,12/30/2023,Entry,1600.0,1600.0,0,CANDY SNAP,Clam
AGL,HLBU9535688,01/11/2024,Sale,-1600.0,0.0,12,CANDY SNAP,Clam
AGL,HLBU9557244,01/22/2024,Entry,1600.0,1600.0,0,SWEET GLOBE,Clam
AGL,HLBU9557244,01/26/2024,Sale,-80.0,1520.0,4,SWEET GLOBE,Clam
AGL,HLBU9557244,01/29/2024,Sale,-320.0,1200.0,7,SWEET GLOBE,Clam
AGL,HLBU9557244,01/30/2024,Sale,-1200.0,0.0,8,SWEET GLOBE,Clam
AGL,HLBU9607031,01/22/2024,Entry,1600.0,1600.0,0,SWEET GLOBE,Clam
AGL,HLBU9607031,01/30/2024,Sale,-400.0,1200.0,8,SWEET GLOBE,Clam
AGL,HLBU9607031,01/31/2024,Sale,-1200.0,0.0,9,SWEET GLOBE,Clam
AGL,HLBU9730220,12/30/2023,Entry,1600.0,1600.0,0,CANDY SNAP,Clam
AGL,HLBU9730220,01/12/2024,Sale,-1600.0,0.0,13,CANDY SNAP,Clam
AGL,HLBU9770096,12/30/2023,Entry,1600.0,1600.0,0,ALLISON,Clam
AGL,HLBU9770096,01/04/2024,Sale,-1600.0,0.0,5,ALLISON,Clam
AGL,HLBU9847372,12/15/2023,Entry,1600.0,1600.0,0,CANDY SNAP,Clam
AGL,HLBU9847372,01/05/2024,Sale,-1600.0,0.0,21,CANDY SNAP,Clam
AGL,HLBU9866285,12/17/2023,Entry,1600.0,1600.0,0,CANDY SNAP,Clam
AGL,HLBU9866285,01/10/2024,Sale,-1598.0,2.0,24,CANDY SNAP,Clam
AGL,HLBU9889784,01/05/2024,Entry,1600.0,1600.0,0,ALLISON,Clam
AGL,HLBU9889784,01/19/2024,Sale,-400.0,1200.0,14,ALLISON,Clam
AGL,HLBU9889784,01/19/2024,Sale,-480.0,720.0,14,ALLISON,Clam
AGL,HLBU9889784,01/20/2024,Sale,-720.0,0.0,15,ALLISON,Clam
AGL,HLBU9902778,12/15/2023,Entry,1600.0,1600.0,0,CANDY SNAP,Clam
AGL,HLBU9902778,01/04/2024,Sale,-1600.0,0.0,20,CANDY SNAP,Clam
AGL,HLBU9919533,01/22/2024,Entry,1600.0,1600.0,0,ALLISON,Clam
AGL,HLBU9919533,01/29/2024,Sale,-1600.0,0.0,7,ALLISON,Clam
AGL,HLBU9956250,01/05/2024,Entry,1600.0,1600.0,0,ALLISON,Clam
AGL,HLBU9956250,01/20/2024,Sale,-720.0,880.0,15,ALLISON,Clam
AGL,HLBU9956250,01/20/2024,Sale,-880.0,0.0,15,ALLISON,Clam
AGL,HLBU9962571,12/30/2023,Entry,1600.0,1600.0,0,CANDY DREAMS,Clam
AGL,HLBU9962571,01/23/2024,Sale,-800.0,800.0,24,CANDY DREAMS,Clam
AGL,HLBU9962571,01/23/2024,Sale,-560.0,240.0,24,CANDY DREAMS,Clam
AGL,HLBU9962571,01/27/2024,Sale,-240.0,0.0,28,CANDY DREAMS,Clam
AGL,HLBU9967568,01/05/2024,Entry,1600.0,1600.0,0,ALLISON,Clam
AGL,HLBU9967568,01/20/2024,Sale,-880.0,720.0,15,ALLISON,Clam
AGL,HLBU9967568,01/22/2024,Sale,-720.0,0.0,17,ALLISON,Clam
AGL,HLBU9971681,12/15/2023,Entry,1600.0,1600.0,0,CANDY SNAP,Clam
AGL,HLBU9971681,01/05/2024,Sale,-1600.0,0.0,21,CANDY SNAP,Clam
AGL,HLBU9972219,12/30/2023,Entry,1600.0,1600.0,0,ALLISON,Clam
AGL,HLBU9972219,01/19/2024,Sale,-1520.0,80.0,20,ALLISON,Clam
AGL,HLBU9972219,01/19/2024,Sale,-80.0,0.0,20,ALLISON,Clam
AGL,HLBU9977490,01/04/2024,Entry,1600.0,1600.0,0,CANDY DREAMS,Clam
AGL,HLBU9977490,01/30/2024,Sale,-1200.0,400.0,26,CANDY DREAMS,Clam
AGL,HLBU9977490,02/02/2024,Sale,-400.0,0.0,29,CANDY DREAMS,Clam
AGL,MEDU9009491,01/20/2024,Entry,1600.0,1600.0,0,SWEET GLOBE,Clam
AGL,MEDU9009491,01/25/2024,Sale,-560.0,1040.0,5,SWEET GLOBE,Clam
AGL,MEDU9009491,01/26/2024,Sale,-1040.0,0.0,6,SWEET GLOBE,Clam
AGL,MEDU9622749,12/30/2023,Entry,1600.0,1600.0,0,CANDY DREAMS,Clam
AGL,MEDU9622749,02/01/2024,Sale,-480.0,1120.0,33,CANDY DREAMS,Clam
AGL,MEDU9622749,02/02/2024,Sale,-720.0,400.0,34,CANDY DREAMS,Clam
AGL,MEDU9622749,02/05/2024,Sale,-80.0,320.0,37,CANDY DREAMS,Clam
AGL,MEDU9622749,02/08/2024,Sale,-320.0,0.0,40,CANDY DREAMS,Clam
AGL,MEDU9729280,01/20/2024,Entry,1600.0,1600.0,0,SWEET GLOBE,Clam
AGL,MEDU9729280,01/25/2024,Sale,-400.0,1200.0,5,SWEET GLOBE,Clam
AGL,MEDU9729280,01/25/2024,Sale,-80.0,1120.0,5,SWEET GLOBE,Clam
AGL,MEDU9729280,01/25/2024,Sale,-1120.0,0.0,5,SWEET GLOBE,Clam
AGL,MEDU9786779,01/20/2024,Entry,1600.0,1600.0,0,ALLISON,Clam
AGL,MEDU9786779,01/20/2024,Sale,-1600.0,0.0,0,ALLISON,Clam
AGL,MEDU9805420,12/30/2023,Entry,1600.0,1600.0,0,CANDY SNAP,Clam
AGL,MEDU9805420,01/02/2024,Sale,-1600.0,0.0,3,CANDY SNAP,Clam
AGL,MEDU9807188,01/20/2024,Entry,1600.0,1600.0,0,ALLISON,Clam
AGL,MEDU9807188,01/25/2024,Sale,-960.0,640.0,5,ALLISON,Clam
AGL,MEDU9807188,01/30/2024,Sale,-400.0,240.0,10,ALLISON,Clam
AGL,MEDU9807188,02/03/2024,Sale,-240.0,0.0,14,ALLISON,Clam
AGL,MMAU1269107,01/30/2024,Entry,1600.0,1600.0,0,CANDY DREAMS,Clam
AGL,MMAU1269107,02/14/2024,Sale,-160.0,1440.0,15,CANDY DREAMS,Clam
AGL,MMAU1269107,02/17/2024,Sale,-160.0,1280.0,18,CANDY DREAMS,Clam
AGL,MMAU1269107,02/17/2024,Sale,-240.0,1040.0,18,CANDY DREAMS,Clam
AGL,MMAU1269107,02/19/2024,Sale,-160.0,880.0,20,CANDY DREAMS,Clam
AGL,MMAU1269107,02/19/2024,Sale,-320.0,560.0,20,CANDY DREAMS,Clam
AGL,MMAU1269107,02/19/2024,Sale,-320.0,240.0,20,CANDY DREAMS,Clam
AGL,MMAU1269107,02/19/2024,Sale,-160.0,80.0,20,CANDY DREAMS,Clam
AGL,MMAU1303650,12/30/2023,Entry,1800.0,1800.0,0,ALLISON,Bag
AGL,MMAU1303650,01/16/2024,Sale,-1260.0,540.0,17,ALLISON,Bag
AGL,MMAU1303650,01/16/2024,Sale,-90.0,450.0,17,ALLISON,Bag
AGL,MMAU1303650,01/17/2024,Sale,-450.0,0.0,18,ALLISON,Bag
AGL,MMAU1304002,12/30/2023,Entry,1800.0,1800.0,0,ALLISON,Bag
AGL,MMAU1304002,01/16/2024,Sale,-1260.0,540.0,17,ALLISON,Bag
AGL,MMAU1304002,01/16/2024,Sale,-540.0,0.0,17,ALLISON,Bag
AGL,MMAU1311001,12/30/2023,Entry,1600.0,1600.0,0,ALLISON,Clam
AGL,MMAU1311001,01/15/2024,Sale,-800.0,800.0,16,ALLISON,Clam
AGL,MMAU1311001,01/16/2024,Sale,-800.0,0.0,17,ALLISON,Clam
AGL,MMAU1367680,12/30/2023,Entry,1600.0,1600.0,0,ALLISON,Clam
AGL,MMAU1367680,01/16/2024,Sale,-800.0,800.0,17,ALLISON,Clam
AGL,MMAU1367680,01/17/2024,Sale,-640.0,160.0,18,ALLISON,Clam
AGL,MMAU1367680,01/19/2024,Sale,-160.0,0.0,20,ALLISON,Clam
AGL,MMAU1373580,12/30/2023,Entry,1600.0,1600.0,0,ALLISON,Clam
AGL,MMAU1373580,01/15/2024,Sale,-1600.0,0.0,16,ALLISON,Clam
AGL,MMAU1440884,01/23/2024,Entry,1600.0,1600.0,0,SWEET GLOBE,Clam
AGL,MMAU1440884,02/05/2024,Sale,-800.0,800.0,13,SWEET GLOBE,Clam
AGL,MMAU1440884,02/05/2024,Sale,-800.0,0.0,13,SWEET GLOBE,Clam
AGL,MNBU0004376,02/06/2024,Entry,1600.0,1600.0,0,SWEET GLOBE,Clam
AGL,MNBU0004376,02/29/2024,Sale,-800.0,800.0,23,SWEET GLOBE,Clam
AGL,MNBU0004376,02/29/2024,Sale,-800.0,0.0,23,SWEET GLOBE,Clam
AGL,MNBU0069989,01/23/2024,Entry,1600.0,1600.0,0,SWEET GLOBE,Clam
AGL,MNBU0069989,02/03/2024,Sale,-800.0,800.0,11,SWEET GLOBE,Clam
AGL,MNBU0069989,02/03/2024,Sale,-800.0,0.0,11,SWEET GLOBE,Clam
AGL,MNBU0100873,12/30/2023,Entry,1600.0,1600.0,0,ALLISON,Clam
AGL,MNBU0100873,02/23/2024,Sale,-1460.0,140.0,55,ALLISON,Clam
AGL,MNBU0142570,01/28/2024,Entry,1600.0,1600.0,0,CANDY DREAMS,Clam
AGL,MNBU0142570,02/13/2024,Sale,-480.0,1120.0,16,CANDY DREAMS,Clam
AGL,MNBU0142570,02/13/2024,Sale,-480.0,640.0,16,CANDY DREAMS,Clam
AGL,MNBU0142570,02/14/2024,Sale,-640.0,0.0,17,CANDY DREAMS,Clam
AGL,MNBU0191512,12/30/2023,Entry,1600.0,1600.0,0,CANDY DREAMS,Clam
AGL,MNBU0191512,01/20/2024,Sale,-1600.0,0.0,21,CANDY DREAMS,Clam
AGL,MNBU0213231,01/08/2024,Entry,1600.0,1600.0,0,SWEET GLOBE,Clam
AGL,MNBU0213231,01/23/2024,Sale,-80.0,1520.0,15,SWEET GLOBE,Clam
AGL,MNBU0213231,01/24/2024,Sale,-1520.0,0.0,16,SWEET GLOBE,Clam
AGL,MNBU0219380,01/22/2024,Entry,1600.0,1600.0,0,SWEET GLOBE,Clam
AGL,MNBU0219380,01/31/2024,Sale,-400.0,1200.0,9,SWEET GLOBE,Clam
AGL,MNBU0219380,01/31/2024,Sale,-1200.0,0.0,9,SWEET GLOBE,Clam
AGL,MNBU0249065,01/23/2024,Entry,1600.0,1600.0,0,SWEET FAVORS,Clam
AGL,MNBU0249065,02/17/2024,Sale,-320.0,1280.0,25,SWEET FAVORS,Clam
AGL,MNBU0249065,02/17/2024,Sale,-560.0,720.0,25,SWEET FAVORS,Clam
AGL,MNBU0249065,02/17/2024,Sale,-720.0,0.0,25,SWEET FAVORS,Clam
AGL,MNBU0251714,01/30/2024,Entry,240.0,240.0,0,SWEET GLOBE,Clam
AGL,MNBU0251714,01/30/2024,Entry,1360.0,1600.0,0,TIMCO,Clam
AGL,MNBU0251714,02/13/2024,Sale,-240.0,1360.0,14,SWEET GLOBE,Clam
AGL,MNBU0251714,02/17/2024,Sale,-960.0,400.0,18,TIMCO,Clam
AGL,MNBU0251714,02/19/2024,Sale,-398.0,2.0,20,TIMCO,Clam
AGL,MNBU0274406,01/08/2024,Entry,1600.0,1600.0,0,SWEET GLOBE,Clam
AGL,MNBU0274406,01/23/2024,Sale,-1520.0,80.0,15,SWEET GLOBE,Clam
AGL,MNBU0274406,01/26/2024,Sale,-77.0,3.0,18,SWEET GLOBE,Clam
AGL,MNBU0304183,12/30/2023,Entry,1805.0,1805.0,0,ALLISON,Bag
AGL,MNBU0304183,12/30/2023,Entry,95.0,1900.0,0,TIMCO,Bag
AGL,MNBU0304183,01/23/2024,Sale,-475.0,1425.0,24,ALLISON,Bag
AGL,MNBU0304183,01/23/2024,Sale,-1140.0,285.0,24,ALLISON,Bag
AGL,MNBU0304183,01/25/2024,Sale,-190.0,95.0,26,ALLISON,Bag
AGL,MNBU0304183,01/29/2024,Sale,-95.0,0.0,30,TIMCO,Bag
AGL,MNBU0306993,01/30/2024,Entry,1600.0,1600.0,0,TIMCO,Clam
AGL,MNBU0306993,02/12/2024,Sale,-640.0,960.0,13,TIMCO,Clam
AGL,MNBU0306993,02/13/2024,Sale,-960.0,0.0,14,TIMCO,Clam
AGL,MNBU0307599,02/06/2024,Entry,1600.0,1600.0,0,SWEET GLOBE,Clam
AGL,MNBU0307599,02/28/2024,Sale,-1600.0,0.0,22,SWEET GLOBE,Clam
AGL,MNBU0356551,12/30/2023,Entry,1800.0,1800.0,0,TIMCO,Bag
AGL,MNBU0356551,01/23/2024,Sale,-1440.0,360.0,24,TIMCO,Bag
AGL,MNBU0356551,01/23/2024,Sale,-180.0,180.0,24,TIMCO,Bag
AGL,MNBU0356551,01/23/2024,Sale,-180.0,0.0,24,TIMCO,Bag
AGL,MNBU0377359,01/23/2024,Entry,1600.0,1600.0,0,SWEET GLOBE,Clam
AGL,MNBU0377359,02/06/2024,Sale,-1600.0,0.0,14,SWEET GLOBE,Clam
AGL,MNBU0509033,01/08/2024,Entry,1800.0,1800.0,0,TIMCO,Bag
AGL,MNBU0509033,01/22/2024,Sale,-1800.0,0.0,14,TIMCO,Bag
AGL,MNBU0530920,01/30/2024,Entry,1600.0,1600.0,0,SWEET GLOBE,Clam
AGL,MNBU0530920,02/13/2024,Sale,-1600.0,0.0,14,SWEET GLOBE,Clam
AGL,MNBU0541040,01/08/2024,Entry,1600.0,1600.0,0,SWEET GLOBE,Clam
AGL,MNBU0541040,01/24/2024,Sale,-80.0,1520.0,16,SWEET GLOBE,Clam
AGL,MNBU0541040,01/24/2024,Sale,-1520.0,0.0,16,SWEET GLOBE,Clam
AGL,MNBU0547579,01/30/2024,Entry,1600.0,1600.0,0,SWEET GLOBE,Clam
AGL,MNBU0547579,02/08/2024,Sale,-80.0,1520.0,9,SWEET GLOBE,Clam
AGL,MNBU0547579,02/09/2024,Sale,-640.0,880.0,10,SWEET GLOBE,Clam
AGL,MNBU0547579,02/10/2024,Sale,-880.0,0.0,11,SWEET GLOBE,Clam
AGL,MNBU0573726,01/22/2024,Entry,1600.0,1600.0,0,SWEET GLOBE,Clam
AGL,MNBU0573726,01/26/2024,Sale,-80.0,1520.0,4,SWEET GLOBE,Clam
AGL,MNBU0573726,01/26/2024,Sale,-1520.0,0.0,4,SWEET GLOBE,Clam
AGL,MNBU0590472,02/06/2024,Entry,1600.0,1600.0,0,SWEET GLOBE,Clam
AGL,MNBU0590472,02/19/2024,Sale,-1600.0,0.0,13,SWEET GLOBE,Clam
AGL,MNBU0591870,02/06/2024,Entry,1140.0,1140.0,0,SWEET GLOBE,Bag
AGL,MNBU0591870,02/06/2024,Entry,380.0,1520.0,0,SWEET GLOBE,Bag
AGL,MNBU0591870,02/06/2024,Entry,380.0,1900.0,0,SWEET GLOBE,Bag
AGL,MNBU0591870,02/24/2024,Sale,-285.0,1615.0,18,SWEET GLOBE,Bag
AGL,MNBU0591870,02/24/2024,Sale,-375.0,1240.0,18,SWEET GLOBE,Bag
AGL,MNBU0591870,02/26/2024,Sale,-760.0,480.0,20,SWEET GLOBE,Bag
AGL,MNBU0591870,02/28/2024,Sale,-190.0,290.0,22,SWEET GLOBE,Bag
AGL,MNBU0591870,02/29/2024,Sale,-190.0,100.0,23,SWEET GLOBE,Bag
AGL,MNBU0591870,02/29/2024,Sale,-91.0,9.0,23,SWEET GLOBE,Bag
AGL,MNBU0599090,01/23/2024,Entry,1600.0,1600.0,0,SWEET GLOBE,Clam
AGL,MNBU0599090,02/07/2024,Sale,-1280.0,320.0,15,SWEET GLOBE,Clam
AGL,MNBU0599090,02/07/2024,Sale,-320.0,0.0,15,SWEET GLOBE,Clam
AGL,MNBU0603121,12/30/2023,Entry,1600.0,1600.0,0,CANDY SNAP,Clam
AGL,MNBU0603121,01/16/2024,Sale,-1600.0,0.0,17,CANDY SNAP,Clam
AGL,MNBU0615755,01/23/2024,Entry,1600.0,1600.0,0,SWEET GLOBE,Clam
AGL,MNBU0615755,02/03/2024,Sale,-800.0,800.0,11,SWEET GLOBE,Clam
AGL,MNBU0615755,02/03/2024,Sale,-800.0,0.0,11,SWEET GLOBE,Clam
AGL,MNBU0624633,01/22/2024,Entry,800.0,800.0,0,ALLISON,Clam
AGL,MNBU0624633,01/22/2024,Entry,800.0,1600.0,0,TIMCO,Clam
AGL,MNBU0624633,01/30/2024,Sale,-800.0,800.0,8,ALLISON,Clam
AGL,MNBU0624633,01/30/2024,Sale,-800.0,0.0,8,TIMCO,Clam
AGL,MNBU3014280,01/23/2024,Entry,1600.0,1600.0,0,SWEET GLOBE,Clam
AGL,MNBU3014280,02/05/2024,Sale,-1600.0,0.0,13,SWEET GLOBE,Clam
AGL,MNBU3102890,12/30/2023,Entry,1600.0,1600.0,0,SWEET GLOBE,Clam
AGL,MNBU3102890,01/19/2024,Sale,-1600.0,0.0,20,SWEET GLOBE,Clam
AGL,MNBU3161255,01/22/2024,Entry,1600.0,1600.0,0,CANDY DREAMS,Clam
AGL,MNBU3161255,02/06/2024,Sale,-240.0,1360.0,15,CANDY DREAMS,Clam
AGL,MNBU3161255,02/08/2024,Sale,-960.0,400.0,17,CANDY DREAMS,Clam
AGL,MNBU3161255,02/08/2024,Sale,-240.0,160.0,17,CANDY DREAMS,Clam
AGL,MNBU3161255,02/09/2024,Sale,-160.0,0.0,18,CANDY DREAMS,Clam
AGL,MNBU3224625,01/22/2024,Entry,1600.0,1600.0,0,ALLISON,Clam
AGL,MNBU3224625,01/30/2024,Sale,-320.0,1280.0,8,ALLISON,Clam
AGL,MNBU3224625,01/30/2024,Sale,-1280.0,0.0,8,ALLISON,Clam
AGL,MNBU3315448,01/30/2024,Entry,1600.0,1600.0,0,SWEET GLOBE,Clam
AGL,MNBU3315448,02/09/2024,Sale,-1600.0,0.0,10,SWEET GLOBE,Clam
AGL,MNBU3340760,01/30/2024,Entry,1600.0,1600.0,0,SWEET GLOBE,Clam
AGL,MNBU3340760,02/12/2024,Sale,-400.0,1200.0,13,SWEET GLOBE,Clam
AGL,MNBU3340760,02/13/2024,Sale,-1200.0,0.0,14,SWEET GLOBE,Clam
AGL,MNBU3381075,02/06/2024,Entry,1600.0,1600.0,0,SWEET GLOBE,Clam
AGL,MNBU3381075,04/02/2024,Sale,-400.0,1200.0,56,SWEET GLOBE,Clam
AGL,MNBU3381075,04/04/2024,Sale,-480.0,720.0,58,SWEET GLOBE,Clam
AGL,MNBU3381075,04/08/2024,Sale,-320.0,400.0,62,SWEET GLOBE,Clam
AGL,MNBU3381075,04/12/2024,Sale,-400.0,0.0,66,SWEET GLOBE,Clam
AGL,MNBU3390800,01/30/2024,Entry,1600.0,1600.0,0,SWEET FAVORS,Clam
AGL,MNBU3390800,02/17/2024,Sale,-960.0,640.0,18,SWEET FAVORS,Clam
AGL,MNBU3390800,02/20/2024,Sale,-640.0,0.0,21,SWEET FAVORS,Clam
AGL,MNBU3394030,01/08/2024,Entry,1600.0,1600.0,0,SWEET GLOBE,Clam
AGL,MNBU3394030,01/23/2024,Sale,-80.0,1520.0,15,SWEET GLOBE,Clam
AGL,MNBU3394030,01/23/2024,Sale,-1520.0,0.0,15,SWEET GLOBE,Clam
AGL,MNBU3399496,12/30/2023,Entry,1600.0,1600.0,0,TIMCO,Clam
AGL,MNBU3399496,01/24/2024,Sale,-1360.0,240.0,25,TIMCO,Clam
AGL,MNBU3399496,01/27/2024,Sale,-240.0,0.0,28,TIMCO,Clam
AGL,MNBU3446582,02/04/2024,Entry,570.0,570.0,0,SWEET GLOBE,Bag
AGL,MNBU3446582,02/04/2024,Entry,190.0,760.0,0,SWEET GLOBE,Bag
AGL,MNBU3446582,02/04/2024,Entry,1140.0,1900.0,0,SWEET GLOBE,Bag
AGL,MNBU3446582,02/22/2024,Sale,-190.0,1710.0,18,SWEET GLOBE,Bag
AGL,MNBU3446582,02/23/2024,Sale,-190.0,1520.0,19,SWEET GLOBE,Bag
AGL,MNBU3446582,02/24/2024,Sale,-380.0,1140.0,20,SWEET GLOBE,Bag
AGL,MNBU3446582,02/24/2024,Sale,-570.0,570.0,20,SWEET GLOBE,Bag
AGL,MNBU3446582,02/24/2024,Sale,-570.0,0.0,20,SWEET GLOBE,Bag
AGL,MNBU3497168,01/22/2024,Entry,1600.0,1600.0,0,SWEET GLOBE,Clam
AGL,MNBU3497168,02/01/2024,Sale,-1440.0,160.0,10,SWEET GLOBE,Clam
AGL,MNBU3497168,02/02/2024,Sale,-160.0,0.0,11,SWEET GLOBE,Clam
AGL,MNBU3506357,12/30/2023,Entry,1600.0,1600.0,0,CANDY DREAMS,Clam
AGL,MNBU3506357,01/12/2024,Sale,-1600.0,0.0,13,CANDY DREAMS,Clam
AGL,MNBU3660721,01/31/2024,Entry,1600.0,1600.0,0,SWEET FAVORS,Clam
AGL,MNBU3660721,02/21/2024,Sale,-800.0,800.0,21,SWEET FAVORS,Clam
AGL,MNBU3660721,02/26/2024,Sale,-400.0,400.0,26,SWEET FAVORS,Clam
AGL,MNBU3660721,02/27/2024,Sale,-400.0,0.0,27,SWEET FAVORS,Clam
AGL,MNBU3721848,02/06/2024,Entry,1235.0,1235.0,0,SWEET GLOBE,Bag
AGL,MNBU3721848,02/06/2024,Entry,285.0,1520.0,0,SWEET GLOBE,Bag
AGL,MNBU3721848,02/06/2024,Entry,380.0,1900.0,0,SWEET GLOBE,Bag
AGL,MNBU3721848,02/24/2024,Sale,-380.0,1520.0,18,SWEET GLOBE,Bag
AGL,MNBU3721848,02/26/2024,Sale,-570.0,950.0,20,SWEET GLOBE,Bag
AGL,MNBU3721848,02/28/2024,Sale,-285.0,665.0,22,SWEET GLOBE,Bag
AGL,MNBU3721848,02/29/2024,Sale,-380.0,285.0,23,SWEET GLOBE,Bag
AGL,MNBU3721848,02/29/2024,Sale,-285.0,0.0,23,SWEET GLOBE,Bag
AGL,MNBU3774072,01/23/2024,Entry,1600.0,1600.0,0,CANDY DREAMS,Clam
AGL,MNBU3774072,02/12/2024,Sale,-160.0,1440.0,20,CANDY DREAMS,Clam
AGL,MNBU3774072,02/13/2024,Sale,-1440.0,0.0,21,CANDY DREAMS,Clam
AGL,MNBU3783984,01/23/2024,Entry,1600.0,1600.0,0,SWEET GLOBE,Clam
AGL,MNBU3783984,02/05/2024,Sale,-800.0,800.0,13,SWEET GLOBE,Clam
AGL,MNBU3783984,02/06/2024,Sale,-800.0,0.0,14,SWEET GLOBE,Clam
AGL,MNBU3828409,01/22/2024,Entry,1600.0,1600.0,0,SWEET GLOBE,Clam
AGL,MNBU3828409,02/02/2024,Sale,-720.0,880.0,11,SWEET GLOBE,Clam
AGL,MNBU3828409,02/02/2024,Sale,-880.0,0.0,11,SWEET GLOBE,Clam
AGL,MNBU3837951,12/30/2023,Entry,1800.0,1800.0,0,TIMCO,Bag
AGL,MNBU3837951,01/23/2024,Sale,-360.0,1440.0,24,TIMCO,Bag
AGL,MNBU3837951,01/23/2024,Sale,-270.0,1170.0,24,TIMCO,Bag
AGL,MNBU3837951,01/24/2024,Sale,-360.0,810.0,25,TIMCO,Bag
AGL,MNBU3837951,01/24/2024,Sale,-810.0,0.0,25,TIMCO,Bag
AGL,MNBU3841782,12/30/2023,Entry,1600.0,1600.0,0,SWEET GLOBE,Clam
AGL,MNBU3841782,01/13/2024,Sale,-1600.0,0.0,14,SWEET GLOBE,Clam
AGL,MNBU3932326,12/30/2023,Entry,1600.0,1600.0,0,SWEET GLOBE,Clam
AGL,MNBU3932326,01/12/2024,Sale,-1600.0,0.0,13,SWEET GLOBE,Clam
AGL,MNBU3940722,02/06/2024,Entry,1600.0,1600.0,0,SWEET GLOBE,Clam
AGL,MNBU3940722,03/01/2024,Sale,-880.0,720.0,24,SWEET GLOBE,Clam
AGL,MNBU3940722,03/05/2024,Sale,-640.0,80.0,28,SWEET GLOBE,Clam
AGL,MNBU3940722,03/06/2024,Sale,-80.0,0.0,29,SWEET GLOBE,Clam
AGL,MNBU3960138,12/30/2023,Entry,1600.0,1600.0,0,SWEET GLOBE,Clam
AGL,MNBU3960138,01/22/2024,Sale,-1600.0,0.0,23,SWEET GLOBE,Clam
AGL,MNBU3975122,12/30/2023,Entry,1600.0,1600.0,0,ALLISON,Clam
AGL,MNBU3975122,01/16/2024,Sale,-1600.0,0.0,17,ALLISON,Clam
AGL,MNBU3992412,01/30/2024,Entry,80.0,80.0,0,COTTON CANDY,Clam
AGL,MNBU3992412,01/30/2024,Entry,1520.0,1600.0,0,SWEET GLOBE,Clam
AGL,MNBU3992412,02/07/2024,Sale,-1280.0,320.0,8,SWEET GLOBE,Clam
AGL,MNBU3992412,02/08/2024,Sale,-240.0,80.0,9,SWEET GLOBE,Clam
AGL,MNBU3992412,03/14/2024,Sale,-80.0,0.0,44,COTTON CANDY,Clam
AGL,MNBU4053471,12/30/2023,Entry,1600.0,1600.0,0,SWEET GLOBE,Clam
AGL,MNBU4053471,01/13/2024,Sale,-1600.0,0.0,14,SWEET GLOBE,Clam
AGL,MNBU4139019,01/30/2024,Entry,1600.0,1600.0,0,SWEET GLOBE,Clam
AGL,MNBU4139019,02/08/2024,Sale,-1440.0,160.0,9,SWEET GLOBE,Clam
AGL,MNBU4139019,02/08/2024,Sale,-160.0,0.0,9,SWEET GLOBE,Clam
AGL,MNBU4145829,02/04/2024,Entry,1600.0,1600.0,0,SWEET GLOBE,Clam
AGL,MNBU4145829,02/13/2024,Sale,-1440.0,160.0,9,SWEET GLOBE,Clam
AGL,MNBU4145829,02/13/2024,Sale,-160.0,0.0,9,SWEET GLOBE,Clam
AGL,MNBU4185267,01/23/2024,Entry,1600.0,1600.0,0,SWEET GLOBE,Clam
AGL,MNBU4185267,02/06/2024,Sale,-960.0,640.0,14,SWEET GLOBE,Clam
AGL,MNBU4185267,02/07/2024,Sale,-640.0,0.0,15,SWEET GLOBE,Clam
AGL,MNBU4193869,02/06/2024,Entry,1600.0,1600.0,0,SWEET GLOBE,Clam
AGL,MNBU4193869,02/27/2024,Sale,-800.0,800.0,21,SWEET GLOBE,Clam
AGL,MNBU4193869,02/28/2024,Sale,-800.0,0.0,22,SWEET GLOBE,Clam
AGL,MNBU4199086,01/30/2024,Entry,1600.0,1600.0,0,SWEET GLOBE,Clam
AGL,MNBU4199086,02/10/2024,Sale,-400.0,1200.0,11,SWEET GLOBE,Clam
AGL,MNBU4199086,02/12/2024,Sale,-1200.0,0.0,13,SWEET GLOBE,Clam
AGL,MNBU4290452,02/07/2024,Entry,1600.0,1600.0,0,SWEET GLOBE,Clam
AGL,MNBU4290452,02/16/2024,Sale,-560.0,1040.0,9,SWEET GLOBE,Clam
AGL,MNBU4290452,02/20/2024,Sale,-1040.0,0.0,13,SWEET GLOBE,Clam
AGL,MNBU4290658,12/30/2023,Entry,1600.0,1600.0,0,SWEET GLOBE,Clam
AGL,MNBU4290658,01/17/2024,Sale,-1600.0,0.0,18,SWEET GLOBE,Clam
AGL,MNBU4307920,12/30/2023,Entry,1900.0,1900.0,0,TIMCO,Bag
AGL,MNBU4307920,01/24/2024,Sale,-475.0,1425.0,25,TIMCO,Bag
AGL,MNBU4307920,01/26/2024,Sale,-285.0,1140.0,27,TIMCO,Bag
AGL,MNBU4307920,01/26/2024,Sale,-475.0,665.0,27,TIMCO,Bag
AGL,MNBU4307920,01/26/2024,Sale,-379.0,286.0,27,TIMCO,Bag
AGL,MNBU4307920,01/29/2024,Sale,-285.0,1.0,30,TIMCO,Bag
AGL,MNBU4311832,01/23/2024,Entry,1600.0,1600.0,0,SWEET GLOBE,Clam
AGL,MNBU4311832,02/02/2024,Sale,-720.0,880.0,10,SWEET GLOBE,Clam
AGL,MNBU4311832,02/02/2024,Sale,-880.0,0.0,10,SWEET GLOBE,Clam
AGL,MNBU4344250,12/30/2023,Entry,1600.0,1600.0,0,SWEET GLOBE,Clam
AGL,MNBU4344250,01/08/2024,Sale,-80.0,1520.0,9,SWEET GLOBE,Clam
AGL,MNBU4344250,01/09/2024,Sale,-1520.0,0.0,10,SWEET GLOBE,Clam
AGL,MNBU4354351,01/30/2024,Entry,1600.0,1600.0,0,SWEET GLOBE,Clam
AGL,MNBU4354351,02/09/2024,Sale,-1280.0,320.0,10,SWEET GLOBE,Clam
AGL,MNBU4354351,02/10/2024,Sale,-320.0,0.0,11,SWEET GLOBE,Clam
AGL,MNBU4355764,02/06/2024,Entry,1600.0,1600.0,0,SWEET GLOBE,Clam
AGL,MNBU4355764,02/13/2024,Sale,-160.0,1440.0,7,SWEET GLOBE,Clam
AGL,MNBU4355764,02/16/2024,Sale,-1440.0,0.0,10,SWEET GLOBE,Clam
AGL,MNBU4388048,01/23/2024,Entry,1600.0,1600.0,0,TIMCO,Clam
AGL,MNBU4388048,02/06/2024,Sale,-640.0,960.0,14,TIMCO,Clam
AGL,MNBU4388048,02/07/2024,Sale,-960.0,0.0,15,TIMCO,Clam
AGL,MNBU4422564,01/30/2024,Entry,1600.0,1600.0,0,CANDY DREAMS,Clam
AGL,MNBU4422564,02/17/2024,Sale,-80.0,1520.0,18,CANDY DREAMS,Clam
AGL,MNBU4422564,02/17/2024,Sale,-80.0,1440.0,18,CANDY DREAMS,Clam
AGL,MNBU4422564,02/19/2024,Sale,-80.0,1360.0,20,CANDY DREAMS,Clam
AGL,MNBU4422564,02/21/2024,Sale,-800.0,560.0,22,CANDY DREAMS,Clam
AGL,MNBU4422564,02/21/2024,Sale,-475.0,85.0,22,CANDY DREAMS,Clam
AGL,MNBU4425120,01/30/2024,Entry,1600.0,1600.0,0,SWEET GLOBE,Clam
AGL,MNBU4425120,02/08/2024,Sale,-320.0,1280.0,9,SWEET GLOBE,Clam
AGL,MNBU4425120,02/09/2024,Sale,-1280.0,0.0,10,SWEET GLOBE,Clam
AGL,MNBU9028912,12/30/2023,Entry,1260.0,1260.0,0,ALLISON,Bag
AGL,MNBU9028912,12/30/2023,Entry,540.0,1800.0,0,TIMCO,Bag
AGL,MNBU9028912,01/24/2024,Sale,-180.0,1620.0,25,ALLISON,Bag
AGL,MNBU9028912,01/24/2024,Sale,-180.0,1440.0,25,TIMCO,Bag
AGL,MNBU9028912,01/24/2024,Sale,-180.0,1260.0,25,TIMCO,Bag
AGL,MNBU9028912,01/25/2024,Sale,-90.0,1170.0,26,ALLISON,Bag
AGL,MNBU9028912,01/25/2024,Sale,-90.0,1080.0,26,ALLISON,Bag
AGL,MNBU9028912,01/25/2024,Sale,-180.0,900.0,26,ALLISON,Bag
AGL,MNBU9028912,01/25/2024,Sale,-180.0,720.0,26,TIMCO,Bag
AGL,MNBU9028912,01/30/2024,Sale,-360.0,360.0,31,ALLISON,Bag
AGL,MNBU9028912,01/31/2024,Sale,-180.0,180.0,32,ALLISON,Bag
AGL,MNBU9028912,02/02/2024,Sale,-180.0,0.0,34,ALLISON,Bag
AGL,MNBU9051980,01/23/2024,Entry,1600.0,1600.0,0,CANDY DREAMS,Clam
AGL,MNBU9051980,02/08/2024,Sale,-80.0,1520.0,16,CANDY DREAMS,Clam
AGL,MNBU9051980,02/09/2024,Sale,-1520.0,0.0,17,CANDY DREAMS,Clam
AGL,MNBU9056977,01/23/2024,Entry,80.0,80.0,0,COTTON CANDY,Clam
AGL,MNBU9056977,01/23/2024,Entry,1520.0,1600.0,0,SWEET GLOBE,Clam
AGL,MNBU9056977,02/02/2024,Sale,-720.0,880.0,10,SWEET GLOBE,Clam
AGL,MNBU9056977,02/03/2024,Sale,-800.0,80.0,11,SWEET GLOBE,Clam
AGL,MNBU9056977,03/14/2024,Sale,-80.0,0.0,51,COTTON CANDY,Clam
AGL,MNBU9097560,01/23/2024,Entry,1600.0,1600.0,0,CANDY DREAMS,Clam
AGL,MNBU9097560,02/09/2024,Sale,-240.0,1360.0,17,CANDY DREAMS,Clam
AGL,MNBU9097560,02/09/2024,Sale,-160.0,1200.0,17,CANDY DREAMS,Clam
AGL,MNBU9097560,02/10/2024,Sale,-1200.0,0.0,18,CANDY DREAMS,Clam
AGL,MNBU9132681,02/06/2024,Entry,1600.0,1600.0,0,SWEET GLOBE,Clam
AGL,MNBU9132681,02/27/2024,Sale,-960.0,640.0,21,SWEET GLOBE,Clam
AGL,MNBU9132681,02/27/2024,Sale,-640.0,0.0,21,SWEET GLOBE,Clam
AGL,MNBU9133950,02/06/2024,Entry,80.0,80.0,0,COTTON CANDY,Clam
AGL,MNBU9133950,02/06/2024,Entry,1520.0,1600.0,0,SWEET GLOBE,Clam
AGL,MNBU9133950,02/16/2024,Sale,-160.0,1440.0,10,SWEET GLOBE,Clam
AGL,MNBU9133950,02/23/2024,Sale,-559.0,881.0,17,SWEET GLOBE,Clam
AGL,MNBU9133950,02/24/2024,Sale,-800.0,81.0,18,SWEET GLOBE,Clam
AGL,MNBU9133950,03/11/2024,Sale,-18.0,63.0,34,BI-COLOR,Clam
AGL,MNBU9143794,02/07/2024,Entry,1600.0,1600.0,0,SWEET GLOBE,Clam
AGL,MNBU9143794,02/20/2024,Sale,-560.0,1040.0,13,SWEET GLOBE,Clam
AGL,MNBU9143794,02/22/2024,Sale,-78.0,962.0,15,SWEET GLOBE,Clam
AGL,MNBU9143794,02/24/2024,Sale,-640.0,322.0,17,SWEET GLOBE,Clam
AGL,MNBU9143794,02/26/2024,Sale,-320.0,2.0,19,SWEET GLOBE,Clam
AGL,MNBU9156127,12/30/2023,Entry,1600.0,1600.0,0,TIMCO,Clam
AGL,MNBU9156127,01/25/2024,Sale,-1600.0,0.0,26,TIMCO,Clam
AGL,MNBU9161904,02/06/2024,Entry,1600.0,1600.0,0,SWEET GLOBE,Clam
AGL,MNBU9161904,02/22/2024,Sale,-1600.0,0.0,16,SWEET GLOBE,Clam
AGL,MNBU9162623,01/23/2024,Entry,1600.0,1600.0,0,SWEET GLOBE,Clam
AGL,MNBU9162623,02/03/2024,Sale,-800.0,800.0,11,SWEET GLOBE,Clam
AGL,MNBU9162623,02/05/2024,Sale,-800.0,0.0,13,SWEET GLOBE,Clam
AGL,MSDU9019579,12/30/2023,Entry,1600.0,1600.0,0,ALLISON,Clam
AGL,MSDU9019579,01/10/2024,Sale,-720.0,880.0,11,ALLISON,Clam
AGL,MSDU9019579,01/11/2024,Sale,-876.0,4.0,12,ALLISON,Clam
AGL,MSDU9022802,01/30/2024,Entry,1600.0,1600.0,0,TIMCO,Clam
AGL,MSDU9022802,02/07/2024,Sale,-640.0,960.0,8,TIMCO,Clam
AGL,MSDU9022802,02/12/2024,Sale,-960.0,0.0,13,TIMCO,Clam
AGL,MSDU9034486,12/31/2023,Entry,1600.0,1600.0,0,ALLISON,Clam
AGL,MSDU9034486,01/08/2024,Sale,-1440.0,160.0,8,ALLISON,Clam
AGL,MSDU9034486,01/11/2024,Sale,-160.0,0.0,11,ALLISON,Clam
AGL,MSDU9038199,01/20/2024,Entry,1600.0,1600.0,0,ALLISON,Clam
AGL,MSDU9038199,01/25/2024,Sale,-960.0,640.0,5,ALLISON,Clam
AGL,MSDU9038199,01/30/2024,Sale,-400.0,240.0,10,ALLISON,Clam
AGL,MSDU9038199,02/03/2024,Sale,-240.0,0.0,14,ALLISON,Clam
AGL,MSDU9700113,02/07/2024,Entry,1600.0,1600.0,0,SWEET GLOBE,Clam
AGL,MSDU9700113,02/14/2024,Sale,-1600.0,0.0,7,SWEET GLOBE,Clam
AGL,MSDU9703278,01/30/2024,Entry,1600.0,1600.0,0,SWEET GLOBE,Clam
AGL,MSDU9703278,02/08/2024,Sale,-400.0,1200.0,9,SWEET GLOBE,Clam
AGL,MSDU9703278,02/08/2024,Sale,-1200.0,0.0,9,SWEET GLOBE,Clam
AGL,MSDU9703874,02/07/2024,Entry,1600.0,1600.0,0,SWEET GLOBE,Clam
AGL,MSDU9703874,02/14/2024,Sale,-720.0,880.0,7,SWEET GLOBE,Clam
AGL,MSDU9703874,02/14/2024,Sale,-720.0,160.0,7,SWEET GLOBE,Clam
AGL,MSDU9703874,02/16/2024,Sale,-160.0,0.0,9,SWEET GLOBE,Clam
AGL,MSDU9703956,02/07/2024,Entry,1600.0,1600.0,0,SWEET GLOBE,Clam
AGL,MSDU9703956,02/26/2024,Sale,-480.0,1120.0,19,SWEET GLOBE,Clam
AGL,MSDU9703956,02/27/2024,Sale,-1120.0,0.0,20,SWEET GLOBE,Clam
AGL,MSDU9704968,01/30/2024,Entry,1600.0,1600.0,0,SWEET GLOBE,Clam
AGL,MSDU9704968,02/13/2024,Sale,-1200.0,400.0,14,SWEET GLOBE,Clam
AGL,MSDU9704968,02/13/2024,Sale,-400.0,0.0,14,SWEET GLOBE,Clam
AGL,MSDU9714502,02/07/2024,Entry,1600.0,1600.0,0,SWEET GLOBE,Clam
AGL,MSDU9714502,02/14/2024,Sale,-960.0,640.0,7,SWEET GLOBE,Clam
AGL,MSDU9714502,02/14/2024,Sale,-80.0,560.0,7,SWEET GLOBE,Clam
AGL,MSDU9714502,02/14/2024,Sale,-80.0,480.0,7,SWEET GLOBE,Clam
AGL,MSDU9714502,02/24/2024,Sale,-480.0,0.0,17,SWEET GLOBE,Clam
AGL,MSDU9714550,02/07/2024,Entry,1600.0,1600.0,0,SWEET GLOBE,Clam
AGL,MSDU9714550,02/22/2024,Sale,-478.0,1122.0,15,SWEET GLOBE,Clam
AGL,MSDU9714550,02/26/2024,Sale,-1120.0,2.0,19,SWEET GLOBE,Clam
AGL,OTPU6513104,12/29/2023,Sale,-1600.0,-1600.0,0,ALLISON,Clam
AGL,OTPU6513104,12/30/2023,Entry,1600.0,0.0,1,ALLISON,Clam
AGL,OTPU6576550,02/07/2024,Entry,80.0,80.0,0,COTTON CANDY,Clam
AGL,OTPU6576550,02/07/2024,Entry,1520.0,1600.0,0,SWEET GLOBE,Clam
AGL,OTPU6576550,02/14/2024,Sale,-1520.0,80.0,7,SWEET GLOBE,Clam
AGL,OTPU6576550,03/14/2024,Sale,-80.0,0.0,36,COTTON CANDY,Clam
AGL,SEGU9521992,01/23/2024,Entry,1600.0,1600.0,0,ALLISON,Clam
AGL,SEGU9521992,01/31/2024,Sale,-560.0,1040.0,8,ALLISON,Clam
AGL,SEGU9521992,02/03/2024,Sale,-1040.0,0.0,11,ALLISON,Clam
AGL,SEGU9545947,12/30/2023,Entry,1700.0,1700.0,0,BI-COLOR,Clam
AGL,SEGU9545947,01/13/2024,Sale,-1700.0,0.0,14,BI-COLOR,Clam
AGL,SEGU9622895,12/30/2023,Entry,1600.0,1600.0,0,ALLISON,Clam
AGL,SEGU9622895,01/09/2024,Sale,-240.0,1360.0,10,ALLISON,Clam
AGL,SEGU9622895,01/09/2024,Sale,-80.0,1280.0,10,ALLISON,Clam
AGL,SEGU9622895,01/13/2024,Sale,-400.0,880.0,14,ALLISON,Clam
AGL,SEGU9622895,01/15/2024,Sale,-880.0,0.0,16,ALLISON,Clam
AGL,SEGU9624100,12/27/2023,Entry,1600.0,1600.0,0,SWEET GLOBE,Clam
AGL,SEGU9624100,01/06/2024,Sale,-400.0,1200.0,10,SWEET GLOBE,Clam
AGL,SEGU9624100,01/08/2024,Sale,-240.0,960.0,12,SWEET GLOBE,Clam
AGL,SEGU9624100,01/09/2024,Sale,-960.0,0.0,13,SWEET GLOBE,Clam
AGL,SEGU9624326,12/30/2023,Entry,1600.0,1600.0,0,ALLISON,Clam
AGL,SEGU9624326,12/30/2023,Sale,-240.0,1360.0,0,ALLISON,Clam
AGL,SEGU9624326,01/02/2024,Sale,-640.0,720.0,3,ALLISON,Clam
AGL,SEGU9624326,01/04/2024,Sale,-720.0,0.0,5,ALLISON,Clam
AGL,SEGU9629879,01/28/2024,Entry,1600.0,1600.0,0,SWEET GLOBE,Clam
AGL,SEGU9629879,01/29/2024,Sale,-1600.0,0.0,1,SWEET GLOBE,Clam
AGL,SEGU9819478,12/31/2023,Entry,1700.0,1700.0,0,BI-COLOR,Clam
AGL,SEGU9819478,01/08/2024,Sale,-1700.0,0.0,8,BI-COLOR,Clam
AGL,SEGU9883374,02/02/2024,Sale,-190.0,-190.0,0,SWEET GLOBE,Unknown
AGL,SEGU9883374,02/04/2024,Entry,1900.0,1710.0,2,SWEET GLOBE,Unknown
AGL,SEGU9883374,02/10/2024,Sale,-950.0,760.0,8,SWEET GLOBE,Unknown
AGL,SEGU9883374,02/15/2024,Sale,-760.0,0.0,13,SWEET GLOBE,Unknown
AGL,SEGU9884072,12/28/2023,Sale,-160.0,-160.0,0,ALLISON,Unknown
AGL,SEGU9884072,12/28/2023,Sale,-1440.0,-1600.0,0,ALLISON,Unknown
AGL,SEGU9884072,12/30/2023,Entry,1600.0,0.0,2,ALLISON,Unknown
AGL,SEGU9884508,12/27/2023,Entry,1600.0,1600.0,0,ALLISON,Unknown
AGL,SEGU9884508,01/04/2024,Sale,-720.0,880.0,8,ALLISON,Unknown
AGL,SEGU9884508,01/08/2024,Sale,-720.0,160.0,12,ALLISON,Unknown
AGL,SEGU9884508,01/09/2024,Sale,-160.0,0.0,13,ALLISON,Unknown
AGL,SEGU9884555,01/28/2024,Entry,1600.0,1600.0,0,SWEET GLOBE,Unknown
AGL,SEGU9884555,01/31/2024,Sale,-1600.0,0.0,3,SWEET GLOBE,Unknown
AGL,SEGU9884600,02/04/2024,Entry,1600.0,1600.0,0,SWEET GLOBE,Unknown
AGL,SEGU9884600,02/09/2024,Sale,-320.0,1280.0,5,SWEET GLOBE,Unknown
AGL,SEGU9884600,02/10/2024,Sale,-1040.0,240.0,6,SWEET GLOBE,Unknown
AGL,SEGU9884600,02/10/2024,Sale,-240.0,0.0,6,SWEET GLOBE,Unknown
AGL,SEGU9885720,12/28/2023,Sale,-1700.0,-1700.0,0,BI-COLOR,Unknown
AGL,SEGU9885720,12/30/2023,Entry,1700.0,0.0,2,BI-COLOR,Unknown
AGL,SEGU9886239,01/22/2024,Sale,-800.0,-800.0,0,SWEET GLOBE,Unknown
AGL,SEGU9886239,01/23/2024,Entry,1600.0,800.0,1,SWEET GLOBE,Unknown
AGL,SEGU9886239,01/25/2024,Sale,-800.0,0.0,3,SWEET GLOBE,Unknown
AGL,SEGU9886481,12/30/2023,Entry,1600.0,1600.0,0,ALLISON,Unknown
AGL,SEGU9886481,01/09/2024,Sale,-400.0,1200.0,10,ALLISON,Unknown
AGL,SEGU9886481,01/09/2024,Sale,-160.0,1040.0,10,ALLISON,Unknown
AGL,SEGU9886481,01/13/2024,Sale,-80.0,960.0,14,ALLISON,Unknown
AGL,SEGU9886481,01/15/2024,Sale,-560.0,400.0,16,ALLISON,Unknown
AGL,SEGU9886481,01/22/2024,Sale,-400.0,0.0,23,ALLISON,Unknown
AGL,SEGU9886558,12/28/2023,Sale,-1700.0,-1700.0,0,BI-COLOR,Unknown
AGL,SEGU9886558,12/30/2023,Entry,1700.0,0.0,2,BI-COLOR,Unknown
AGL,SEGU9886603,01/28/2024,Entry,1600.0,1600.0,0,ALLISON,Unknown
AGL,SEGU9886603,02/06/2024,Sale,-1120.0,480.0,9,ALLISON,Unknown
AGL,SEGU9886603,02/07/2024,Sale,-480.0,0.0,10,ALLISON,Unknown
AGL,SEGU9887066,12/27/2023,Entry,1600.0,1600.0,0,ALLISON,Unknown
AGL,SEGU9887066,01/04/2024,Sale,-480.0,1120.0,8,ALLISON,Unknown
AGL,SEGU9887066,01/04/2024,Sale,-1120.0,0.0,8,ALLISON,Unknown
AGL,SEGU9887430,12/15/2023,Entry,1600.0,1600.0,0,ALLISON,Unknown
AGL,SEGU9887430,12/30/2023,Sale,-560.0,1040.0,15,ALLISON,Unknown
AGL,SEGU9887430,01/02/2024,Sale,-880.0,160.0,18,ALLISON,Unknown
AGL,SEGU9887430,01/04/2024,Sale,-160.0,0.0,20,ALLISON,Unknown
AGL,SEGU9887446,02/04/2024,Entry,1600.0,1600.0,0,SWEET GLOBE,Unknown
AGL,SEGU9887446,02/14/2024,Sale,-480.0,1120.0,10,SWEET GLOBE,Unknown
AGL,SEGU9887446,02/22/2024,Sale,-400.0,720.0,18,SWEET GLOBE,Unknown
AGL,SEGU9887446,02/23/2024,Sale,-376.0,344.0,19,SWEET GLOBE,Unknown
AGL,SEGU9992797,01/20/2024,Entry,1600.0,1600.0,0,SWEET GLOBE,Unknown
AGL,SEGU9992797,01/24/2024,Sale,-1520.0,80.0,4,SWEET GLOBE,Unknown
AGL,SEGU9992797,01/24/2024,Sale,-80.0,0.0,4,SWEET GLOBE,Unknown
AGL,SEKU9118220,02/04/2024,Entry,1330.0,1330.0,0,SWEET GLOBE,Unknown
AGL,SEKU9118220,02/04/2024,Entry,570.0,1900.0,0,SWEET GLOBE,Unknown
AGL,SEKU9118220,02/15/2024,Sale,-190.0,1710.0,11,SWEET GLOBE,Unknown
AGL,SEKU9118220,02/15/2024,Sale,-95.0,1615.0,11,SWEET GLOBE,Unknown
AGL,SEKU9118220,02/15/2024,Sale,-475.0,1140.0,11,SWEET GLOBE,Unknown
AGL,SEKU9118220,02/20/2024,Sale,-95.0,1045.0,16,SWEET GLOBE,Unknown
AGL,SEKU9118220,02/22/2024,Sale,-190.0,855.0,18,SWEET GLOBE,Unknown
AGL,SEKU9118220,02/22/2024,Sale,-665.0,190.0,18,SWEET GLOBE,Unknown
AGL,SEKU9118220,02/23/2024,Sale,-190.0,0.0,19,SWEET GLOBE,Unknown
AGL,SEKU9118425,02/04/2024,Entry,95.0,95.0,0,SWEET GLOBE,Unknown
AGL,SEKU9118425,02/04/2024,Entry,475.0,570.0,0,SWEET GLOBE,Unknown
AGL,SEKU9118425,02/04/2024,Entry,1330.0,1900.0,0,SWEET GLOBE,Unknown
AGL,SEKU9118425,02/09/2024,Sale,-95.0,1805.0,5,SWEET GLOBE,Unknown
AGL,SEKU9118425,02/12/2024,Sale,-1330.0,475.0,8,SWEET GLOBE,Unknown
AGL,SEKU9118425,02/12/2024,Sale,-475.0,0.0,8,SWEET GLOBE,Unknown
AGL,SEKU9120042,02/02/2024,Sale,-190.0,-190.0,0,SWEET GLOBE,Unknown
AGL,SEKU9120042,02/04/2024,Entry,1900.0,1710.0,2,SWEET GLOBE,Unknown
AGL,SEKU9120042,02/06/2024,Sale,-665.0,1045.0,4,SWEET GLOBE,Unknown
AGL,SEKU9120042,02/07/2024,Sale,-285.0,760.0,5,SWEET GLOBE,Unknown
AGL,SEKU9120042,02/08/2024,Sale,-380.0,380.0,6,SWEET GLOBE,Unknown
AGL,SEKU9120042,02/12/2024,Sale,-95.0,285.0,10,SWEET GLOBE,Unknown
AGL,SEKU9120042,02/14/2024,Sale,-285.0,0.0,12,SWEET GLOBE,Unknown
AGL,SMLU5461609,01/19/2024,Sale,-640.0,-640.0,0,SWEET GLOBE,Unknown
AGL,SMLU5461609,01/20/2024,Sale,-720.0,-1360.0,1,SWEET GLOBE,Unknown
AGL,SMLU5461609,01/20/2024,Sale,-240.0,-1600.0,1,SWEET GLOBE,Unknown
AGL,SMLU5461609,01/23/2024,Entry,1600.0,0.0,4,SWEET GLOBE,Unknown
AGL,SMLU5463690,01/23/2024,Entry,1600.0,1600.0,0,ALLISON,Unknown
AGL,SMLU5463690,01/24/2024,Sale,-400.0,1200.0,1,ALLISON,Unknown
AGL,SMLU5463690,01/24/2024,Sale,-880.0,320.0,1,ALLISON,Unknown
AGL,SMLU5463690,01/29/2024,Sale,-240.0,80.0,6,ALLISON,Unknown
AGL,SMLU5463690,01/31/2024,Sale,-80.0,0.0,8,ALLISON,Unknown
AGL,SMLU5469662,02/04/2024,Entry,1600.0,1600.0,0,SWEET GLOBE,Unknown
AGL,SMLU5469662,02/07/2024,Sale,-960.0,640.0,3,SWEET GLOBE,Unknown
AGL,SMLU5469662,02/09/2024,Sale,-640.0,0.0,5,SWEET GLOBE,Unknown
AGL,SMLU5470684,02/04/2024,Entry,1600.0,1600.0,0,SWEET GLOBE,Unknown
AGL,SMLU5470684,02/07/2024,Sale,-960.0,640.0,3,SWEET GLOBE,Unknown
AGL,SMLU5470684,02/09/2024,Sale,-640.0,0.0,5,SWEET GLOBE,Unknown
AGL,SMLU5471850,12/30/2023,Entry,1600.0,1600.0,0,IVORY,Unknown
AGL,SMLU5471850,01/04/2024,Sale,-580.0,1020.0,5,IVORY,Unknown
AGL,SMLU5471850,01/06/2024,Sale,-560.0,460.0,7,IVORY,Unknown
AGL,SMLU5471850,01/06/2024,Sale,-320.0,140.0,7,IVORY,Unknown
AGL,SMLU5471850,01/09/2024,Sale,-140.0,0.0,10,IVORY,Unknown
AGL,SMLU5472769,12/30/2023,Entry,1600.0,1600.0,0,IVORY,Unknown
AGL,SMLU5472769,01/12/2024,Sale,-180.0,1420.0,13,IVORY,Unknown
AGL,SMLU5472769,01/13/2024,Sale,-1420.0,0.0,14,IVORY,Unknown
AGL,SMLU5472877,01/27/2024,Sale,-190.0,-190.0,0,SWEET FAVORS,Unknown
AGL,SMLU5472877,01/28/2024,Entry,1900.0,1710.0,1,SWEET FAVORS,Unknown
AGL,SMLU5472877,01/30/2024,Sale,-475.0,1235.0,3,SWEET FAVORS,Unknown
AGL,SMLU5472877,01/31/2024,Sale,-190.0,1045.0,4,SWEET FAVORS,Unknown
AGL,SMLU5472877,02/01/2024,Sale,-187.0,858.0,5,SWEET FAVORS,Unknown
AGL,SMLU5472877,02/01/2024,Sale,-380.0,478.0,5,SWEET FAVORS,Unknown
AGL,SMLU5472877,02/01/2024,Sale,-380.0,98.0,5,SWEET FAVORS,Unknown
AGL,SMLU5472877,02/02/2024,Sale,-95.0,3.0,6,SWEET FAVORS,Unknown
AGL,SMLU5472877,03/04/2024,Sale,-3.0,0.0,37,SWEET FAVORS,Unknown
AGL,SMLU5473066,01/26/2024,Sale,-1140.0,-1140.0,0,SWEET GLOBE,Unknown
AGL,SMLU5473066,01/28/2024,Entry,1900.0,760.0,2,SWEET GLOBE,Unknown
AGL,SMLU5473066,01/30/2024,Sale,-190.0,570.0,4,SWEET GLOBE,Unknown
AGL,SMLU5473066,01/31/2024,Sale,-570.0,0.0,5,SWEET GLOBE,Unknown
AGL,SMLU5473507,12/12/2023,Entry,1600.0,1600.0,0,CANDY SNAP,Unknown
AGL,SMLU5473507,12/15/2023,Sale,-1600.0,0.0,3,CANDY SNAP,Unknown
AGL,SMLU5476960,01/23/2024,Entry,1900.0,1900.0,0,SWEET FAVORS,Unknown
AGL,SMLU5476960,01/25/2024,Sale,-190.0,1710.0,2,SWEET FAVORS,Unknown
AGL,SMLU5476960,01/27/2024,Sale,-1710.0,0.0,4,SWEET FAVORS,Unknown
AGL,SMLU5477143,02/04/2024,Entry,1600.0,1600.0,0,SWEET GLOBE,Unknown
AGL,SMLU5477143,02/16/2024,Sale,-80.0,1520.0,12,SWEET GLOBE,Unknown
AGL,SMLU5477143,02/17/2024,Sale,-1520.0,0.0,13,SWEET GLOBE,Unknown
AGL,SMLU5478350,12/27/2023,Sale,-560.0,-560.0,0,ALLISON,Unknown
AGL,SMLU5478350,12/28/2023,Sale,-1040.0,-1600.0,1,ALLISON,Unknown
AGL,SMLU5478350,12/30/2023,Entry,1600.0,0.0,3,ALLISON,Unknown
AGL,SUDU6071166,01/30/2024,Entry,1600.0,1600.0,0,SWEET FAVORS,Unknown
AGL,SUDU6071166,02/17/2024,Sale,-240.0,1360.0,18,SWEET FAVORS,Unknown
AGL,SUDU6071166,02/20/2024,Sale,-560.0,800.0,21,SWEET FAVORS,Unknown
AGL,SUDU6071166,02/21/2024,Sale,-800.0,0.0,22,SWEET FAVORS,Unknown
AGL,SUDU6120912,12/30/2023,Entry,1600.0,1600.0,0,SWEET GLOBE,Unknown
AGL,SUDU6120912,01/22/2024,Sale,-1600.0,0.0,23,SWEET GLOBE,Unknown
AGL,SUDU6182616,12/30/2023,Entry,1600.0,1600.0,0,SWEET GLOBE,Unknown
AGL,SUDU6182616,01/20/2024,Sale,-1600.0,0.0,21,SWEET GLOBE,Unknown
AGL,SUDU8022140,01/23/2024,Entry,1600.0,1600.0,0,TIMCO,Unknown
AGL,SUDU8022140,02/09/2024,Sale,-1600.0,0.0,17,TIMCO,Unknown
AGL,SUDU8110657,12/30/2023,Entry,1600.0,1600.0,0,SWEET GLOBE,Unknown
AGL,SUDU8110657,01/08/2024,Sale,-1600.0,0.0,9,SWEET GLOBE,Unknown
AGL,SUDU8115900,01/30/2024,Entry,1600.0,1600.0,0,TIMCO,Unknown
AGL,SUDU8115900,02/13/2024,Sale,-640.0,960.0,14,TIMCO,Unknown
AGL,SUDU8115900,02/14/2024,Sale,-480.0,480.0,15,TIMCO,Unknown
AGL,SUDU8115900,02/19/2024,Sale,-480.0,0.0,20,TIMCO,Unknown
AGL,SUDU8198484,01/23/2024,Entry,1600.0,1600.0,0,SWEET GLOBE,Unknown
AGL,SUDU8198484,02/06/2024,Sale,-960.0,640.0,14,SWEET GLOBE,Unknown
AGL,SUDU8198484,02/06/2024,Sale,-640.0,0.0,14,SWEET GLOBE,Unknown
AGL,SUDU8208690,12/30/2023,Entry,1600.0,1600.0,0,SWEET GLOBE,Unknown
AGL,SUDU8208690,01/19/2024,Sale,-1600.0,0.0,20,SWEET GLOBE,Unknown
AGL,SZLU5000011,12/15/2023,Entry,1600.0,1600.0,0,CANDY SNAP,Unknown
AGL,SZLU5000011,12/16/2023,Sale,-1360.0,240.0,1,CANDY SNAP,Unknown
AGL,SZLU5000011,12/16/2023,Sale,-240.0,0.0,1,CANDY SNAP,Unknown
AGL,SZLU5000496,12/27/2023,Entry,1600.0,1600.0,0,SWEET GLOBE,Unknown
AGL,SZLU5000496,01/06/2024,Sale,-880.0,720.0,10,SWEET GLOBE,Unknown
AGL,SZLU5000496,01/08/2024,Sale,-160.0,560.0,12,SWEET GLOBE,Unknown
AGL,SZLU5000496,01/08/2024,Sale,-560.0,0.0,12,SWEET GLOBE,Unknown
AGL,SZLU5001131,12/30/2023,Entry,1600.0,1600.0,0,ALLISON,Unknown
AGL,SZLU5001131,01/23/2024,Sale,-1600.0,0.0,24,ALLISON,Unknown
AGL,SZLU5001363,12/27/2023,Entry,1600.0,1600.0,0,SWEET GLOBE,Unknown
AGL,SZLU5001363,01/09/2024,Sale,-400.0,1200.0,13,SWEET GLOBE,Unknown
AGL,SZLU5001363,01/10/2024,Sale,-400.0,800.0,14,SWEET GLOBE,Unknown
AGL,SZLU5001363,01/11/2024,Sale,-800.0,0.0,15,SWEET GLOBE,Unknown
AGL,SZLU5001830,01/31/2024,Entry,1900.0,1900.0,0,SWEET GLOBE,Unknown
AGL,SZLU5001830,01/31/2024,Sale,-855.0,1045.0,0,SWEET GLOBE,Unknown
AGL,SZLU5001830,02/01/2024,Sale,-475.0,570.0,1,SWEET GLOBE,Unknown
AGL,SZLU5001830,02/01/2024,Sale,-570.0,0.0,1,SWEET GLOBE,Unknown
AGL,SZLU5002457,02/04/2024,Entry,1600.0,1600.0,0,SWEET GLOBE,Unknown
AGL,SZLU5002457,02/16/2024,Sale,-640.0,960.0,12,SWEET GLOBE,Unknown
AGL,SZLU5002457,02/20/2024,Sale,-960.0,0.0,16,SWEET GLOBE,Unknown
AGL,SZLU5010004,12/27/2023,Entry,1600.0,1600.0,0,SWEET GLOBE,Unknown
AGL,SZLU5010004,01/09/2024,Sale,-320.0,1280.0,13,SWEET GLOBE,Unknown
AGL,SZLU5010004,01/10/2024,Sale,-1120.0,160.0,14,SWEET GLOBE,Unknown
AGL,SZLU5010004,01/11/2024,Sale,-160.0,0.0,15,SWEET GLOBE,Unknown
AGL,SZLU9259510,12/30/2023,Entry,1600.0,1600.0,0,CANDY DREAMS,Unknown
AGL,SZLU9259510,01/27/2024,Sale,-960.0,640.0,28,CANDY DREAMS,Unknown
AGL,SZLU9259510,01/29/2024,Sale,-560.0,80.0,30,CANDY DREAMS,Unknown
AGL,SZLU9259510,02/01/2024,Sale,-80.0,0.0,33,CANDY DREAMS,Unknown
AGL,SZLU9259952,01/20/2024,Entry,1600.0,1600.0,0,ALLISON,Unknown
AGL,SZLU9259952,01/22/2024,Sale,-480.0,1120.0,2,ALLISON,Unknown
AGL,SZLU9259952,01/22/2024,Sale,-880.0,240.0,2,ALLISON,Unknown
AGL,SZLU9259952,01/24/2024,Sale,-240.0,0.0,4,ALLISON,Unknown
AGL,SZLU9275568,01/15/2024,Entry,1600.0,1600.0,0,ALLISON,Unknown
AGL,SZLU9275568,01/23/2024,Sale,-720.0,880.0,8,ALLISON,Unknown
AGL,SZLU9275568,01/26/2024,Sale,-880.0,0.0,11,ALLISON,Unknown
AGL,SZLU9302447,12/30/2023,Entry,1700.0,1700.0,0,BI-COLOR,Unknown
AGL,SZLU9302447,01/13/2024,Sale,-1700.0,0.0,14,BI-COLOR,Unknown
AGL,SZLU9304286,01/28/2024,Entry,1600.0,1600.0,0,SWEET GLOBE,Unknown
AGL,SZLU9304286,01/30/2024,Sale,-1600.0,0.0,2,SWEET GLOBE,Unknown
AGL,SZLU9304537,12/30/2023,Entry,1600.0,1600.0,0,IVORY,Unknown
AGL,SZLU9304537,01/09/2024,Sale,-100.0,1500.0,10,IVORY,Unknown
AGL,SZLU9304537,01/11/2024,Sale,-1500.0,0.0,12,IVORY,Unknown
AGL,SZLU9304990,01/28/2024,Entry,1600.0,1600.0,0,TIMCO,Unknown
AGL,SZLU9304990,02/06/2024,Sale,-1600.0,0.0,9,TIMCO,Unknown
AGL,SZLU9355684,01/02/2024,Entry,1600.0,1600.0,0,TIMCO,Unknown
AGL,SZLU9355684,02/02/2024,Sale,-1600.0,0.0,31,TIMCO,Unknown
AGL,SZLU9395901,12/29/2023,Sale,-80.0,-80.0,0,ALLISON,Unknown
AGL,SZLU9395901,12/30/2023,Entry,1600.0,1520.0,1,ALLISON,Unknown
AGL,SZLU9395901,01/02/2024,Sale,-1520.0,0.0,4,ALLISON,Unknown
AGL,SZLU9578353,01/20/2024,Entry,1600.0,1600.0,0,SWEET FAVORS,Unknown
AGL,SZLU9578353,02/15/2024,Sale,-960.0,640.0,26,SWEET FAVORS,Unknown
AGL,SZLU9578353,02/15/2024,Sale,-160.0,480.0,26,SWEET FAVORS,Unknown
AGL,SZLU9578353,02/17/2024,Sale,-480.0,0.0,28,SWEET FAVORS,Unknown
AGL,TCLU1321702,12/15/2023,Entry,1600.0,1600.0,0,CANDY SNAP,Unknown
AGL,TCLU1321702,01/08/2024,Sale,-1600.0,0.0,24,CANDY SNAP,Unknown
AGL,TEMU9051072,01/20/2024,Entry,1600.0,1600.0,0,SWEET GLOBE,Unknown
AGL,TEMU9051072,01/24/2024,Sale,-80.0,1520.0,4,SWEET GLOBE,Unknown
AGL,TEMU9051072,01/25/2024,Sale,-1520.0,0.0,5,SWEET GLOBE,Unknown
AGL,TEMU9620862,12/30/2023,Entry,1600.0,1600.0,0,IVORY,Unknown
AGL,TEMU9620862,01/06/2024,Sale,-160.0,1440.0,7,IVORY,Unknown
AGL,TEMU9620862,01/06/2024,Sale,-480.0,960.0,7,IVORY,Unknown
AGL,TEMU9620862,01/06/2024,Sale,-560.0,400.0,7,IVORY,Unknown
AGL,TEMU9620862,01/09/2024,Sale,-400.0,0.0,10,IVORY,Unknown
AGL,TEMU9621010,12/28/2023,Sale,-1700.0,-1700.0,0,ALLISON,Unknown
AGL,TEMU9621010,12/30/2023,Entry,1700.0,0.0,2,ALLISON,Unknown
AGL,TEMU9622119,01/22/2024,Sale,-800.0,-800.0,0,SWEET GLOBE,Unknown
AGL,TEMU9622119,01/23/2024,Entry,1600.0,800.0,1,SWEET GLOBE,Unknown
AGL,TEMU9622119,01/25/2024,Sale,-800.0,0.0,3,SWEET GLOBE,Unknown
AGL,TEMU9622295,12/27/2023,Entry,1600.0,1600.0,0,SWEET GLOBE,Unknown
AGL,TEMU9622295,01/08/2024,Sale,-880.0,720.0,12,SWEET GLOBE,Unknown
AGL,TEMU9622295,01/08/2024,Sale,-160.0,560.0,12,SWEET GLOBE,Unknown
AGL,TEMU9622295,01/09/2024,Sale,-560.0,0.0,13,SWEET GLOBE,Unknown
AGL,TEMU9624560,12/30/2023,Entry,1600.0,1600.0,0,CANDY SNAP,Unknown
AGL,TEMU9624560,01/12/2024,Sale,-1600.0,0.0,13,CANDY SNAP,Unknown
AGL,TEMU9750110,12/27/2023,Entry,1600.0,1600.0,0,SWEET GLOBE,Unknown
AGL,TEMU9750110,01/06/2024,Sale,-320.0,1280.0,10,SWEET GLOBE,Unknown
AGL,TEMU9750110,01/08/2024,Sale,-560.0,720.0,12,SWEET GLOBE,Unknown
AGL,TEMU9750110,01/08/2024,Sale,-640.0,80.0,12,SWEET GLOBE,Unknown
AGL,TEMU9750110,01/09/2024,Sale,-80.0,0.0,13,SWEET GLOBE,Unknown
AGL,TEMU9750151,02/04/2024,Entry,1900.0,1900.0,0,SWEET GLOBE,Unknown
AGL,TEMU9750151,02/15/2024,Sale,-950.0,950.0,11,SWEET GLOBE,Unknown
AGL,TEMU9750151,02/15/2024,Sale,-190.0,760.0,11,SWEET GLOBE,Unknown
AGL,TEMU9750151,02/23/2024,Sale,-760.0,0.0,19,SWEET GLOBE,Unknown
AGL,TEMU9750228,02/04/2024,Entry,1600.0,1600.0,0,SWEET GLOBE,Unknown
AGL,TEMU9750228,02/14/2024,Sale,-1280.0,320.0,10,SWEET GLOBE,Unknown
AGL,TEMU9750228,02/17/2024,Sale,-320.0,0.0,13,SWEET GLOBE,Unknown
AGL,TEMU9787398,01/30/2024,Entry,1600.0,1600.0,0,SWEET GLOBE,Unknown
AGL,TEMU9787398,02/13/2024,Sale,-400.0,1200.0,14,SWEET GLOBE,Unknown
AGL,TEMU9787398,02/13/2024,Sale,-1200.0,0.0,14,SWEET GLOBE,Unknown
AGL,TLLU1156490,02/06/2024,Entry,1600.0,1600.0,0,SWEET GLOBE,Unknown
AGL,TLLU1156490,02/27/2024,Sale,-80.0,1520.0,21,SWEET GLOBE,Unknown
AGL,TLLU1156490,02/29/2024,Sale,-800.0,720.0,23,SWEET GLOBE,Unknown
AGL,TLLU1156490,03/01/2024,Sale,-720.0,0.0,24,SWEET GLOBE,Unknown
AGL,TLLU1189087,01/01/2024,Entry,1600.0,1600.0,0,SWEET FAVORS,Unknown
AGL,TLLU1189087,01/01/2024,Sale,-1600.0,0.0,0,SWEET FAVORS,Unknown
AGL,TRIU8169319,12/31/2023,Entry,1600.0,1600.0,0,ALLISON,Unknown
AGL,TRIU8169319,01/12/2024,Sale,-1600.0,0.0,12,ALLISON,Unknown
AGL,TRIU8499178,01/19/2024,Sale,-80.0,-80.0,0,ALLISON,Unknown
AGL,TRIU8499178,01/19/2024,Sale,-1440.0,-1520.0,0,ALLISON,Unknown
AGL,TRIU8499178,01/22/2024,Entry,1520.0,0.0,3,ALLISON,Unknown
AGL,TRIU8499178,01/22/2024,Entry,80.0,80.0,3,TIMCO,Unknown
AGL,TRIU8499178,01/27/2024,Sale,-80.0,0.0,8,TIMCO,Unknown
AGL,TRIU8759402,01/20/2024,Entry,1600.0,1600.0,0,ALLISON,Unknown
AGL,TRIU8759402,01/23/2024,Sale,-880.0,720.0,3,ALLISON,Unknown
AGL,TRIU8759402,01/26/2024,Sale,-720.0,0.0,6,ALLISON,Unknown
AGL,TRIU8786352,01/20/2024,Entry,1600.0,1600.0,0,CANDY DREAMS,Unknown
AGL,TRIU8786352,02/05/2024,Sale,-320.0,1280.0,16,CANDY DREAMS,Unknown
AGL,TRIU8786352,02/05/2024,Sale,-80.0,1200.0,16,CANDY DREAMS,Unknown
AGL,TRIU8786352,02/06/2024,Sale,-1200.0,0.0,17,CANDY DREAMS,Unknown
AGL,TRIU8963782,01/20/2024,Entry,1600.0,1600.0,0,ALLISON,Unknown
AGL,TRIU8963782,01/26/2024,Sale,-160.0,1440.0,6,ALLISON,Unknown
AGL,TRIU8963782,01/29/2024,Sale,-1440.0,0.0,9,ALLISON,Unknown
AGL,TTNU8011720,12/30/2023,Entry,1600.0,1600.0,0,CANDY DREAMS,Unknown
AGL,TTNU8011720,01/24/2024,Sale,-400.0,1200.0,25,CANDY DREAMS,Unknown
AGL,TTNU8011720,01/25/2024,Sale,-800.0,400.0,26,CANDY DREAMS,Unknown
AGL,TTNU8011720,01/27/2024,Sale,-400.0,0.0,28,CANDY DREAMS,Unknown
AGL,TTNU8114482,12/30/2023,Entry,1600.0,1600.0,0,SWEET GLOBE,Unknown
AGL,TTNU8114482,01/22/2024,Sale,-1600.0,0.0,23,SWEET GLOBE,Unknown
AGL,TTNU8127181,01/23/2024,Entry,1600.0,1600.0,0,TIMCO,Unknown
AGL,TTNU8127181,02/05/2024,Sale,-1600.0,0.0,13,TIMCO,Unknown
AGL,TTNU8509034,02/04/2024,Entry,1600.0,1600.0,0,SWEET GLOBE,Unknown
AGL,TTNU8509034,02/21/2024,Sale,-640.0,960.0,17,SWEET GLOBE,Unknown
AGL,TTNU8509034,02/22/2024,Sale,-480.0,480.0,18,SWEET GLOBE,Unknown
AGL,TTNU8509034,02/23/2024,Sale,-480.0,0.0,19,SWEET GLOBE,Unknown
AGL,TTNU8510360,12/30/2023,Entry,1600.0,1600.0,0,ALLISON,Unknown
AGL,TTNU8510360,01/22/2024,Sale,-1520.0,80.0,23,ALLISON,Unknown
AGL,TTNU8510360,01/23/2024,Sale,-80.0,0.0,24,ALLISON,Unknown
AGL,TTNU8708798,01/23/2024,Entry,1600.0,1600.0,0,TIMCO,Unknown
AGL,TTNU8708798,02/05/2024,Sale,-640.0,960.0,13,TIMCO,Unknown
AGL,TTNU8708798,02/06/2024,Sale,-960.0,0.0,14,TIMCO,Unknown
AGL,TTNU8716999,12/31/2023,Entry,1600.0,1600.0,0,ALLISON,Unknown
AGL,TTNU8716999,01/05/2024,Sale,-1600.0,0.0,5,ALLISON,Unknown
AGL,ZMOU8815767,01/10/2024,Entry,1600.0,1600.0,0,ALLISON,Unknown
AGL,ZMOU8815767,01/23/2024,Sale,-240.0,1360.0,13,ALLISON,Unknown
AGL,ZMOU8815767,01/24/2024,Sale,-560.0,800.0,14,ALLISON,Unknown
AGL,ZMOU8815767,01/24/2024,Sale,-800.0,0.0,14,ALLISON,Unknown
AGL,ZMOU8899048,02/04/2024,Entry,1600.0,1600.0,0,SWEET GLOBE,Unknown
AGL,ZMOU8899048,02/19/2024,Sale,-320.0,1280.0,15,SWEET GLOBE,Unknown
AGL,ZMOU8899048,02/21/2024,Sale,-1280.0,0.0,17,SWEET GLOBE,Unknown
AGL,ZMOU8936990,02/04/2024,Entry,1600.0,1600.0,0,SWEET GLOBE,Unknown
AGL,ZMOU8936990,02/19/2024,Sale,-1600.0,0.0,15,SWEET GLOBE,Unknown
BORQUEZ,24TRA101481,05/21/2024,Entry,990.0,990.0,0,FLAME,Bag
BORQUEZ,24TRA101481,05/22/2024,Sale,-90.0,900.0,1,FLAME,Bag
BORQUEZ,24TRA101481,05/22/2024,Sale,-270.0,630.0,1,FLAME,Bag
BORQUEZ,24TRA101481,05/23/2024,Sale,-90.0,540.0,2,FLAME,Bag
BORQUEZ,24TRA101481,05/23/2024,Sale,-450.0,90.0,2,FLAME,Bag
BORQUEZ,24TRA101481,05/23/2024,Sale,-90.0,0.0,2,FLAME,Bag
BORQUEZ,24TRA101484,05/23/2024,Entry,900.0,900.0,0,FLAME,Bag
BORQUEZ,24TRA101484,05/23/2024,Sale,-90.0,810.0,0,FLAME,Bag
BORQUEZ,24TRA101484,05/24/2024,Sale,-180.0,630.0,1,FLAME,Bag
BORQUEZ,24TRA101484,05/24/2024,Sale,-630.0,0.0,1,FLAME,Bag
BORQUEZ,24TRA101486,05/25/2024,Entry,2240.0,2240.0,0,FLAME,Clam
BORQUEZ,24TRA101486,05/25/2024,Sale,-1920.0,320.0,0,FLAME,Clam
BORQUEZ,24TRA101486,05/25/2024,Sale,-320.0,0.0,0,FLAME,Clam
BORQUEZ,24TRA101487,05/25/2024,Entry,2520.0,2520.0,0,FLAME,Bag
BORQUEZ,24TRA101487,05/25/2024,Sale,-90.0,2430.0,0,FLAME,Bag
BORQUEZ,24TRA101487,05/25/2024,Sale,-90.0,2340.0,0,FLAME,Bag
BORQUEZ,24TRA101487,05/27/2024,Sale,-810.0,1530.0,2,FLAME,Bag
BORQUEZ,24TRA101487,05/27/2024,Sale,-1440.0,90.0,2,FLAME,Bag
BORQUEZ,24TRA101487,05/30/2024,Sale,-90.0,0.0,5,FLAME,Bag
BORQUEZ,24TRA101488,05/25/2024,Entry,1520.0,1520.0,0,FLAME,Clam
BORQUEZ,24TRA101488,05/25/2024,Sale,-1280.0,240.0,0,FLAME,Clam
BORQUEZ,24TRA101488,05/27/2024,Sale,-240.0,0.0,2,FLAME,Clam
BORQUEZ,24TRA101490,05/27/2024,Entry,2340.0,2340.0,0,FLAME,Bag
BORQUEZ,24TRA101490,05/30/2024,Sale,-630.0,1710.0,3,FLAME,Bag
BORQUEZ,24TRA101490,05/31/2024,Sale,-990.0,720.0,4,FLAME,Bag
BORQUEZ,24TRA101490,06/03/2024,Sale,-720.0,0.0,7,FLAME,Bag
BORQUEZ,24TRA101491,05/26/2024,Entry,2240.0,2240.0,0,FLAME,Clam
BORQUEZ,24TRA101491,05/27/2024,Sale,-1680.0,560.0,1,FLAME,Clam
BORQUEZ,24TRA101491,05/27/2024,Sale,-240.0,320.0,1,FLAME,Clam
BORQUEZ,24TRA101491,05/27/2024,Sale,-320.0,0.0,1,FLAME,Clam
BORQUEZ,24TRA101492,05/26/2024,Entry,450.0,450.0,0,FLAME,Bag
BORQUEZ,24TRA101492,05/26/2024,Entry,1725.0,2175.0,0,FLAME,Bag
BORQUEZ,24TRA101492,05/28/2024,Sale,-180.0,1995.0,2,FLAME,Bag
BORQUEZ,24TRA101492,05/30/2024,Sale,-270.0,1725.0,4,FLAME,Bag
BORQUEZ,24TRA101492,06/03/2024,Sale,-750.0,975.0,8,FLAME,Clam
BORQUEZ,24TRA101492,06/03/2024,Sale,-900.0,75.0,8,FLAME,Clam
BORQUEZ,24TRA101492,06/04/2024,Sale,-75.0,0.0,9,FLAME,Clam
BORQUEZ,24TRA101493,05/27/2024,Entry,2160.0,2160.0,0,FLAME,Clam
BORQUEZ,24TRA101493,05/27/2024,Sale,-1680.0,480.0,0,FLAME,Clam
BORQUEZ,24TRA101493,05/27/2024,Sale,-240.0,240.0,0,FLAME,Clam
BORQUEZ,24TRA101493,05/30/2024,Sale,-240.0,0.0,3,FLAME,Clam
BORQUEZ,24TRA101495,05/27/2024,Entry,2520.0,2520.0,0,FLAME,Bag
BORQUEZ,24TRA101495,06/07/2024,Sale,-1260.0,1260.0,11,FLAME,Bag
BORQUEZ,24TRA101495,06/07/2024,Sale,-90.0,1170.0,11,FLAME,Bag
BORQUEZ,24TRA101495,06/07/2024,Sale,-540.0,630.0,11,FLAME,Bag
BORQUEZ,24TRA101495,06/07/2024,Sale,-540.0,90.0,11,FLAME,Bag
BORQUEZ,24TRA101495,06/08/2024,Sale,-90.0,0.0,12,FLAME,Bag
BORQUEZ,24TRA101497,05/27/2024,Entry,2520.0,2520.0,0,FLAME,Bag
BORQUEZ,24TRA101497,06/07/2024,Sale,-1170.0,1350.0,11,FLAME,Bag
BORQUEZ,24TRA101497,06/07/2024,Sale,-990.0,360.0,11,FLAME,Bag
BORQUEZ,24TRA101497,06/08/2024,Sale,-360.0,0.0,12,FLAME,Bag
BORQUEZ,24TRA101498,05/27/2024,Entry,150.0,150.0,0,FLAME,Clam
BORQUEZ,24TRA101498,05/27/2024,Entry,960.0,1110.0,0,FLAME,Clam
BORQUEZ,24TRA101498,05/27/2024,Entry,825.0,1935.0,0,FLAME,Clam
BORQUEZ,24TRA101498,05/28/2024,Sale,-150.0,1785.0,1,FLAME,Clam
BORQUEZ,24TRA101498,05/31/2024,Sale,-825.0,960.0,4,FLAME,Bag
BORQUEZ,24TRA101498,06/04/2024,Sale,-320.0,640.0,8,FLAME,Clam
BORQUEZ,24TRA101498,06/04/2024,Sale,-400.0,240.0,8,FLAME,Clam
BORQUEZ,24TRA101498,06/08/2024,Sale,-240.0,0.0,12,FLAME,Clam
BORQUEZ,24TRA101499,05/28/2024,Entry,1710.0,1710.0,0,FLAME,Bag
BORQUEZ,24TRA101499,05/28/2024,Sale,-180.0,1530.0,0,FLAME,Bag
BORQUEZ,24TRA101499,05/29/2024,Sale,-990.0,540.0,1,FLAME,Bag
BORQUEZ,24TRA101499,05/31/2024,Sale,-270.0,270.0,3,FLAME,Bag
BORQUEZ,24TRA101499,05/31/2024,Sale,-180.0,90.0,3,FLAME,Bag
BORQUEZ,24TRA101499,06/08/2024,Sale,-90.0,0.0,11,FLAME,Bag
BORQUEZ,24TRA101502,05/28/2024,Entry,2520.0,2520.0,0,FLAME,Bag
BORQUEZ,24TRA101502,05/30/2024,Sale,-1080.0,1440.0,2,FLAME,Bag
BORQUEZ,24TRA101502,05/31/2024,Sale,-720.0,720.0,3,FLAME,Bag
BORQUEZ,24TRA101502,06/01/2024,Sale,-90.0,630.0,4,FLAME,Bag
BORQUEZ,24TRA101502,06/04/2024,Sale,-90.0,540.0,7,FLAME,Bag
BORQUEZ,24TRA101502,06/05/2024,Sale,-540.0,0.0,8,FLAME,Bag
BORQUEZ,24TRA101503,05/28/2024,Entry,2520.0,2520.0,0,FLAME,Bag
BORQUEZ,24TRA101503,05/31/2024,Sale,-900.0,1620.0,3,FLAME,Bag
BORQUEZ,24TRA101503,06/04/2024,Sale,-1620.0,0.0,7,FLAME,Bag
BORQUEZ,24TRA101504,05/28/2024,Entry,2100.0,2100.0,0,FLAME,Bag
BORQUEZ,24TRA101504,05/31/2024,Sale,-900.0,1200.0,3,FLAME,Bag
BORQUEZ,24TRA101504,06/03/2024,Sale,-750.0,450.0,6,FLAME,Bag
BORQUEZ,24TRA101504,06/04/2024,Sale,-450.0,0.0,7,FLAME,Bag
BORQUEZ,24TRA101505,05/28/2024,Entry,2520.0,2520.0,0,FLAME,Bag
BORQUEZ,24TRA101505,06/01/2024,Sale,-540.0,1980.0,4,FLAME,Bag
BORQUEZ,24TRA101505,06/03/2024,Sale,-1890.0,90.0,6,FLAME,Bag
BORQUEZ,24TRA101505,06/13/2024,Sale,-90.0,0.0,16,FLAME,Bag
BORQUEZ,24TRA101514,05/29/2024,Entry,960.0,960.0,0,FLAME,Clam
BORQUEZ,24TRA101514,06/14/2024,Sale,-960.0,0.0,16,FLAME,Clam
BORQUEZ,24TRA101515,05/29/2024,Entry,2240.0,2240.0,0,FLAME,Clam
BORQUEZ,24TRA101515,06/08/2024,Sale,-1360.0,880.0,10,FLAME,Clam
BORQUEZ,24TRA101515,06/10/2024,Sale,-160.0,720.0,12,FLAME,Clam
BORQUEZ,24TRA101515,06/13/2024,Sale,-320.0,400.0,15,FLAME,Clam
BORQUEZ,24TRA101515,06/14/2024,Sale,-400.0,0.0,16,FLAME,Clam
BORQUEZ,24TRA101516,05/30/2024,Entry,2240.0,2240.0,0,FLAME,Clam
BORQUEZ,24TRA101516,05/31/2024,Sale,-240.0,2000.0,1,FLAME,Clam
BORQUEZ,24TRA101516,06/01/2024,Sale,-160.0,1840.0,2,FLAME,Clam
BORQUEZ,24TRA101516,06/04/2024,Sale,-1600.0,240.0,5,FLAME,Clam
BORQUEZ,24TRA101516,06/06/2024,Sale,-160.0,80.0,7,FLAME,Clam
BORQUEZ,24TRA101516,06/14/2024,Sale,-80.0,0.0,15,FLAME,Clam
BORQUEZ,24TRA101517,05/30/2024,Entry,2100.0,2100.0,0,FLAME,Bag
BORQUEZ,24TRA101517,06/01/2024,Sale,-750.0,1350.0,2,FLAME,Bag
BORQUEZ,24TRA101517,06/04/2024,Sale,-1200.0,150.0,5,FLAME,Bag
BORQUEZ,24TRA101517,06/06/2024,Sale,-75.0,75.0,7,FLAME,Bag
BORQUEZ,24TRA101517,06/07/2024,Sale,-75.0,0.0,8,FLAME,Bag
BORQUEZ,24TRA101518,05/30/2024,Entry,2520.0,2520.0,0,FLAME,Bag
BORQUEZ,24TRA101518,05/31/2024,Sale,-360.0,2160.0,1,FLAME,Bag
BORQUEZ,24TRA101518,05/31/2024,Sale,-270.0,1890.0,1,FLAME,Bag
BORQUEZ,24TRA101518,05/31/2024,Sale,-90.0,1800.0,1,FLAME,Bag
BORQUEZ,24TRA101518,06/04/2024,Sale,-720.0,1080.0,5,FLAME,Bag
BORQUEZ,24TRA101518,06/07/2024,Sale,-720.0,360.0,8,FLAME,Bag
BORQUEZ,24TRA101518,06/08/2024,Sale,-180.0,180.0,9,FLAME,Bag
BORQUEZ,24TRA101518,06/08/2024,Sale,-180.0,0.0,9,FLAME,Bag
BORQUEZ,24TRA101519,05/30/2024,Entry,2520.0,2520.0,0,FLAME,Bag
BORQUEZ,24TRA101519,06/05/2024,Sale,-1440.0,1080.0,6,FLAME,Bag
BORQUEZ,24TRA101519,06/08/2024,Sale,-270.0,810.0,9,FLAME,Bag
BORQUEZ,24TRA101519,06/10/2024,Sale,-810.0,0.0,11,FLAME,Bag
BORQUEZ,24TRA101520,05/30/2024,Entry,2100.0,2100.0,0,FLAME,Bag
BORQUEZ,24TRA101520,06/01/2024,Sale,-750.0,1350.0,2,FLAME,Bag
BORQUEZ,24TRA101520,06/03/2024,Sale,-1200.0,150.0,4,FLAME,Bag
BORQUEZ,24TRA101520,06/04/2024,Sale,-150.0,0.0,5,FLAME,Bag
BORQUEZ,24TRA101523,05/31/2024,Entry,2100.0,2100.0,0,FLAME,Bag
BORQUEZ,24TRA101523,06/04/2024,Sale,-750.0,1350.0,4,FLAME,Bag
BORQUEZ,24TRA101523,06/04/2024,Sale,-750.0,600.0,4,FLAME,Bag
BORQUEZ,24TRA101523,06/05/2024,Sale,-375.0,225.0,5,FLAME,Bag
BORQUEZ,24TRA101523,06/07/2024,Sale,-150.0,75.0,7,FLAME,Bag
BORQUEZ,24TRA101523,06/07/2024,Sale,-75.0,0.0,7,FLAME,Bag
BORQUEZ,24TRA101524,05/31/2024,Entry,2100.0,2100.0,0,FLAME,Bag
BORQUEZ,24TRA101524,06/05/2024,Sale,-825.0,1275.0,5,FLAME,Bag
BORQUEZ,24TRA101524,06/06/2024,Sale,-1125.0,150.0,6,FLAME,Bag
BORQUEZ,24TRA101524,06/07/2024,Sale,-150.0,0.0,7,FLAME,Bag
BORQUEZ,24TRA101526,05/31/2024,Entry,2100.0,2100.0,0,FLAME,Unknown
BORQUEZ,24TRA101526,06/04/2024,Sale,-225.0,1875.0,4,FLAME,Unknown
BORQUEZ,24TRA101526,06/05/2024,Sale,-825.0,1050.0,5,FLAME,Unknown
BORQUEZ,24TRA101526,06/05/2024,Sale,-675.0,375.0,5,FLAME,Unknown
BORQUEZ,24TRA101526,06/07/2024,Sale,-150.0,225.0,7,FLAME,Unknown
BORQUEZ,24TRA101526,06/12/2024,Sale,-150.0,75.0,12,FLAME,Unknown
BORQUEZ,24TRA101526,06/21/2024,Sale,-75.0,0.0,21,FLAME,Unknown
BORQUEZ,24TRA101527,05/31/2024,Entry,2100.0,2100.0,0,FLAME,Bag
BORQUEZ,24TRA101527,06/04/2024,Sale,-1200.0,900.0,4,FLAME,Bag
BORQUEZ,24TRA101527,06/04/2024,Sale,-225.0,675.0,4,FLAME,Bag
BORQUEZ,24TRA101527,06/05/2024,Sale,-675.0,0.0,5,FLAME,Bag
BORQUEZ,24TRA101528,05/31/2024,Entry,480.0,480.0,0,FLAME,Clam
BORQUEZ,24TRA101528,06/14/2024,Sale,-160.0,320.0,14,FLAME,Clam
BORQUEZ,24TRA101528,06/17/2024,Sale,-320.0,0.0,17,FLAME,Clam
BORQUEZ,24TRA101531,05/31/2024,Entry,2240.0,2240.0,0,FLAME,Clam
BORQUEZ,24TRA101531,06/17/2024,Sale,-80.0,2160.0,17,FLAME,Clam
BORQUEZ,24TRA101531,06/17/2024,Sale,-1440.0,720.0,17,FLAME,Clam
BORQUEZ,24TRA101531,06/18/2024,Sale,-560.0,160.0,18,FLAME,Clam
BORQUEZ,24TRA101531,07/19/2024,Sale,-160.0,0.0,49,FLAME,Clam
BORQUEZ,24TRA101532,06/01/2024,Entry,2240.0,2240.0,0,FLAME,Clam
BORQUEZ,24TRA101532,06/18/2024,Sale,-800.0,1440.0,17,FLAME,Clam
BORQUEZ,24TRA101532,06/18/2024,Sale,-1440.0,0.0,17,FLAME,Clam
BORQUEZ,24TRA101534,06/01/2024,Entry,2520.0,2520.0,0,FLAME,Bag
BORQUEZ,24TRA101534,06/03/2024,Sale,-90.0,2430.0,2,FLAME,Bag
BORQUEZ,24TRA101534,06/04/2024,Sale,-360.0,2070.0,3,FLAME,Bag
BORQUEZ,24TRA101534,06/10/2024,Sale,-1890.0,180.0,9,FLAME,Bag
BORQUEZ,24TRA101534,06/12/2024,Sale,-180.0,0.0,11,FLAME,Bag
BORQUEZ,24TRA101535,06/01/2024,Entry,2240.0,2240.0,0,FLAME,Clam
BORQUEZ,24TRA101535,06/17/2024,Sale,-240.0,2000.0,16,FLAME,Clam
BORQUEZ,24TRA101535,06/17/2024,Sale,-480.0,1520.0,16,FLAME,Clam
BORQUEZ,24TRA101535,06/17/2024,Sale,-1280.0,240.0,16,FLAME,Clam
BORQUEZ,24TRA101535,06/18/2024,Sale,-240.0,0.0,17,FLAME,Clam
BORQUEZ,24TRA101536,06/01/2024,Entry,1200.0,1200.0,0,FLAME,Clam
BORQUEZ,24TRA101536,06/01/2024,Entry,975.0,2175.0,0,FLAME,Clam
BORQUEZ,24TRA101536,06/03/2024,Sale,-975.0,1200.0,2,FLAME,Clam
BORQUEZ,24TRA101536,06/18/2024,Sale,-480.0,720.0,17,FLAME,Clam
BORQUEZ,24TRA101536,07/19/2024,Sale,-720.0,0.0,48,FLAME,Clam
BORQUEZ,24TRA101537,06/01/2024,Entry,675.0,675.0,0,FLAME,Clam
BORQUEZ,24TRA101537,06/03/2024,Sale,-675.0,0.0,2,FLAME,Clam
BORQUEZ,24TRA101539,06/02/2024,Entry,2520.0,2520.0,0,FLAME,Bag
BORQUEZ,24TRA101539,06/04/2024,Sale,-900.0,1620.0,2,FLAME,Bag
BORQUEZ,24TRA101539,06/12/2024,Sale,-180.0,1440.0,10,FLAME,Bag
BORQUEZ,24TRA101539,06/13/2024,Sale,-360.0,1080.0,11,FLAME,Bag
BORQUEZ,24TRA101539,06/13/2024,Sale,-1080.0,0.0,11,FLAME,Bag
BORQUEZ,24TRA101540,06/02/2024,Entry,2100.0,2100.0,0,FLAME,Clam
BORQUEZ,24TRA101540,06/03/2024,Sale,-1800.0,300.0,1,FLAME,Clam
BORQUEZ,24TRA101540,06/03/2024,Sale,-150.0,150.0,1,FLAME,Clam
BORQUEZ,24TRA101540,06/04/2024,Sale,-150.0,0.0,2,FLAME,Clam
BORQUEZ,24TRA101542,06/02/2024,Entry,2520.0,2520.0,0,FLAME,Bag
BORQUEZ,24TRA101542,06/12/2024,Sale,-1800.0,720.0,10,FLAME,Bag
BORQUEZ,24TRA101542,06/13/2024,Sale,-720.0,0.0,11,FLAME,Bag
BORQUEZ,24TRA101546,06/02/2024,Entry,2520.0,2520.0,0,FLAME,Bag
BORQUEZ,24TRA101546,06/13/2024,Sale,-810.0,1710.0,11,FLAME,Bag
BORQUEZ,24TRA101546,06/14/2024,Sale,-270.0,1440.0,12,FLAME,Bag
BORQUEZ,24TRA101546,06/14/2024,Sale,-1260.0,180.0,12,FLAME,Bag
BORQUEZ,24TRA101546,06/18/2024,Sale,-90.0,90.0,16,FLAME,Bag
BORQUEZ,24TRA101547,06/02/2024,Entry,2100.0,2100.0,0,FLAME,Clam
BORQUEZ,24TRA101547,06/05/2024,Sale,-300.0,1800.0,3,FLAME,Clam
BORQUEZ,24TRA101547,06/08/2024,Sale,-375.0,1425.0,6,FLAME,Clam
BORQUEZ,24TRA101547,06/12/2024,Sale,-150.0,1275.0,10,FLAME,Clam
BORQUEZ,24TRA101547,06/14/2024,Sale,-75.0,1200.0,12,FLAME,Clam
BORQUEZ,24TRA101547,06/18/2024,Sale,-750.0,450.0,16,FLAME,Clam
BORQUEZ,24TRA101547,06/21/2024,Sale,-450.0,0.0,19,FLAME,Clam
BORQUEZ,24TRA101548,06/02/2024,Entry,2520.0,2520.0,0,FLAME,Bag
BORQUEZ,24TRA101548,06/08/2024,Sale,-180.0,2340.0,6,FLAME,Bag
BORQUEZ,24TRA101548,06/20/2024,Sale,-90.0,2250.0,18,FLAME,Bag
BORQUEZ,24TRA101548,06/20/2024,Sale,-720.0,1530.0,18,FLAME,Bag
BORQUEZ,24TRA101548,06/21/2024,Sale,-450.0,1080.0,19,FLAME,Bag
BORQUEZ,24TRA101548,06/21/2024,Sale,-630.0,450.0,19,FLAME,Bag
BORQUEZ,24TRA101550,06/02/2024,Entry,1440.0,1440.0,0,FLAME,Bag
BORQUEZ,24TRA101550,06/10/2024,Sale,-1440.0,0.0,8,FLAME,Bag
BORQUEZ,24TRA101552,06/02/2024,Entry,1500.0,1500.0,0,FLAME,Bag
BORQUEZ,24TRA101552,06/02/2024,Entry,450.0,1950.0,0,FLAME,Bag
BORQUEZ,24TRA101552,06/04/2024,Sale,-225.0,1725.0,2,FLAME,Bag
BORQUEZ,24TRA101552,06/05/2024,Sale,-1500.0,225.0,3,FLAME,Clam
BORQUEZ,24TRA101552,06/06/2024,Sale,-225.0,0.0,4,FLAME,Bag
BORQUEZ,24TRA101556,06/03/2024,Entry,2520.0,2520.0,0,FLAME,Bag
BORQUEZ,24TRA101556,06/03/2024,Sale,-90.0,2430.0,0,FLAME,Bag
BORQUEZ,24TRA101556,06/10/2024,Sale,-1980.0,450.0,7,FLAME,Bag
BORQUEZ,24TRA101556,06/10/2024,Sale,-450.0,0.0,7,FLAME,Bag
BORQUEZ,24TRA101559,06/03/2024,Entry,2100.0,2100.0,0,FLAME,Clam
BORQUEZ,24TRA101559,06/04/2024,Sale,-1650.0,450.0,1,FLAME,Clam
BORQUEZ,24TRA101559,06/05/2024,Sale,-300.0,150.0,2,FLAME,Clam
BORQUEZ,24TRA101559,06/07/2024,Sale,-150.0,0.0,4,FLAME,Clam
BORQUEZ,24TRA101562,06/03/2024,Entry,450.0,450.0,0,FLAME,Clam
BORQUEZ,24TRA101562,06/06/2024,Sale,-300.0,150.0,3,FLAME,Clam
BORQUEZ,24TRA101562,06/21/2024,Sale,-150.0,0.0,18,FLAME,Clam
BORQUEZ,24TRA101564,06/03/2024,Entry,2520.0,2520.0,0,FLAME,Bag
BORQUEZ,24TRA101564,06/11/2024,Sale,-2160.0,360.0,8,FLAME,Bag
BORQUEZ,24TRA101564,06/11/2024,Sale,-270.0,90.0,8,FLAME,Bag
BORQUEZ,24TRA101564,06/12/2024,Sale,-90.0,0.0,9,FLAME,Bag
BORQUEZ,24TRA101565,06/03/2024,Entry,2430.0,2430.0,0,FLAME,Bag
BORQUEZ,24TRA101565,06/11/2024,Sale,-540.0,1890.0,8,FLAME,Bag
BORQUEZ,24TRA101565,06/11/2024,Sale,-1890.0,0.0,8,FLAME,Bag
BORQUEZ,24TRA101568,06/03/2024,Entry,90.0,90.0,0,FLAME,Bag
BORQUEZ,24TRA101568,06/03/2024,Entry,1710.0,1800.0,0,FLAME,Bag
BORQUEZ,24TRA101568,06/03/2024,Entry,600.0,2400.0,0,FLAME,Bag
BORQUEZ,24TRA101568,06/04/2024,Sale,-1710.0,690.0,1,FLAME,Bag
BORQUEZ,24TRA101568,06/06/2024,Sale,-75.0,615.0,3,FLAME,Clam
BORQUEZ,24TRA101568,06/07/2024,Sale,-90.0,525.0,4,FLAME,Bag
BORQUEZ,24TRA101568,06/21/2024,Sale,-225.0,300.0,18,FLAME,Clam
BORQUEZ,24TRA101568,06/21/2024,Sale,-75.0,225.0,18,FLAME,Clam
BORQUEZ,24TRA101568,06/25/2024,Sale,-225.0,0.0,22,FLAME,Clam
BORQUEZ,24TRA101569,06/04/2024,Entry,2520.0,2520.0,0,FLAME,Bag
BORQUEZ,24TRA101569,06/11/2024,Sale,-450.0,2070.0,7,FLAME,Bag
BORQUEZ,24TRA101569,06/12/2024,Sale,-180.0,1890.0,8,FLAME,Bag
BORQUEZ,24TRA101569,06/12/2024,Sale,-1890.0,0.0,8,FLAME,Bag
BORQUEZ,24TRA101570,06/04/2024,Entry,2520.0,2520.0,0,FLAME,Bag
BORQUEZ,24TRA101570,06/11/2024,Sale,-990.0,1530.0,7,FLAME,Bag
BORQUEZ,24TRA101570,06/12/2024,Sale,-1350.0,180.0,8,FLAME,Bag
BORQUEZ,24TRA101570,06/13/2024,Sale,-180.0,0.0,9,FLAME,Bag
BORQUEZ,24TRA101572,06/04/2024,Entry,2100.0,2100.0,0,FLAME,Unknown
BORQUEZ,24TRA101572,06/07/2024,Sale,-75.0,2025.0,3,FLAME,Unknown
BORQUEZ,24TRA101572,06/07/2024,Sale,-150.0,1875.0,3,FLAME,Unknown
BORQUEZ,24TRA101572,06/10/2024,Sale,-225.0,1650.0,6,FLAME,Unknown
BORQUEZ,24TRA101572,06/11/2024,Sale,-150.0,1500.0,7,FLAME,Unknown
BORQUEZ,24TRA101572,06/14/2024,Sale,-150.0,1350.0,10,FLAME,Unknown
BORQUEZ,24TRA101572,06/15/2024,Sale,-75.0,1275.0,11,FLAME,Unknown
BORQUEZ,24TRA101572,06/17/2024,Sale,-75.0,1200.0,13,FLAME,Unknown
BORQUEZ,24TRA101572,06/21/2024,Sale,-300.0,900.0,17,FLAME,Bag
BORQUEZ,24TRA101572,06/21/2024,Sale,-75.0,825.0,17,FLAME,Bag
BORQUEZ,24TRA101572,06/21/2024,Sale,-150.0,675.0,17,FLAME,Unknown
BORQUEZ,24TRA101572,06/22/2024,Sale,-323.0,352.0,18,FLAME,Bag
BORQUEZ,24TRA101572,06/22/2024,Sale,-75.0,277.0,18,FLAME,Unknown
BORQUEZ,24TRA101572,06/27/2024,Sale,-75.0,202.0,23,FLAME,Unknown
BORQUEZ,24TRA101572,07/02/2024,Sale,-75.0,127.0,28,FLAME,Unknown
BORQUEZ,24TRA101573,06/05/2024,Entry,2160.0,2160.0,0,FLAME,Bag
BORQUEZ,24TRA101573,06/12/2024,Sale,-720.0,1440.0,7,FLAME,Bag
BORQUEZ,24TRA101573,06/13/2024,Sale,-180.0,1260.0,8,FLAME,Bag
BORQUEZ,24TRA101573,07/20/2024,Sale,-136.0,1124.0,45,FLAME,Bag
BORQUEZ,24TRA101574,06/04/2024,Entry,1800.0,1800.0,0,FLAME,Bag
BORQUEZ,24TRA101574,06/04/2024,Entry,150.0,1950.0,0,FLAME,Bag
BORQUEZ,24TRA101574,06/05/2024,Sale,-1800.0,150.0,1,FLAME,Bag
BORQUEZ,24TRA101574,06/13/2024,Sale,-150.0,0.0,9,FLAME,Clam
BORQUEZ,24TRA101576,06/04/2024,Entry,1500.0,1500.0,0,FLAME,Unknown
BORQUEZ,24TRA101576,06/06/2024,Sale,-450.0,1050.0,2,FLAME,Unknown
BORQUEZ,24TRA101576,06/07/2024,Sale,-150.0,900.0,3,FLAME,Unknown
BORQUEZ,24TRA101576,06/08/2024,Sale,-150.0,750.0,4,FLAME,Unknown
BORQUEZ,24TRA101576,06/10/2024,Sale,-150.0,600.0,6,FLAME,Unknown
BORQUEZ,24TRA101576,06/10/2024,Sale,-150.0,450.0,6,FLAME,Unknown
BORQUEZ,24TRA101576,06/21/2024,Sale,-150.0,300.0,17,FLAME,Unknown
BORQUEZ,24TRA101576,07/03/2024,Sale,-150.0,150.0,29,FLAME,Unknown
BORQUEZ,24TRA101576,07/05/2024,Sale,-75.0,75.0,31,FLAME,Unknown
BORQUEZ,24TRA101576,07/20/2024,Sale,-75.0,0.0,46,FLAME,Unknown
BORQUEZ,24TRA101577,06/04/2024,Entry,2520.0,2520.0,0,FLAME,Bag
BORQUEZ,24TRA101577,06/12/2024,Sale,-1980.0,540.0,8,FLAME,Bag
BORQUEZ,24TRA101577,06/12/2024,Sale,-540.0,0.0,8,FLAME,Bag
BORQUEZ,24TRA101579,06/05/2024,Entry,2520.0,2520.0,0,FLAME,Bag
BORQUEZ,24TRA101579,06/06/2024,Sale,-1980.0,540.0,1,FLAME,Bag
BORQUEZ,24TRA101579,06/08/2024,Sale,-540.0,0.0,3,FLAME,Bag
BORQUEZ,24TRA101580,06/05/2024,Entry,2520.0,2520.0,0,FLAME,Bag
BORQUEZ,24TRA101580,06/05/2024,Sale,-180.0,2340.0,0,FLAME,Bag
BORQUEZ,24TRA101580,06/06/2024,Sale,-1980.0,360.0,1,FLAME,Bag
BORQUEZ,24TRA101580,06/07/2024,Sale,-180.0,180.0,2,FLAME,Bag
BORQUEZ,24TRA101580,06/08/2024,Sale,-180.0,0.0,3,FLAME,Bag
BORQUEZ,24TRA101581,06/05/2024,Entry,750.0,750.0,0,FLAME,Clam
BORQUEZ,24TRA101581,06/07/2024,Sale,-750.0,0.0,2,FLAME,Clam
BORQUEZ,24TRA101583,06/05/2024,Entry,2160.0,2160.0,0,FLAME,Bag
BORQUEZ,24TRA101583,06/12/2024,Sale,-90.0,2070.0,7,FLAME,Bag
BORQUEZ,24TRA101583,06/13/2024,Sale,-180.0,1890.0,8,FLAME,Bag
BORQUEZ,24TRA101583,06/14/2024,Sale,-300.0,1590.0,9,BI-COLOR,Clam
BORQUEZ,24TRA101583,06/14/2024,Sale,-300.0,1290.0,9,BI-COLOR,Clam
BORQUEZ,24TRA101583,06/14/2024,Sale,-45.0,1245.0,9,FLAME,Clam
BORQUEZ,24TRA101583,06/18/2024,Sale,-180.0,1065.0,13,FLAME,Bag
BORQUEZ,24TRA101583,06/19/2024,Sale,-90.0,975.0,14,FLAME,Bag
BORQUEZ,24TRA101583,06/20/2024,Sale,-180.0,795.0,15,FLAME,Bag
BORQUEZ,24TRA101583,06/20/2024,Sale,-90.0,705.0,15,FLAME,Bag
BORQUEZ,24TRA101583,06/21/2024,Sale,-675.0,30.0,16,BI-COLOR,Clam
BORQUEZ,24TRA101583,07/20/2024,Sale,-75.0,-45.0,45,BI-COLOR,Clam
BORQUEZ,24TRA101584,06/05/2024,Entry,1500.0,1500.0,0,FLAME,Clam
BORQUEZ,24TRA101584,06/07/2024,Sale,-900.0,600.0,2,FLAME,Clam
BORQUEZ,24TRA101584,06/07/2024,Sale,-600.0,0.0,2,FLAME,Clam
BORQUEZ,24TRA101584,06/21/2024,Sale,-225.0,-225.0,16,BI-COLOR,Clam
BORQUEZ,24TRA101584,07/30/2024,Sale,-525.0,-750.0,55,BI-COLOR,Clam
BORQUEZ,24TRA101586,06/05/2024,Entry,2520.0,2520.0,0,FLAME,Bag
BORQUEZ,24TRA101586,06/07/2024,Sale,-1800.0,720.0,2,FLAME,Bag
BORQUEZ,24TRA101586,06/08/2024,Sale,-630.0,90.0,3,FLAME,Bag
BORQUEZ,24TRA101586,06/22/2024,Sale,-90.0,0.0,17,FLAME,Bag
BORQUEZ,24TRA101587,06/05/2024,Entry,2070.0,2070.0,0,FLAME,Bag
BORQUEZ,24TRA101587,06/05/2024,Entry,450.0,2520.0,0,FLAME,Bag
BORQUEZ,24TRA101587,06/07/2024,Sale,-1980.0,540.0,2,FLAME,Bag
BORQUEZ,24TRA101587,06/08/2024,Sale,-90.0,450.0,3,FLAME,Bag
BORQUEZ,24TRA101587,06/15/2024,Sale,-450.0,0.0,10,FLAME,Bag
BORQUEZ,24TRA101588,06/06/2024,Entry,2250.0,2250.0,0,FLAME,Bag
BORQUEZ,24TRA101588,06/13/2024,Sale,-1980.0,270.0,7,FLAME,Bag
BORQUEZ,24TRA101589,06/06/2024,Entry,2520.0,2520.0,0,FLAME,Bag
BORQUEZ,24TRA101589,06/08/2024,Sale,-630.0,1890.0,2,FLAME,Bag
BORQUEZ,24TRA101589,06/08/2024,Sale,-1440.0,450.0,2,FLAME,Bag
BORQUEZ,24TRA101589,06/08/2024,Sale,-450.0,0.0,2,FLAME,Bag
BORQUEZ,24TRA101593,06/06/2024,Entry,225.0,225.0,0,FLAME,Clam
BORQUEZ,24TRA101593,06/07/2024,Sale,-225.0,0.0,1,FLAME,Clam
BORQUEZ,24TRA101595,06/06/2024,Entry,2520.0,2520.0,0,FLAME,Bag
BORQUEZ,24TRA101595,06/13/2024,Sale,-720.0,1800.0,7,FLAME,Bag
BORQUEZ,24TRA101595,06/13/2024,Sale,-810.0,990.0,7,FLAME,Bag
BORQUEZ,24TRA101595,06/15/2024,Sale,-90.0,900.0,9,FLAME,Bag
BORQUEZ,24TRA101595,06/18/2024,Sale,-180.0,720.0,12,FLAME,Bag
BORQUEZ,24TRA101595,06/19/2024,Sale,-270.0,450.0,13,FLAME,Bag
BORQUEZ,24TRA101595,06/19/2024,Sale,-180.0,270.0,13,FLAME,Bag
BORQUEZ,24TRA101595,06/20/2024,Sale,-270.0,0.0,14,FLAME,Bag
BORQUEZ,24TRA101596,06/07/2024,Entry,2520.0,2520.0,0,FLAME,Bag
BORQUEZ,24TRA101596,06/07/2024,Sale,-1980.0,540.0,0,FLAME,Bag
BORQUEZ,24TRA101596,06/08/2024,Sale,-450.0,90.0,1,FLAME,Bag
BORQUEZ,24TRA101596,06/25/2024,Sale,-90.0,0.0,18,FLAME,Bag
BORQUEZ,24TRA101605,06/07/2024,Entry,2520.0,2520.0,0,FLAME,Bag
BORQUEZ,24TRA101605,06/10/2024,Sale,-540.0,1980.0,3,FLAME,Bag
BORQUEZ,24TRA101605,06/10/2024,Sale,-1980.0,0.0,3,FLAME,Bag
BORQUEZ,24TRA101607,06/08/2024,Entry,2520.0,2520.0,0,FLAME,Bag
BORQUEZ,24TRA101607,06/12/2024,Sale,-270.0,2250.0,4,FLAME,Bag
BORQUEZ,24TRA101607,06/12/2024,Sale,-180.0,2070.0,4,FLAME,Bag
BORQUEZ,24TRA101607,06/12/2024,Sale,-630.0,1440.0,4,FLAME,Bag
BORQUEZ,24TRA101607,06/13/2024,Sale,-90.0,1350.0,5,FLAME,Bag
BORQUEZ,24TRA101607,06/18/2024,Sale,-90.0,1260.0,10,FLAME,Bag
BORQUEZ,24TRA101607,06/19/2024,Sale,-180.0,1080.0,11,FLAME,Bag
BORQUEZ,24TRA101607,06/19/2024,Sale,-900.0,180.0,11,FLAME,Bag
BORQUEZ,24TRA101607,06/20/2024,Sale,-90.0,90.0,12,FLAME,Bag
BORQUEZ,24TRA101607,06/21/2024,Sale,-90.0,0.0,13,FLAME,Bag
BORQUEZ,24TRA101609,06/08/2024,Entry,2520.0,2520.0,0,FLAME,Bag
BORQUEZ,24TRA101609,06/10/2024,Sale,-990.0,1530.0,2,FLAME,Bag
BORQUEZ,24TRA101609,06/10/2024,Sale,-180.0,1350.0,2,FLAME,Bag
BORQUEZ,24TRA101609,06/12/2024,Sale,-1350.0,0.0,4,FLAME,Bag
BORQUEZ,24TRA101610,06/08/2024,Entry,2520.0,2520.0,0,FLAME,Bag
BORQUEZ,24TRA101610,06/15/2024,Sale,-450.0,2070.0,7,FLAME,Bag
BORQUEZ,24TRA101610,06/15/2024,Sale,-900.0,1170.0,7,FLAME,Bag
BORQUEZ,24TRA101610,06/18/2024,Sale,-540.0,630.0,10,FLAME,Bag
BORQUEZ,24TRA101610,06/20/2024,Sale,-36.0,594.0,12,FLAME,Bag
BORQUEZ,24TRA101610,06/20/2024,Sale,-324.0,270.0,12,FLAME,Bag
BORQUEZ,24TRA101610,06/20/2024,Sale,-90.0,180.0,12,FLAME,Bag
BORQUEZ,24TRA101610,06/20/2024,Sale,-180.0,0.0,12,FLAME,Bag
BORQUEZ,24TRA101611,06/08/2024,Entry,2520.0,2520.0,0,FLAME,Bag
BORQUEZ,24TRA101611,06/12/2024,Sale,-1080.0,1440.0,4,FLAME,Bag
BORQUEZ,24TRA101611,06/14/2024,Sale,-90.0,1350.0,6,FLAME,Bag
BORQUEZ,24TRA101611,06/17/2024,Sale,-1260.0,90.0,9,FLAME,Bag
BORQUEZ,24TRA101611,06/20/2024,Sale,-90.0,0.0,12,FLAME,Bag
BORQUEZ,24TRA101612,06/08/2024,Entry,2520.0,2520.0,0,FLAME,Bag
BORQUEZ,24TRA101612,06/14/2024,Sale,-630.0,1890.0,6,FLAME,Bag
BORQUEZ,24TRA101612,06/14/2024,Sale,-1890.0,0.0,6,FLAME,Bag
BORQUEZ,24TRA101614,06/08/2024,Entry,1170.0,1170.0,0,FLAME,Bag
BORQUEZ,24TRA101614,06/08/2024,Entry,1350.0,2520.0,0,FLAME,Bag
BORQUEZ,24TRA101614,06/08/2024,Sale,-990.0,1530.0,0,FLAME,Bag
BORQUEZ,24TRA101614,06/12/2024,Sale,-90.0,1440.0,4,FLAME,Bag
BORQUEZ,24TRA101614,06/13/2024,Sale,-360.0,1080.0,5,FLAME,Bag
BORQUEZ,24TRA101614,06/14/2024,Sale,-90.0,990.0,6,FLAME,Bag
BORQUEZ,24TRA101614,06/15/2024,Sale,-90.0,900.0,7,FLAME,Bag
BORQUEZ,24TRA101614,06/15/2024,Sale,-360.0,540.0,7,FLAME,Bag
BORQUEZ,24TRA101614,06/20/2024,Sale,-180.0,360.0,12,FLAME,Bag
BORQUEZ,24TRA101614,06/20/2024,Sale,-183.0,177.0,12,FLAME,Bag
BORQUEZ,24TRA101614,06/20/2024,Sale,-177.0,0.0,12,FLAME,Bag
BORQUEZ,24TRA101616,06/09/2024,Entry,2520.0,2520.0,0,FLAME,Bag
BORQUEZ,24TRA101616,06/18/2024,Sale,-630.0,1890.0,9,FLAME,Bag
BORQUEZ,24TRA101616,06/21/2024,Sale,-90.0,1800.0,12,FLAME,Bag
BORQUEZ,24TRA101616,06/21/2024,Sale,-450.0,1350.0,12,FLAME,Bag
BORQUEZ,24TRA101616,06/21/2024,Sale,-270.0,1080.0,12,FLAME,Bag
BORQUEZ,24TRA101616,06/22/2024,Sale,-180.0,900.0,13,FLAME,Bag
BORQUEZ,24TRA101616,06/25/2024,Sale,-450.0,450.0,16,FLAME,Bag
BORQUEZ,24TRA101616,06/26/2024,Sale,-360.0,90.0,17,FLAME,Bag
BORQUEZ,24TRA101616,06/28/2024,Sale,-90.0,0.0,19,FLAME,Bag
BORQUEZ,24TRA101617,06/09/2024,Entry,2520.0,2520.0,0,FLAME,Bag
BORQUEZ,24TRA101617,06/17/2024,Sale,-1350.0,1170.0,8,FLAME,Bag
BORQUEZ,24TRA101617,06/18/2024,Sale,-540.0,630.0,9,FLAME,Bag
BORQUEZ,24TRA101617,06/21/2024,Sale,-630.0,0.0,12,FLAME,Bag
BORQUEZ,24TRA101620,06/09/2024,Entry,2520.0,2520.0,0,FLAME,Bag
BORQUEZ,24TRA101620,06/21/2024,Sale,-180.0,2340.0,12,FLAME,Bag
BORQUEZ,24TRA101620,06/22/2024,Sale,-990.0,1350.0,13,FLAME,Bag
BORQUEZ,24TRA101620,06/22/2024,Sale,-1350.0,0.0,13,FLAME,Bag
BORQUEZ,24TRA101621,06/09/2024,Entry,540.0,540.0,0,FLAME,Clam
BORQUEZ,24TRA101621,06/09/2024,Entry,1650.0,2190.0,0,FLAME,Clam
BORQUEZ,24TRA101621,06/13/2024,Sale,-1650.0,540.0,4,FLAME,Clam
BORQUEZ,24TRA101621,06/21/2024,Sale,-540.0,0.0,12,FLAME,Bag
BORQUEZ,24TRA101628,06/10/2024,Entry,225.0,225.0,0,SUGAR DROP - ORG,Clam
BORQUEZ,24TRA101628,06/12/2024,Sale,-225.0,0.0,2,SUGAR DROP - ORG,Clam
BORQUEZ,24TRA101641,06/11/2024,Entry,540.0,540.0,0,FLAME,Bag
BORQUEZ,24TRA101641,06/18/2024,Sale,-360.0,180.0,7,FLAME,Bag
BORQUEZ,24TRA101641,06/19/2024,Sale,-90.0,90.0,8,FLAME,Bag
BORQUEZ,24TRA101641,06/20/2024,Sale,-90.0,0.0,9,FLAME,Bag
BORQUEZ,24TRA101649,06/12/2024,Entry,2520.0,2520.0,0,FLAME,Bag
BORQUEZ,24TRA101649,06/13/2024,Sale,-990.0,1530.0,1,FLAME,Bag
BORQUEZ,24TRA101649,06/14/2024,Sale,-1080.0,450.0,2,FLAME,Bag
BORQUEZ,24TRA101649,06/14/2024,Sale,-450.0,0.0,2,FLAME,Bag
BORQUEZ,24TRA101658,06/13/2024,Entry,270.0,270.0,0,FLAME,Bag
BORQUEZ,24TRA101658,06/13/2024,Entry,2250.0,2520.0,0,SUGAR DROP - ORG,Bag
BORQUEZ,24TRA101658,06/18/2024,Sale,-180.0,2340.0,5,FLAME,Bag
BORQUEZ,24TRA101658,06/21/2024,Sale,-90.0,2250.0,8,SUGAR DROP - ORG,Bag
BORQUEZ,24TRA101658,06/22/2024,Sale,-90.0,2160.0,9,FLAME,Bag
BORQUEZ,24TRA101658,06/25/2024,Sale,-45.0,2115.0,12,SUGAR DROP - ORG,Bag
BORQUEZ,24TRA101658,06/26/2024,Sale,-90.0,2025.0,13,SUGAR DROP - ORG,Bag
BORQUEZ,24TRA101658,06/27/2024,Sale,-45.0,1980.0,14,SUGAR DROP - ORG,Bag
BORQUEZ,24TRA101658,06/28/2024,Sale,-90.0,1890.0,15,SUGAR DROP - ORG,Bag
BORQUEZ,24TRA101658,06/28/2024,Sale,-90.0,1800.0,15,SUGAR DROP - ORG,Bag
BORQUEZ,24TRA101658,07/01/2024,Sale,-90.0,1710.0,18,SUGAR DROP - ORG,Bag
BORQUEZ,24TRA101658,07/04/2024,Sale,-45.0,1665.0,21,SUGAR DROP - ORG,Bag
BORQUEZ,24TRA101658,07/09/2024,Sale,-45.0,1620.0,26,SUGAR DROP - ORG,Bag
BORQUEZ,24TRA101658,07/20/2024,Sale,-1620.0,0.0,37,SUGAR DROP - ORG,Bag
BORQUEZ,24TRA101660,06/13/2024,Entry,1125.0,1125.0,0,BI-COLOR,Clam
BORQUEZ,24TRA101660,06/13/2024,Entry,675.0,1800.0,0,PASSION FIRE-ORG,Clam
BORQUEZ,24TRA101660,06/13/2024,Sale,-1125.0,675.0,0,BI-COLOR,Clam
BORQUEZ,24TRA101660,06/18/2024,Sale,-375.0,300.0,5,PASSION FIRE-ORG,Clam
BORQUEZ,24TRA101660,06/18/2024,Sale,-150.0,150.0,5,PASSION FIRE-ORG,Clam
BORQUEZ,24TRA101660,06/21/2024,Sale,-150.0,0.0,8,PASSION FIRE-ORG,Clam
BORQUEZ,24TRA101665,06/13/2024,Entry,2520.0,2520.0,0,FLAME,Bag
BORQUEZ,24TRA101665,06/15/2024,Sale,-630.0,1890.0,2,FLAME,Bag
BORQUEZ,24TRA101665,06/18/2024,Sale,-1620.0,270.0,5,FLAME,Bag
BORQUEZ,24TRA101665,06/21/2024,Sale,-270.0,0.0,8,FLAME,Bag
BORQUEZ,24TRA101666,06/13/2024,Entry,2520.0,2520.0,0,FLAME,Bag
BORQUEZ,24TRA101666,06/15/2024,Sale,-900.0,1620.0,2,FLAME,Bag
BORQUEZ,24TRA101666,06/15/2024,Sale,-1530.0,90.0,2,FLAME,Bag
BORQUEZ,24TRA101666,06/21/2024,Sale,-90.0,0.0,8,FLAME,Bag
BORQUEZ,24TRA101671,06/14/2024,Entry,630.0,630.0,0,FLAME,Bag
BORQUEZ,24TRA101671,06/14/2024,Entry,1620.0,2250.0,0,FLAME,Bag
BORQUEZ,24TRA101671,06/14/2024,Entry,270.0,2520.0,0,SUGAR DROP - ORG,Bag
BORQUEZ,24TRA101671,06/15/2024,Sale,-180.0,2340.0,1,FLAME,Bag
BORQUEZ,24TRA101671,06/15/2024,Sale,-810.0,1530.0,1,FLAME,Bag
BORQUEZ,24TRA101671,06/15/2024,Sale,-630.0,900.0,1,FLAME,Bag
BORQUEZ,24TRA101671,06/17/2024,Sale,-180.0,720.0,3,SUGAR DROP - ORG,Bag
BORQUEZ,24TRA101671,06/21/2024,Sale,-90.0,630.0,7,FLAME,Bag
BORQUEZ,24TRA101671,06/22/2024,Sale,-450.0,180.0,8,FLAME,Bag
BORQUEZ,24TRA101671,07/02/2024,Sale,-90.0,90.0,18,SUGAR DROP - ORG,Bag
BORQUEZ,24TRA101675,06/14/2024,Entry,720.0,720.0,0,FLAME,Bag
BORQUEZ,24TRA101675,06/14/2024,Entry,1600.0,2320.0,0,FLAME,Bag
BORQUEZ,24TRA101675,06/18/2024,Sale,-630.0,1690.0,4,FLAME,Bag
BORQUEZ,24TRA101675,06/19/2024,Sale,-960.0,730.0,5,FLAME,Clam
BORQUEZ,24TRA101675,06/22/2024,Sale,-90.0,640.0,8,FLAME,Bag
BORQUEZ,24TRA101675,07/06/2024,Sale,-32.0,608.0,22,FLAME,Bag
BORQUEZ,24TRA101675,07/30/2024,Sale,-360.0,248.0,46,FLAME,Bag
BORQUEZ,24TRA101677,06/14/2024,Entry,2520.0,2520.0,0,FLAME,Bag
BORQUEZ,24TRA101677,06/18/2024,Sale,-1080.0,1440.0,4,FLAME,Bag
BORQUEZ,24TRA101677,06/21/2024,Sale,-990.0,450.0,7,FLAME,Bag
BORQUEZ,24TRA101677,06/22/2024,Sale,-90.0,360.0,8,FLAME,Bag
BORQUEZ,24TRA101677,06/25/2024,Sale,-360.0,0.0,11,FLAME,Bag
BORQUEZ,24TRA101682,06/15/2024,Entry,75.0,75.0,0,BI-COLOR,Bag
BORQUEZ,24TRA101682,06/15/2024,Entry,180.0,255.0,0,FLAME,Bag
BORQUEZ,24TRA101682,06/15/2024,Entry,75.0,330.0,0,PASSION FIRE-ORG,Bag
BORQUEZ,24TRA101682,06/15/2024,Entry,1800.0,2130.0,0,SUGAR DROP - ORG,Bag
BORQUEZ,24TRA101682,06/15/2024,Sale,-90.0,2040.0,0,FLAME,Bag
BORQUEZ,24TRA101682,06/15/2024,Sale,-225.0,1815.0,0,SUGAR DROP - ORG,Clam
BORQUEZ,24TRA101682,06/15/2024,Sale,-150.0,1665.0,0,SUGAR DROP - ORG,Clam
BORQUEZ,24TRA101682,06/15/2024,Sale,-225.0,1440.0,0,SUGAR DROP - ORG,Clam
BORQUEZ,24TRA101682,06/18/2024,Sale,-300.0,1140.0,3,SUGAR DROP - ORG,Clam
BORQUEZ,24TRA101682,06/18/2024,Sale,-300.0,840.0,3,SUGAR DROP - ORG,Clam
BORQUEZ,24TRA101682,06/18/2024,Sale,-225.0,615.0,3,SUGAR DROP - ORG,Clam
BORQUEZ,24TRA101682,06/20/2024,Sale,-75.0,540.0,5,BI-COLOR,Clam
BORQUEZ,24TRA101682,06/21/2024,Sale,-225.0,315.0,6,SUGAR DROP - ORG,Clam
BORQUEZ,24TRA101682,06/21/2024,Sale,-75.0,240.0,6,SUGAR DROP - ORG,Clam
BORQUEZ,24TRA101682,06/22/2024,Sale,-75.0,165.0,7,PASSION FIRE-ORG,Clam
BORQUEZ,24TRA101682,06/25/2024,Sale,-75.0,90.0,10,SUGAR DROP - ORG,Clam
BORQUEZ,24TRA101682,06/26/2024,Sale,-90.0,0.0,11,FLAME,Bag
BORQUEZ,24TRA101684,06/15/2024,Entry,180.0,180.0,0,FLAME,Clam
BORQUEZ,24TRA101684,06/15/2024,Entry,180.0,360.0,0,FLAME,Clam
BORQUEZ,24TRA101684,06/15/2024,Entry,225.0,585.0,0,FLAME,Clam
BORQUEZ,24TRA101684,06/15/2024,Entry,1575.0,2160.0,0,FLAME,Clam
BORQUEZ,24TRA101684,06/17/2024,Sale,-1575.0,585.0,2,FLAME,Clam
BORQUEZ,24TRA101684,06/19/2024,Sale,-180.0,405.0,4,FLAME,Bag
BORQUEZ,24TRA101684,06/21/2024,Sale,-180.0,225.0,6,FLAME,Bag
BORQUEZ,24TRA101684,07/20/2024,Sale,-225.0,0.0,35,FLAME,Clam
BORQUEZ,24TRA101691,06/15/2024,Entry,1350.0,1350.0,0,FLAME,Bag
BORQUEZ,24TRA101691,06/15/2024,Entry,810.0,2160.0,0,FLAME,Bag
BORQUEZ,24TRA101691,06/17/2024,Sale,-270.0,1890.0,2,FLAME,Bag
BORQUEZ,24TRA101691,06/19/2024,Sale,-90.0,1800.0,4,FLAME,Bag
BORQUEZ,24TRA101691,06/19/2024,Sale,-360.0,1440.0,4,FLAME,Bag
BORQUEZ,24TRA101691,06/20/2024,Sale,-90.0,1350.0,5,FLAME,Bag
BORQUEZ,24TRA101691,06/21/2024,Sale,-810.0,540.0,6,FLAME,Bag
BORQUEZ,24TRA101691,06/22/2024,Sale,-540.0,0.0,7,FLAME,Bag
BORQUEZ,24TRA101702,06/17/2024,Entry,1125.0,1125.0,0,FLAME,Clam
BORQUEZ,24TRA101702,06/17/2024,Entry,975.0,2100.0,0,SUGAR DROP - ORG,Clam
BORQUEZ,24TRA101702,06/24/2024,Sale,-900.0,1200.0,7,SUGAR DROP - ORG,Clam
BORQUEZ,24TRA101702,06/25/2024,Sale,-150.0,1050.0,8,FLAME,Clam
BORQUEZ,24TRA101702,07/02/2024,Sale,-225.0,825.0,15,FLAME,Clam
BORQUEZ,24TRA101702,07/04/2024,Sale,-150.0,675.0,17,FLAME,Clam
BORQUEZ,24TRA101702,07/20/2024,Sale,-600.0,75.0,33,FLAME,Clam
BORQUEZ,24TRA101702,07/20/2024,Sale,-75.0,0.0,33,SUGAR DROP - ORG,Clam
BORQUEZ,24TRA101711,06/18/2024,Entry,900.0,900.0,0,FLAME,Bag
BORQUEZ,24TRA101711,06/18/2024,Entry,1200.0,2100.0,0,PASSION FIRE-ORG,Bag
BORQUEZ,24TRA101711,06/19/2024,Sale,-900.0,1200.0,1,FLAME,Bag
BORQUEZ,24TRA101711,06/21/2024,Sale,-150.0,1050.0,3,PASSION FIRE-ORG,Clam
BORQUEZ,24TRA101711,06/22/2024,Sale,-300.0,750.0,4,PASSION FIRE-ORG,Clam
BORQUEZ,24TRA101711,06/22/2024,Sale,-75.0,675.0,4,PASSION FIRE-ORG,Clam
BORQUEZ,24TRA101711,06/22/2024,Sale,-225.0,450.0,4,PASSION FIRE-ORG,Clam
BORQUEZ,24TRA101711,06/25/2024,Sale,-150.0,300.0,7,PASSION FIRE-ORG,Clam
BORQUEZ,24TRA101711,06/25/2024,Sale,-150.0,150.0,7,PASSION FIRE-ORG,Clam
BORQUEZ,24TRA101711,06/25/2024,Sale,-150.0,0.0,7,PASSION FIRE-ORG,Clam
BORQUEZ,24TRA101746,06/21/2024,Entry,900.0,900.0,0,PASSION FIRE-ORG,Clam
BORQUEZ,24TRA101746,06/24/2024,Sale,-900.0,0.0,3,PASSION FIRE-ORG,Clam
BORQUEZ,24TRA101765,06/22/2024,Entry,270.0,270.0,0,PASSION FIRE-ORG,Bag
BORQUEZ,24TRA101765,07/10/2024,Sale,-270.0,0.0,18,PASSION FIRE-ORG,Bag
BORQUEZ,24TRA101768,06/23/2024,Entry,810.0,810.0,0,PASSION FIRE,Bag
BORQUEZ,24TRA101768,07/03/2024,Sale,-810.0,0.0,10,PASSION FIRE,Bag
BORQUEZ,24TRA101773,06/23/2024,Entry,270.0,270.0,0,FLAME,Bag
BORQUEZ,24TRA101773,06/23/2024,Entry,1050.0,1320.0,0,FLAME,Bag
BORQUEZ,24TRA101773,06/23/2024,Entry,150.0,1470.0,0,SUGAR DROP,Bag
BORQUEZ,24TRA101773,06/26/2024,Sale,-270.0,1200.0,3,FLAME,Bag
BORQUEZ,24TRA101773,07/01/2024,Sale,-1050.0,150.0,8,FLAME,Clam
BORQUEZ,24TRA101773,07/12/2024,Sale,-150.0,0.0,19,SUGAR DROP,Clam
BORQUEZ,24TRA101785,06/25/2024,Entry,2520.0,2520.0,0,FLAME,Bag
BORQUEZ,24TRA101785,06/26/2024,Sale,-720.0,1800.0,1,FLAME,Bag
BORQUEZ,24TRA101785,06/26/2024,Sale,-450.0,1350.0,1,FLAME,Bag
BORQUEZ,24TRA101785,06/27/2024,Sale,-1260.0,90.0,2,FLAME,Bag
BORQUEZ,24TRA101785,06/28/2024,Sale,-90.0,0.0,3,FLAME,Bag
BORQUEZ,24TRA101786,06/25/2024,Entry,900.0,900.0,0,FLAME,Bag
BORQUEZ,24TRA101786,06/26/2024,Sale,-900.0,0.0,1,FLAME,Bag
BORQUEZ,24TRA101790,06/25/2024,Entry,2520.0,2520.0,0,FLAME,Bag
BORQUEZ,24TRA101790,06/27/2024,Sale,-720.0,1800.0,2,FLAME,Bag
BORQUEZ,24TRA101790,06/27/2024,Sale,-720.0,1080.0,2,FLAME,Bag
BORQUEZ,24TRA101790,06/27/2024,Sale,-1080.0,0.0,2,FLAME,Bag
BORQUEZ,24TRA101794,06/26/2024,Entry,720.0,720.0,0,PASSION FIRE,Bag
BORQUEZ,24TRA101794,06/28/2024,Sale,-450.0,270.0,2,PASSION FIRE,Bag
BORQUEZ,24TRA101794,06/29/2024,Sale,-90.0,180.0,3,PASSION FIRE,Bag
BORQUEZ,24TRA101794,06/29/2024,Sale,-180.0,0.0,3,PASSION FIRE,Bag
BORQUEZ,24TRA101796,06/26/2024,Entry,2520.0,2520.0,0,PASSION FIRE,Bag
BORQUEZ,24TRA101796,06/28/2024,Sale,-450.0,2070.0,2,PASSION FIRE,Bag
BORQUEZ,24TRA101796,06/28/2024,Sale,-1980.0,90.0,2,PASSION FIRE,Bag
BORQUEZ,24TRA101796,06/29/2024,Sale,-90.0,0.0,3,PASSION FIRE,Bag
BORQUEZ,24TRA101797,06/26/2024,Entry,2520.0,2520.0,0,PASSION FIRE,Bag
BORQUEZ,24TRA101797,06/28/2024,Sale,-900.0,1620.0,2,PASSION FIRE,Bag
BORQUEZ,24TRA101797,06/29/2024,Sale,-810.0,810.0,3,PASSION FIRE,Bag
BORQUEZ,24TRA101797,06/29/2024,Sale,-810.0,0.0,3,PASSION FIRE,Bag
BORQUEZ,24TRA101801,06/27/2024,Entry,2520.0,2520.0,0,FLAME,Bag
BORQUEZ,24TRA101801,06/27/2024,Sale,-1980.0,540.0,0,FLAME,Bag
BORQUEZ,24TRA101801,06/27/2024,Sale,-540.0,0.0,0,FLAME,Bag
BORQUEZ,24TRA101802,06/27/2024,Entry,2520.0,2520.0,0,FLAME,Bag
BORQUEZ,24TRA101802,06/27/2024,Sale,-1260.0,1260.0,0,FLAME,Bag
BORQUEZ,24TRA101802,06/27/2024,Sale,-990.0,270.0,0,FLAME,Bag
BORQUEZ,24TRA101802,06/28/2024,Sale,-270.0,0.0,1,FLAME,Bag
BORQUEZ,24TRA101804,06/27/2024,Entry,1080.0,1080.0,0,FLAME,Bag
BORQUEZ,24TRA101804,06/28/2024,Sale,-630.0,450.0,1,FLAME,Bag
BORQUEZ,24TRA101804,06/28/2024,Sale,-180.0,270.0,1,FLAME,Bag
BORQUEZ,24TRA101804,06/29/2024,Sale,-270.0,0.0,2,FLAME,Bag
BORQUEZ,24TRA101805,06/28/2024,Entry,750.0,750.0,0,PASSION FIRE,Bag
BORQUEZ,24TRA101805,06/28/2024,Entry,225.0,975.0,0,PASSION FIRE,Bag
BORQUEZ,24TRA101805,06/29/2024,Entry,270.0,1245.0,1,PASSION FIRE,Bag
BORQUEZ,24TRA101805,06/29/2024,Sale,-270.0,975.0,1,PASSION FIRE,Bag
BORQUEZ,24TRA101805,06/29/2024,Sale,-225.0,750.0,1,PASSION FIRE,Bag
BORQUEZ,24TRA101805,07/01/2024,Sale,-750.0,0.0,3,PASSION FIRE,Clam
BORQUEZ,24TRA101806,06/28/2024,Entry,2100.0,2100.0,0,PASSION FIRE,Bag
BORQUEZ,24TRA101806,06/28/2024,Sale,-600.0,1500.0,0,PASSION FIRE,Bag
BORQUEZ,24TRA101806,06/29/2024,Sale,-825.0,675.0,1,PASSION FIRE,Bag
BORQUEZ,24TRA101806,06/29/2024,Sale,-675.0,0.0,1,PASSION FIRE,Bag
BORQUEZ,24TRA101808,06/27/2024,Entry,900.0,900.0,0,PASSION FIRE,Bag
BORQUEZ,24TRA101808,06/27/2024,Entry,1350.0,2250.0,0,PASSION FIRE-ORG,Bag
BORQUEZ,24TRA101808,06/28/2024,Sale,-810.0,1440.0,1,PASSION FIRE,Bag
BORQUEZ,24TRA101808,06/29/2024,Sale,-90.0,1350.0,2,PASSION FIRE,Bag
BORQUEZ,24TRA101808,06/29/2024,Sale,-225.0,1125.0,2,PASSION FIRE-ORG,Clam
BORQUEZ,24TRA101808,06/29/2024,Sale,-150.0,975.0,2,PASSION FIRE-ORG,Clam
BORQUEZ,24TRA101808,07/02/2024,Sale,-225.0,750.0,5,PASSION FIRE-ORG,Clam
BORQUEZ,24TRA101808,07/02/2024,Sale,-75.0,675.0,5,PASSION FIRE-ORG,Clam
BORQUEZ,24TRA101808,07/05/2024,Sale,-150.0,525.0,8,PASSION FIRE-ORG,Clam
BORQUEZ,24TRA101808,07/05/2024,Sale,-225.0,300.0,8,PASSION FIRE-ORG,Clam
BORQUEZ,24TRA101808,07/10/2024,Sale,-300.0,0.0,13,PASSION FIRE-ORG,Clam
BORQUEZ,24TRA101814,06/28/2024,Entry,1650.0,1650.0,0,PASSION FIRE,Bag
BORQUEZ,24TRA101814,06/28/2024,Sale,-900.0,750.0,0,PASSION FIRE,Bag
BORQUEZ,24TRA101814,06/29/2024,Sale,-750.0,0.0,1,PASSION FIRE,Bag
BORQUEZ,24TRA101816,06/28/2024,Entry,1890.0,1890.0,0,FLAME,Bag
BORQUEZ,24TRA101816,06/28/2024,Sale,-1890.0,0.0,0,FLAME,Bag
BORQUEZ,24TRA101818,06/28/2024,Entry,2520.0,2520.0,0,PASSION FIRE,Bag
BORQUEZ,24TRA101818,06/28/2024,Sale,-540.0,1980.0,0,PASSION FIRE,Bag
BORQUEZ,24TRA101818,06/29/2024,Sale,-540.0,1440.0,1,PASSION FIRE,Bag
BORQUEZ,24TRA101818,06/29/2024,Sale,-1440.0,0.0,1,PASSION FIRE,Bag
BORQUEZ,24TRA101821,07/01/2024,Entry,2520.0,2520.0,0,FLAME,Bag
BORQUEZ,24TRA101821,07/01/2024,Sale,-720.0,1800.0,0,FLAME,Bag
BORQUEZ,24TRA101821,07/01/2024,Sale,-1260.0,540.0,0,FLAME,Bag
BORQUEZ,24TRA101821,07/03/2024,Sale,-540.0,0.0,2,FLAME,Bag
BORQUEZ,24TRA101823,07/01/2024,Entry,1440.0,1440.0,0,FLAME,Bag
BORQUEZ,24TRA101823,07/03/2024,Sale,-450.0,990.0,2,FLAME,Bag
BORQUEZ,24TRA101823,07/06/2024,Sale,-180.0,810.0,5,FLAME,Bag
BORQUEZ,24TRA101823,07/10/2024,Sale,-540.0,270.0,9,FLAME,Bag
BORQUEZ,24TRA101823,07/20/2024,Sale,-7.0,263.0,19,FLAME,Bag
BORQUEZ,24TRA101829,07/03/2024,Entry,1170.0,1170.0,0,FLAME,Bag
BORQUEZ,24TRA101829,07/05/2024,Sale,-540.0,630.0,2,FLAME,Bag
BORQUEZ,24TRA101829,07/06/2024,Sale,-90.0,540.0,3,FLAME,Bag
BORQUEZ,24TRA101829,07/06/2024,Sale,-540.0,0.0,3,FLAME,Bag
BORQUEZ,24TRA104662,05/16/2024,Entry,270.0,270.0,0,EARLY SWEET,Clam
BORQUEZ,24TRA104662,05/16/2024,Entry,320.0,590.0,0,EARLY SWEET,Clam
BORQUEZ,24TRA104662,05/22/2024,Sale,-320.0,270.0,6,EARLY SWEET,Clam
BORQUEZ,24TRA104662,05/31/2024,Sale,-270.0,0.0,15,EARLY SWEET,Bag
BORQUEZ,24TRA104668,05/17/2024,Entry,1200.0,1200.0,0,EARLY SWEET,Clam
BORQUEZ,24TRA104668,05/21/2024,Sale,-80.0,1120.0,4,EARLY SWEET,Clam
BORQUEZ,24TRA104668,05/22/2024,Sale,-640.0,480.0,5,EARLY SWEET,Clam
BORQUEZ,24TRA104668,05/24/2024,Sale,-480.0,0.0,7,EARLY SWEET,Clam
BORQUEZ,24TRA104670,05/18/2024,Entry,2160.0,2160.0,0,EARLY SWEET,Clam
BORQUEZ,24TRA104670,05/18/2024,Entry,80.0,2240.0,0,EARLY SWEET,Clam
BORQUEZ,24TRA104670,05/21/2024,Sale,-1920.0,320.0,3,EARLY SWEET,Clam
BORQUEZ,24TRA104670,05/21/2024,Sale,-240.0,80.0,3,EARLY SWEET,Clam
BORQUEZ,24TRA104670,05/24/2024,Sale,-80.0,0.0,6,EARLY SWEET,Clam
BORQUEZ,24TRA104671,05/20/2024,Entry,640.0,640.0,0,EARLY SWEET,Clam
BORQUEZ,24TRA104671,05/20/2024,Entry,80.0,720.0,0,EARLY SWEET,Clam
BORQUEZ,24TRA104671,05/21/2024,Sale,-640.0,80.0,1,EARLY SWEET,Clam
BORQUEZ,24TRA104671,05/24/2024,Sale,-80.0,0.0,4,EARLY SWEET,Clam
BORQUEZ,24TRA104675,05/20/2024,Entry,2240.0,2240.0,0,EARLY SWEET,Clam
BORQUEZ,24TRA104675,05/24/2024,Sale,-1280.0,960.0,4,EARLY SWEET,Clam
BORQUEZ,24TRA104675,05/24/2024,Sale,-960.0,0.0,4,EARLY SWEET,Clam
BORQUEZ,24TRA104676,05/20/2024,Entry,2240.0,2240.0,0,EARLY SWEET,Clam
BORQUEZ,24TRA104676,05/21/2024,Sale,-1040.0,1200.0,1,EARLY SWEET,Clam
BORQUEZ,24TRA104676,05/21/2024,Sale,-1200.0,0.0,1,EARLY SWEET,Clam
BORQUEZ,24TRA104677,05/20/2024,Entry,2520.0,2520.0,0,EARLY SWEET,Bag
BORQUEZ,24TRA104677,05/23/2024,Sale,-1980.0,540.0,3,EARLY SWEET,Bag
BORQUEZ,24TRA104677,05/24/2024,Sale,-360.0,180.0,4,EARLY SWEET,Bag
BORQUEZ,24TRA104677,05/24/2024,Sale,-90.0,90.0,4,EARLY SWEET,Bag
BORQUEZ,24TRA104677,05/24/2024,Sale,-90.0,0.0,4,EARLY SWEET,Bag
BORQUEZ,24TRA104678,05/20/2024,Entry,2520.0,2520.0,0,EARLY SWEET,Bag
BORQUEZ,24TRA104678,05/23/2024,Sale,-450.0,2070.0,3,EARLY SWEET,Bag
BORQUEZ,24TRA104678,05/23/2024,Sale,-990.0,1080.0,3,EARLY SWEET,Bag
BORQUEZ,24TRA104678,05/24/2024,Sale,-450.0,630.0,4,EARLY SWEET,Bag
BORQUEZ,24TRA104678,05/24/2024,Sale,-630.0,0.0,4,EARLY SWEET,Bag
BORQUEZ,24TRA104679,05/20/2024,Entry,1710.0,1710.0,0,EARLY SWEET,Bag
BORQUEZ,24TRA104679,05/23/2024,Sale,-630.0,1080.0,3,EARLY SWEET,Bag
BORQUEZ,24TRA104679,05/23/2024,Sale,-990.0,90.0,3,EARLY SWEET,Bag
BORQUEZ,24TRA104679,05/24/2024,Sale,-90.0,0.0,4,EARLY SWEET,Bag
BORQUEZ,24TRA104686,05/21/2024,Entry,2520.0,2520.0,0,EARLY SWEET,Bag
BORQUEZ,24TRA104686,05/24/2024,Sale,-180.0,2340.0,3,EARLY SWEET,Bag
BORQUEZ,24TRA104686,05/25/2024,Sale,-990.0,1350.0,4,EARLY SWEET,Bag
BORQUEZ,24TRA104686,05/25/2024,Sale,-1350.0,0.0,4,EARLY SWEET,Bag
BORQUEZ,24TRA104687,05/21/2024,Entry,1080.0,1080.0,0,EARLY SWEET,Bag
BORQUEZ,24TRA104687,05/23/2024,Sale,-810.0,270.0,2,EARLY SWEET,Bag
BORQUEZ,24TRA104687,05/24/2024,Sale,-270.0,0.0,3,EARLY SWEET,Bag
BORQUEZ,24TRA104691,05/22/2024,Entry,2520.0,2520.0,0,EARLY SWEET,Bag
BORQUEZ,24TRA104691,05/25/2024,Sale,-270.0,2250.0,3,EARLY SWEET,Bag
BORQUEZ,24TRA104691,05/25/2024,Sale,-810.0,1440.0,3,EARLY SWEET,Bag
BORQUEZ,24TRA104691,05/25/2024,Sale,-630.0,810.0,3,EARLY SWEET,Bag
BORQUEZ,24TRA104691,05/25/2024,Sale,-450.0,360.0,3,EARLY SWEET,Bag
BORQUEZ,24TRA104691,05/25/2024,Sale,-360.0,0.0,3,EARLY SWEET,Bag
BORQUEZ,24TRA104695,05/22/2024,Entry,2240.0,2240.0,0,EARLY SWEET,Clam
BORQUEZ,24TRA104695,05/25/2024,Sale,-240.0,2000.0,3,EARLY SWEET,Clam
BORQUEZ,24TRA104695,05/25/2024,Sale,-1920.0,80.0,3,EARLY SWEET,Clam
BORQUEZ,24TRA104695,05/30/2024,Sale,-80.0,0.0,8,EARLY SWEET,Clam
BORQUEZ,24TRA104696,05/22/2024,Entry,80.0,80.0,0,EARLY SWEET,Clam
BORQUEZ,24TRA104696,05/22/2024,Entry,1280.0,1360.0,0,EARLY SWEET,Clam
BORQUEZ,24TRA104696,05/24/2024,Sale,-1120.0,240.0,2,EARLY SWEET,Clam
BORQUEZ,24TRA104696,05/24/2024,Sale,-80.0,160.0,2,EARLY SWEET,Clam
BORQUEZ,24TRA104696,05/25/2024,Sale,-80.0,80.0,3,EARLY SWEET,Clam
BORQUEZ,24TRA104696,05/28/2024,Sale,-80.0,0.0,6,EARLY SWEET,Clam
BORQUEZ,24TRA104698,05/22/2024,Entry,2520.0,2520.0,0,EARLY SWEET,Bag
BORQUEZ,24TRA104698,05/23/2024,Sale,-540.0,1980.0,1,EARLY SWEET,Bag
BORQUEZ,24TRA104698,05/25/2024,Sale,-720.0,1260.0,3,EARLY SWEET,Bag
BORQUEZ,24TRA104698,05/27/2024,Sale,-1260.0,0.0,5,EARLY SWEET,Bag
BORQUEZ,24TRA104699,05/23/2024,Entry,2240.0,2240.0,0,EARLY SWEET,Clam
BORQUEZ,24TRA104699,05/24/2024,Sale,-800.0,1440.0,1,EARLY SWEET,Clam
BORQUEZ,24TRA104699,05/24/2024,Sale,-880.0,560.0,1,EARLY SWEET,Clam
BORQUEZ,24TRA104699,05/25/2024,Sale,-560.0,0.0,2,EARLY SWEET,Clam
BORQUEZ,24TRA104700,05/23/2024,Entry,2520.0,2520.0,0,EARLY SWEET,Bag
BORQUEZ,24TRA104700,05/24/2024,Sale,-900.0,1620.0,1,EARLY SWEET,Bag
BORQUEZ,24TRA104700,05/25/2024,Sale,-1440.0,180.0,2,EARLY SWEET,Bag
BORQUEZ,24TRA104700,05/27/2024,Sale,-90.0,90.0,4,EARLY SWEET,Bag
BORQUEZ,24TRA104700,05/28/2024,Sale,-90.0,0.0,5,EARLY SWEET,Bag
BORQUEZ,24TRA104701,05/24/2024,Entry,270.0,270.0,0,EARLY SWEET,Clam
BORQUEZ,24TRA104701,05/24/2024,Entry,2000.0,2270.0,0,EARLY SWEET,Clam
BORQUEZ,24TRA104701,05/25/2024,Sale,-1920.0,350.0,1,EARLY SWEET,Clam
BORQUEZ,24TRA104701,05/30/2024,Sale,-80.0,270.0,6,EARLY SWEET,Clam
BORQUEZ,24TRA104701,05/31/2024,Sale,-180.0,90.0,7,EARLY SWEET,Bag
BORQUEZ,24TRA104701,05/31/2024,Sale,-90.0,0.0,7,EARLY SWEET,Bag
BORQUEZ,24TRA104702,05/23/2024,Entry,900.0,900.0,0,EARLY SWEET,Bag
BORQUEZ,24TRA104702,05/25/2024,Sale,-90.0,810.0,2,EARLY SWEET,Bag
BORQUEZ,24TRA104702,05/25/2024,Sale,-540.0,270.0,2,EARLY SWEET,Bag
BORQUEZ,24TRA104702,05/27/2024,Sale,-90.0,180.0,4,EARLY SWEET,Bag
BORQUEZ,24TRA104702,05/27/2024,Sale,-90.0,90.0,4,EARLY SWEET,Bag
BORQUEZ,24TRA104702,05/28/2024,Sale,-90.0,0.0,5,EARLY SWEET,Bag
BORQUEZ,24TRA104704,05/24/2024,Entry,2520.0,2520.0,0,EARLY SWEET,Bag
BORQUEZ,24TRA104704,05/27/2024,Sale,-720.0,1800.0,3,EARLY SWEET,Bag
BORQUEZ,24TRA104704,05/28/2024,Sale,-1800.0,0.0,4,EARLY SWEET,Bag
BORQUEZ,24TRA104706,05/24/2024,Entry,560.0,560.0,0,EARLY SWEET,Clam
BORQUEZ,24TRA104706,05/28/2024,Sale,-560.0,0.0,4,EARLY SWEET,Clam
BORQUEZ,24TRA104707,05/24/2024,Entry,2100.0,2100.0,0,EARLY SWEET,Clam
BORQUEZ,24TRA104707,05/25/2024,Sale,-1800.0,300.0,1,EARLY SWEET,Clam
BORQUEZ,24TRA104707,05/27/2024,Sale,-300.0,0.0,3,EARLY SWEET,Clam
BORQUEZ,24TRA104708,05/24/2024,Entry,375.0,375.0,0,EARLY SWEET,Unknown
BORQUEZ,24TRA104708,05/24/2024,Entry,1725.0,2100.0,0,EARLY SWEET,Unknown
BORQUEZ,24TRA104708,05/24/2024,Sale,-300.0,1800.0,0,EARLY SWEET,Unknown
BORQUEZ,24TRA104708,05/24/2024,Sale,-75.0,1725.0,0,EARLY SWEET,Unknown
BORQUEZ,24TRA104708,05/24/2024,Sale,-150.0,1575.0,0,EARLY SWEET,Unknown
BORQUEZ,24TRA104708,05/25/2024,Sale,-300.0,1275.0,1,EARLY SWEET,Unknown
BORQUEZ,24TRA104708,05/25/2024,Sale,-150.0,1125.0,1,EARLY SWEET,Unknown
BORQUEZ,24TRA104708,05/25/2024,Sale,-150.0,975.0,1,EARLY SWEET,Unknown
BORQUEZ,24TRA104708,05/25/2024,Sale,-300.0,675.0,1,EARLY SWEET,Unknown
BORQUEZ,24TRA104708,05/25/2024,Sale,-300.0,375.0,1,EARLY SWEET,Unknown
BORQUEZ,24TRA104708,05/27/2024,Sale,-375.0,0.0,3,EARLY SWEET,Clam
BORQUEZ,24TRA104709,05/24/2024,Entry,2240.0,2240.0,0,EARLY SWEET,Clam
BORQUEZ,24TRA104709,05/28/2024,Sale,-320.0,1920.0,4,EARLY SWEET,Clam
BORQUEZ,24TRA104709,05/28/2024,Sale,-1840.0,80.0,4,EARLY SWEET,Clam
BORQUEZ,24TRA104709,05/30/2024,Sale,-80.0,0.0,6,EARLY SWEET,Clam
BORQUEZ,24TRA104710,05/25/2024,Entry,2520.0,2520.0,0,EARLY SWEET,Bag
BORQUEZ,24TRA104710,05/31/2024,Sale,-90.0,2430.0,6,EARLY SWEET,Bag
BORQUEZ,24TRA104710,06/05/2024,Sale,-90.0,2340.0,11,EARLY SWEET,Bag
BORQUEZ,24TRA104710,06/05/2024,Sale,-270.0,2070.0,11,EARLY SWEET,Bag
BORQUEZ,24TRA104710,06/05/2024,Sale,-1980.0,90.0,11,EARLY SWEET,Bag
BORQUEZ,24TRA104710,06/06/2024,Sale,-90.0,0.0,12,EARLY SWEET,Bag
BORQUEZ,24TRA104711,05/25/2024,Entry,1980.0,1980.0,0,EARLY SWEET,Bag
BORQUEZ,24TRA104711,05/29/2024,Sale,-360.0,1620.0,4,EARLY SWEET,Bag
BORQUEZ,24TRA104711,05/30/2024,Sale,-450.0,1170.0,5,EARLY SWEET,Bag
BORQUEZ,24TRA104711,05/30/2024,Sale,-1170.0,0.0,5,EARLY SWEET,Bag
BORQUEZ,24TRA104712,05/25/2024,Entry,1980.0,1980.0,0,EARLY SWEET,Bag
BORQUEZ,24TRA104712,05/27/2024,Sale,-90.0,1890.0,2,EARLY SWEET,Bag
BORQUEZ,24TRA104712,05/28/2024,Sale,-900.0,990.0,3,EARLY SWEET,Bag
BORQUEZ,24TRA104712,05/29/2024,Sale,-540.0,450.0,4,EARLY SWEET,Bag
BORQUEZ,24TRA104712,05/30/2024,Sale,-90.0,360.0,5,EARLY SWEET,Bag
BORQUEZ,24TRA104712,05/30/2024,Sale,-360.0,0.0,5,EARLY SWEET,Bag
BORQUEZ,24TRA104713,05/26/2024,Entry,480.0,480.0,0,EARLY SWEET,Clam
BORQUEZ,24TRA104713,05/26/2024,Entry,1200.0,1680.0,0,EARLY SWEET,Clam
BORQUEZ,24TRA104713,05/27/2024,Sale,-1125.0,555.0,1,EARLY SWEET,Clam
BORQUEZ,24TRA104713,05/30/2024,Sale,-160.0,395.0,4,EARLY SWEET,Clam
BORQUEZ,24TRA104713,06/01/2024,Sale,-320.0,75.0,6,EARLY SWEET,Clam
BORQUEZ,24TRA104713,06/03/2024,Sale,-75.0,0.0,8,EARLY SWEET,Clam
BORQUEZ,24TRA104714,05/26/2024,Entry,160.0,160.0,0,EARLY SWEET,Clam
BORQUEZ,24TRA104714,05/26/2024,Entry,1520.0,1680.0,0,EARLY SWEET,Clam
BORQUEZ,24TRA104714,05/30/2024,Sale,-160.0,1520.0,4,EARLY SWEET,Clam
BORQUEZ,24TRA104714,05/30/2024,Sale,-1520.0,0.0,4,EARLY SWEET,Clam
BORQUEZ,24TRA104716,05/26/2024,Entry,2340.0,2340.0,0,EARLY SWEET,Bag
BORQUEZ,24TRA104716,05/30/2024,Sale,-1980.0,360.0,4,EARLY SWEET,Bag
BORQUEZ,24TRA104716,05/30/2024,Sale,-270.0,90.0,4,EARLY SWEET,Bag
BORQUEZ,24TRA104716,06/26/2024,Sale,-90.0,0.0,31,EARLY SWEET,Bag
BORQUEZ,24TRA104718,05/26/2024,Entry,1440.0,1440.0,0,EARLY SWEET,Clam
BORQUEZ,24TRA104718,05/28/2024,Sale,-800.0,640.0,2,EARLY SWEET,Clam
BORQUEZ,24TRA104718,06/05/2024,Sale,-400.0,240.0,10,EARLY SWEET,Clam
BORQUEZ,24TRA104718,06/08/2024,Sale,-240.0,0.0,13,EARLY SWEET,Clam
BORQUEZ,24TRA104723,05/28/2024,Entry,2240.0,2240.0,0,EARLY SWEET,Clam
BORQUEZ,24TRA104723,06/01/2024,Sale,-720.0,1520.0,4,EARLY SWEET,Clam
BORQUEZ,24TRA104723,06/03/2024,Sale,-1440.0,80.0,6,EARLY SWEET,Clam
BORQUEZ,24TRA104723,06/13/2024,Sale,-80.0,0.0,16,EARLY SWEET,Clam
BORQUEZ,24TRA104724,05/27/2024,Entry,320.0,320.0,0,EARLY SWEET,Clam
BORQUEZ,24TRA104724,05/27/2024,Entry,720.0,1040.0,0,EARLY SWEET,Clam
BORQUEZ,24TRA104724,06/01/2024,Sale,-720.0,320.0,5,EARLY SWEET,Clam
BORQUEZ,24TRA104724,06/08/2024,Sale,-160.0,160.0,12,EARLY SWEET,Clam
BORQUEZ,24TRA104724,06/08/2024,Sale,-160.0,0.0,12,EARLY SWEET,Clam
BORQUEZ,24TRA104726,05/29/2024,Entry,1760.0,1760.0,0,EARLY SWEET,Clam
BORQUEZ,24TRA104726,06/06/2024,Sale,-880.0,880.0,8,EARLY SWEET,Clam
BORQUEZ,24TRA104726,06/08/2024,Sale,-720.0,160.0,10,EARLY SWEET,Clam
BORQUEZ,24TRA104726,06/13/2024,Sale,-160.0,0.0,15,EARLY SWEET,Clam
BORQUEZ,24TRA104727,05/29/2024,Entry,1760.0,1760.0,0,EARLY SWEET,Clam
BORQUEZ,24TRA104727,06/12/2024,Sale,-800.0,960.0,14,EARLY SWEET,Clam
BORQUEZ,24TRA104727,06/12/2024,Sale,-880.0,80.0,14,EARLY SWEET,Clam
BORQUEZ,24TRA104727,06/13/2024,Sale,-80.0,0.0,15,EARLY SWEET,Clam
BORQUEZ,24TRA104728,05/29/2024,Entry,1760.0,1760.0,0,EARLY SWEET,Clam
BORQUEZ,24TRA104728,06/11/2024,Sale,-640.0,1120.0,13,EARLY SWEET,Clam
BORQUEZ,24TRA104728,06/12/2024,Sale,-400.0,720.0,14,EARLY SWEET,Clam
BORQUEZ,24TRA104728,06/13/2024,Sale,-720.0,0.0,15,EARLY SWEET,Clam
BORQUEZ,24TRA104729,05/29/2024,Entry,220.0,220.0,0,EARLY SWEET,Clam
BORQUEZ,24TRA104729,05/29/2024,Entry,1600.0,1820.0,0,EARLY SWEET,Clam
BORQUEZ,24TRA104729,06/10/2024,Sale,-220.0,1600.0,12,EARLY SWEET,Clam
BORQUEZ,24TRA104729,06/10/2024,Sale,-1360.0,240.0,12,EARLY SWEET,Clam
BORQUEZ,24TRA104729,06/13/2024,Sale,-240.0,0.0,15,EARLY SWEET,Clam
BORQUEZ,24TRA104730,05/29/2024,Entry,1430.0,1430.0,0,EARLY SWEET,Clam
BORQUEZ,24TRA104730,06/05/2024,Sale,-330.0,1100.0,7,EARLY SWEET,Clam
BORQUEZ,24TRA104730,06/06/2024,Sale,-220.0,880.0,8,EARLY SWEET,Clam
BORQUEZ,24TRA104730,06/10/2024,Sale,-660.0,220.0,12,EARLY SWEET,Clam
BORQUEZ,24TRA104730,06/13/2024,Sale,-110.0,110.0,15,EARLY SWEET,Clam
BORQUEZ,24TRA104730,06/14/2024,Sale,-110.0,0.0,16,EARLY SWEET,Clam
BORQUEZ,24TRA104737,05/29/2024,Entry,770.0,770.0,0,EARLY SWEET,Clam
BORQUEZ,24TRA104737,05/29/2024,Entry,1360.0,2130.0,0,EARLY SWEET,Clam
BORQUEZ,24TRA104737,06/08/2024,Sale,-960.0,1170.0,10,EARLY SWEET,Clam
BORQUEZ,24TRA104737,06/10/2024,Sale,-660.0,510.0,12,EARLY SWEET,Clam
BORQUEZ,24TRA104737,06/13/2024,Sale,-400.0,110.0,15,EARLY SWEET,Clam
BORQUEZ,24TRA104737,06/14/2024,Sale,-110.0,0.0,16,EARLY SWEET,Clam
BORQUEZ,24TRA104738,05/30/2024,Entry,1650.0,1650.0,0,EARLY SWEET,Unknown
BORQUEZ,24TRA104738,06/10/2024,Sale,-300.0,1350.0,11,EARLY SWEET,Unknown
BORQUEZ,24TRA104738,06/11/2024,Sale,-1350.0,0.0,12,EARLY SWEET,Unknown
BORQUEZ,24TRA104739,05/30/2024,Entry,1760.0,1760.0,0,EARLY SWEET,Clam
BORQUEZ,24TRA104739,06/06/2024,Sale,-1760.0,0.0,7,EARLY SWEET,Clam
BORQUEZ,24TRA104740,05/31/2024,Entry,2340.0,2340.0,0,EARLY SWEET,Bag
BORQUEZ,24TRA104740,05/31/2024,Entry,180.0,2520.0,0,EARLY SWEET,Bag
BORQUEZ,24TRA104740,05/31/2024,Sale,-90.0,2430.0,0,EARLY SWEET,Bag
BORQUEZ,24TRA104740,06/01/2024,Sale,-1170.0,1260.0,1,EARLY SWEET,Bag
BORQUEZ,24TRA104740,06/03/2024,Sale,-540.0,720.0,3,EARLY SWEET,Bag
BORQUEZ,24TRA104740,06/05/2024,Sale,-540.0,180.0,5,EARLY SWEET,Bag
BORQUEZ,24TRA104740,06/08/2024,Sale,-180.0,0.0,8,EARLY SWEET,Bag
BORQUEZ,24TRA104741,05/31/2024,Entry,2520.0,2520.0,0,EARLY SWEET,Bag
BORQUEZ,24TRA104741,05/31/2024,Sale,-540.0,1980.0,0,EARLY SWEET,Bag
BORQUEZ,24TRA104741,05/31/2024,Sale,-1980.0,0.0,0,EARLY SWEET,Bag
BORQUEZ,24TRA104744,05/31/2024,Entry,1650.0,1650.0,0,EARLY SWEET,Bag
BORQUEZ,24TRA104744,06/01/2024,Sale,-750.0,900.0,1,EARLY SWEET,Bag
BORQUEZ,24TRA104744,06/03/2024,Sale,-900.0,0.0,3,EARLY SWEET,Bag
BORQUEZ,24TRA104745,05/31/2024,Entry,1980.0,1980.0,0,EARLY SWEET,Bag
BORQUEZ,24TRA104745,06/01/2024,Sale,-1980.0,0.0,1,EARLY SWEET,Bag
BORQUEZ,24TRA104746,05/31/2024,Entry,2100.0,2100.0,0,EARLY SWEET,Unknown
BORQUEZ,24TRA104746,06/11/2024,Sale,-450.0,1650.0,11,EARLY SWEET,Unknown
BORQUEZ,24TRA104746,07/22/2024,Sale,-1500.0,150.0,52,EARLY SWEET,Unknown
BORQUEZ,24TRA104746,07/23/2024,Sale,-150.0,0.0,53,EARLY SWEET,Unknown
BORQUEZ,24TRA104747,05/31/2024,Entry,440.0,440.0,0,EARLY SWEET,Clam
BORQUEZ,24TRA104747,05/31/2024,Entry,720.0,1160.0,0,EARLY SWEET,Clam
BORQUEZ,24TRA104747,05/31/2024,Entry,300.0,1460.0,0,EARLY SWEET,Clam
BORQUEZ,24TRA104747,06/01/2024,Sale,-560.0,900.0,1,EARLY SWEET,Clam
BORQUEZ,24TRA104747,06/03/2024,Sale,-160.0,740.0,3,EARLY SWEET,Clam
BORQUEZ,24TRA104747,06/13/2024,Sale,-440.0,300.0,13,EARLY SWEET,Clam
BORQUEZ,24TRA104747,07/22/2024,Sale,-300.0,0.0,52,EARLY SWEET,Unknown
BORQUEZ,24TRA104752,05/31/2024,Entry,90.0,90.0,0,EARLY SWEET,Bag
BORQUEZ,24TRA104752,05/31/2024,Entry,1890.0,1980.0,0,EARLY SWEET,Bag
BORQUEZ,24TRA104752,05/31/2024,Sale,-630.0,1350.0,0,EARLY SWEET,Bag
BORQUEZ,24TRA104752,06/01/2024,Sale,-450.0,900.0,1,EARLY SWEET,Bag
BORQUEZ,24TRA104752,06/01/2024,Sale,-360.0,540.0,1,EARLY SWEET,Bag
BORQUEZ,24TRA104752,06/03/2024,Sale,-360.0,180.0,3,EARLY SWEET,Bag
BORQUEZ,24TRA104752,06/07/2024,Sale,-90.0,90.0,7,EARLY SWEET,Bag
BORQUEZ,24TRA104752,06/07/2024,Sale,-90.0,0.0,7,EARLY SWEET,Bag
BORQUEZ,24TRA104753,05/31/2024,Entry,1620.0,1620.0,0,EARLY SWEET,Bag
BORQUEZ,24TRA104753,05/31/2024,Entry,900.0,2520.0,0,EARLY SWEET,Bag
BORQUEZ,24TRA104753,06/01/2024,Sale,-540.0,1980.0,1,EARLY SWEET,Bag
BORQUEZ,24TRA104753,06/03/2024,Sale,-540.0,1440.0,3,EARLY SWEET,Bag
BORQUEZ,24TRA104753,06/03/2024,Sale,-90.0,1350.0,3,EARLY SWEET,Bag
BORQUEZ,24TRA104753,06/03/2024,Sale,-90.0,1260.0,3,EARLY SWEET,Bag
BORQUEZ,24TRA104753,06/04/2024,Sale,-180.0,1080.0,4,EARLY SWEET,Bag
BORQUEZ,24TRA104753,06/05/2024,Sale,-90.0,990.0,5,EARLY SWEET,Bag
BORQUEZ,24TRA104753,06/06/2024,Sale,-90.0,900.0,6,EARLY SWEET,Bag
BORQUEZ,24TRA104753,06/06/2024,Sale,-900.0,0.0,6,EARLY SWEET,Bag
BORQUEZ,24TRA104756,06/01/2024,Entry,375.0,375.0,0,EARLY SWEET,Bag
BORQUEZ,24TRA104756,06/01/2024,Entry,1275.0,1650.0,0,EARLY SWEET,Bag
BORQUEZ,24TRA104756,06/04/2024,Sale,-300.0,1350.0,3,EARLY SWEET,Bag
BORQUEZ,24TRA104756,06/05/2024,Sale,-75.0,1275.0,4,EARLY SWEET,Bag
BORQUEZ,24TRA104756,07/23/2024,Sale,-1275.0,0.0,52,EARLY SWEET,Unknown
BORQUEZ,24TRA104757,06/01/2024,Entry,1680.0,1680.0,0,EARLY SWEET,Clam
BORQUEZ,24TRA104757,06/01/2024,Sale,-1360.0,320.0,0,EARLY SWEET,Clam
BORQUEZ,24TRA104757,06/03/2024,Sale,-320.0,0.0,2,EARLY SWEET,Clam
BORQUEZ,24TRA104758,06/01/2024,Entry,975.0,975.0,0,EARLY SWEET,Clam
BORQUEZ,24TRA104758,06/01/2024,Entry,720.0,1695.0,0,EARLY SWEET,Clam
BORQUEZ,24TRA104758,06/03/2024,Sale,-720.0,975.0,2,EARLY SWEET,Clam
BORQUEZ,24TRA104758,06/06/2024,Sale,-300.0,675.0,5,EARLY SWEET,Clam
BORQUEZ,24TRA104758,06/08/2024,Sale,-675.0,0.0,7,EARLY SWEET,Clam
BORQUEZ,24TRA104762,06/01/2024,Entry,675.0,675.0,0,EARLY SWEET,Clam
BORQUEZ,24TRA104762,06/08/2024,Sale,-375.0,300.0,7,EARLY SWEET,Clam
BORQUEZ,24TRA104762,06/08/2024,Sale,-300.0,0.0,7,EARLY SWEET,Clam
BORQUEZ,24TRA104764,06/02/2024,Entry,240.0,240.0,0,EARLY SWEET,Clam
BORQUEZ,24TRA104764,06/02/2024,Entry,2000.0,2240.0,0,EARLY SWEET,Clam
BORQUEZ,24TRA104764,06/05/2024,Sale,-1920.0,320.0,3,EARLY SWEET,Clam
BORQUEZ,24TRA104764,06/05/2024,Sale,-80.0,240.0,3,EARLY SWEET,Clam
BORQUEZ,24TRA104764,06/06/2024,Sale,-160.0,80.0,4,EARLY SWEET,Clam
BORQUEZ,24TRA104764,06/06/2024,Sale,-80.0,0.0,4,EARLY SWEET,Clam
BORQUEZ,24TRA104765,06/02/2024,Entry,1260.0,1260.0,0,EARLY SWEET,Bag
BORQUEZ,24TRA104765,06/02/2024,Entry,750.0,2010.0,0,EARLY SWEET,Bag
BORQUEZ,24TRA104765,06/02/2024,Entry,300.0,2310.0,0,EARLY SWEET,Bag
BORQUEZ,24TRA104765,06/04/2024,Sale,-150.0,2160.0,2,EARLY SWEET,Bag
BORQUEZ,24TRA104765,06/04/2024,Sale,-300.0,1860.0,2,EARLY SWEET,Bag
BORQUEZ,24TRA104765,06/05/2024,Sale,-450.0,1410.0,3,EARLY SWEET,Bag
BORQUEZ,24TRA104765,06/05/2024,Sale,-180.0,1230.0,3,EARLY SWEET,Bag
BORQUEZ,24TRA104765,06/05/2024,Sale,-300.0,930.0,3,EARLY SWEET,Bag
BORQUEZ,24TRA104765,06/08/2024,Sale,-630.0,300.0,6,EARLY SWEET,Bag
BORQUEZ,24TRA104765,07/22/2024,Sale,-300.0,0.0,50,EARLY SWEET,Unknown
BORQUEZ,24TRA104766,06/02/2024,Entry,2100.0,2100.0,0,EARLY SWEET,Clam
BORQUEZ,24TRA104766,06/08/2024,Sale,-675.0,1425.0,6,EARLY SWEET,Clam
BORQUEZ,24TRA104766,06/08/2024,Sale,-1350.0,75.0,6,EARLY SWEET,Clam
BORQUEZ,24TRA104766,06/11/2024,Sale,-75.0,0.0,9,EARLY SWEET,Clam
BORQUEZ,24TRA104767,06/02/2024,Entry,630.0,630.0,0,EARLY SWEET,Clam
BORQUEZ,24TRA104767,06/02/2024,Entry,2090.0,2720.0,0,EARLY SWEET,Clam
BORQUEZ,24TRA104767,06/12/2024,Sale,-770.0,1950.0,10,EARLY SWEET,Clam
BORQUEZ,24TRA104767,06/13/2024,Sale,-440.0,1510.0,11,EARLY SWEET,Clam
BORQUEZ,24TRA104767,06/14/2024,Sale,-880.0,630.0,12,EARLY SWEET,Clam
BORQUEZ,24TRA104767,07/30/2024,Sale,-17.0,613.0,58,EARLY SWEET,Bag
BORQUEZ,24TRA104768,06/02/2024,Entry,2340.0,2340.0,0,EARLY SWEET,Bag
BORQUEZ,24TRA104768,06/06/2024,Sale,-1620.0,720.0,4,EARLY SWEET,Bag
BORQUEZ,24TRA104768,06/08/2024,Sale,-450.0,270.0,6,EARLY SWEET,Bag
BORQUEZ,24TRA104768,06/11/2024,Sale,-270.0,0.0,9,EARLY SWEET,Bag
BORQUEZ,24TRA104771,06/03/2024,Entry,1980.0,1980.0,0,EARLY SWEET,Bag
BORQUEZ,24TRA104771,06/05/2024,Sale,-1980.0,0.0,2,EARLY SWEET,Bag
BORQUEZ,24TRA104772,06/03/2024,Entry,1980.0,1980.0,0,EARLY SWEET,Bag
BORQUEZ,24TRA104772,06/10/2024,Sale,-990.0,990.0,7,EARLY SWEET,Bag
BORQUEZ,24TRA104772,06/12/2024,Sale,-630.0,360.0,9,EARLY SWEET,Bag
BORQUEZ,24TRA104772,06/14/2024,Sale,-360.0,0.0,11,EARLY SWEET,Bag
BORQUEZ,24TRA104773,06/03/2024,Entry,1650.0,1650.0,0,EARLY SWEET,Clam
BORQUEZ,24TRA104773,06/03/2024,Sale,-600.0,1050.0,0,EARLY SWEET,Clam
BORQUEZ,24TRA104773,06/05/2024,Sale,-1050.0,0.0,2,EARLY SWEET,Clam
BORQUEZ,24TRA104774,06/03/2024,Entry,2520.0,2520.0,0,EARLY SWEET,Bag
BORQUEZ,24TRA104774,06/06/2024,Sale,-1980.0,540.0,3,EARLY SWEET,Bag
BORQUEZ,24TRA104774,06/10/2024,Sale,-540.0,0.0,7,EARLY SWEET,Bag
BORQUEZ,24TRA104775,06/03/2024,Entry,2520.0,2520.0,0,EARLY SWEET,Bag
BORQUEZ,24TRA104775,06/05/2024,Sale,-1350.0,1170.0,2,EARLY SWEET,Bag
BORQUEZ,24TRA104775,06/06/2024,Sale,-90.0,1080.0,3,EARLY SWEET,Bag
BORQUEZ,24TRA104775,06/06/2024,Sale,-450.0,630.0,3,EARLY SWEET,Bag
BORQUEZ,24TRA104775,06/06/2024,Sale,-270.0,360.0,3,EARLY SWEET,Bag
BORQUEZ,24TRA104775,06/07/2024,Sale,-180.0,180.0,4,EARLY SWEET,Bag
BORQUEZ,24TRA104775,06/07/2024,Sale,-90.0,90.0,4,EARLY SWEET,Bag
BORQUEZ,24TRA104775,06/07/2024,Sale,-90.0,0.0,4,EARLY SWEET,Bag
BORQUEZ,24TRA104776,06/03/2024,Entry,1800.0,1800.0,0,EARLY SWEET,Clam
BORQUEZ,24TRA104776,06/03/2024,Entry,300.0,2100.0,0,EARLY SWEET,Clam
BORQUEZ,24TRA104776,06/05/2024,Sale,-225.0,1875.0,2,EARLY SWEET,Clam
BORQUEZ,24TRA104776,06/07/2024,Sale,-1500.0,375.0,4,EARLY SWEET,Clam
BORQUEZ,24TRA104776,06/07/2024,Sale,-75.0,300.0,4,EARLY SWEET,Clam
BORQUEZ,24TRA104776,06/08/2024,Sale,-300.0,0.0,5,EARLY SWEET,Clam
BORQUEZ,24TRA104777,06/03/2024,Entry,360.0,360.0,0,EARLY SWEET,Bag
BORQUEZ,24TRA104777,06/03/2024,Entry,360.0,720.0,0,EARLY SWEET,Bag
BORQUEZ,24TRA104777,06/03/2024,Entry,750.0,1470.0,0,EARLY SWEET,Bag
BORQUEZ,24TRA104777,06/04/2024,Sale,-450.0,1020.0,1,EARLY SWEET,Bag
BORQUEZ,24TRA104777,06/05/2024,Sale,-300.0,720.0,2,EARLY SWEET,Bag
BORQUEZ,24TRA104777,06/06/2024,Sale,-360.0,360.0,3,EARLY SWEET,Bag
BORQUEZ,24TRA104777,06/26/2024,Sale,-360.0,0.0,23,EARLY SWEET,Bag
BORQUEZ,24TRA104779,06/04/2024,Entry,2520.0,2520.0,0,EARLY SWEET,Bag
BORQUEZ,24TRA104779,06/06/2024,Sale,-1890.0,630.0,2,EARLY SWEET,Bag
BORQUEZ,24TRA104779,06/06/2024,Sale,-630.0,0.0,2,EARLY SWEET,Bag
BORQUEZ,24TRA104781,06/04/2024,Entry,2520.0,2520.0,0,EARLY SWEET,Bag
BORQUEZ,24TRA104781,06/06/2024,Sale,-1980.0,540.0,2,EARLY SWEET,Bag
BORQUEZ,24TRA104781,06/07/2024,Sale,-450.0,90.0,3,EARLY SWEET,Bag
BORQUEZ,24TRA104781,06/07/2024,Sale,-90.0,0.0,3,EARLY SWEET,Bag
BORQUEZ,24TRA104782,06/04/2024,Entry,825.0,825.0,0,EARLY SWEET,Clam
BORQUEZ,24TRA104782,06/04/2024,Entry,600.0,1425.0,0,EARLY SWEET,Clam
BORQUEZ,24TRA104782,06/05/2024,Sale,-450.0,975.0,1,EARLY SWEET,Clam
BORQUEZ,24TRA104782,06/07/2024,Sale,-300.0,675.0,3,EARLY SWEET,Clam
BORQUEZ,24TRA104782,06/07/2024,Sale,-75.0,600.0,3,EARLY SWEET,Clam
BORQUEZ,24TRA104782,06/08/2024,Sale,-525.0,75.0,4,EARLY SWEET,Clam
BORQUEZ,24TRA104782,06/11/2024,Sale,-75.0,0.0,7,EARLY SWEET,Clam
BORQUEZ,24TRA104784,06/05/2024,Entry,360.0,360.0,0,EARLY SWEET,Bag
BORQUEZ,24TRA104784,06/05/2024,Entry,450.0,810.0,0,EARLY SWEET,Bag
BORQUEZ,24TRA104784,06/05/2024,Entry,1425.0,2235.0,0,EARLY SWEET,Bag
BORQUEZ,24TRA104784,06/05/2024,Sale,-225.0,2010.0,0,EARLY SWEET,Bag
BORQUEZ,24TRA104784,06/05/2024,Sale,-825.0,1185.0,0,EARLY SWEET,Bag
BORQUEZ,24TRA104784,06/07/2024,Sale,-360.0,825.0,2,EARLY SWEET,Bag
BORQUEZ,24TRA104784,06/07/2024,Sale,-375.0,450.0,2,EARLY SWEET,Bag
BORQUEZ,24TRA104784,06/10/2024,Sale,-360.0,90.0,5,EARLY SWEET,Bag
BORQUEZ,24TRA104784,06/12/2024,Sale,-90.0,0.0,7,EARLY SWEET,Bag
BORQUEZ,24TRA104785,06/04/2024,Entry,2520.0,2520.0,0,EARLY SWEET,Bag
BORQUEZ,24TRA104785,06/04/2024,Sale,-1800.0,720.0,0,EARLY SWEET,Bag
BORQUEZ,24TRA104785,06/07/2024,Sale,-720.0,0.0,3,EARLY SWEET,Bag
BORQUEZ,24TRA104787,06/05/2024,Entry,2520.0,2520.0,0,EARLY SWEET,Bag
BORQUEZ,24TRA104787,06/06/2024,Sale,-1980.0,540.0,1,EARLY SWEET,Bag
BORQUEZ,24TRA104787,06/07/2024,Sale,-540.0,0.0,2,EARLY SWEET,Bag
BORQUEZ,24TRA104788,06/05/2024,Entry,2520.0,2520.0,0,EARLY SWEET,Bag
BORQUEZ,24TRA104788,06/05/2024,Sale,-1980.0,540.0,0,EARLY SWEET,Bag
BORQUEZ,24TRA104788,06/07/2024,Sale,-540.0,0.0,2,EARLY SWEET,Bag
BORQUEZ,24TRA104790,06/06/2024,Entry,2430.0,2430.0,0,EARLY SWEET,Bag
BORQUEZ,24TRA104790,06/06/2024,Entry,90.0,2520.0,0,EARLY SWEET,Bag
BORQUEZ,24TRA104790,06/08/2024,Sale,-1980.0,540.0,2,EARLY SWEET,Bag
BORQUEZ,24TRA104790,06/10/2024,Sale,-90.0,450.0,4,EARLY SWEET,Bag
BORQUEZ,24TRA104790,06/10/2024,Sale,-90.0,360.0,4,EARLY SWEET,Bag
BORQUEZ,24TRA104790,06/12/2024,Sale,-360.0,0.0,6,EARLY SWEET,Bag
BORQUEZ,24TRA104800,06/06/2024,Entry,1980.0,1980.0,0,EARLY SWEET,Bag
BORQUEZ,24TRA104800,06/07/2024,Sale,-1800.0,180.0,1,EARLY SWEET,Bag
BORQUEZ,24TRA104800,06/07/2024,Sale,-180.0,0.0,1,EARLY SWEET,Bag
BORQUEZ,24TRA104801,06/06/2024,Entry,1980.0,1980.0,0,EARLY SWEET,Bag
BORQUEZ,24TRA104801,06/07/2024,Sale,-900.0,1080.0,1,EARLY SWEET,Bag
BORQUEZ,24TRA104801,06/07/2024,Sale,-900.0,180.0,1,EARLY SWEET,Bag
BORQUEZ,24TRA104801,06/13/2024,Sale,-180.0,0.0,7,EARLY SWEET,Bag
BORQUEZ,24TRA104804,06/06/2024,Entry,2520.0,2520.0,0,EARLY SWEET,Bag
BORQUEZ,24TRA104804,06/07/2024,Sale,-720.0,1800.0,1,EARLY SWEET,Bag
BORQUEZ,24TRA104804,06/07/2024,Sale,-1080.0,720.0,1,EARLY SWEET,Bag
BORQUEZ,24TRA104804,06/07/2024,Sale,-720.0,0.0,1,EARLY SWEET,Bag
BORQUEZ,24TRA104805,06/07/2024,Entry,1530.0,1530.0,0,EARLY SWEET,Bag
BORQUEZ,24TRA104805,06/07/2024,Sale,-630.0,900.0,0,EARLY SWEET,Bag
BORQUEZ,24TRA104805,06/08/2024,Sale,-810.0,90.0,1,EARLY SWEET,Bag
BORQUEZ,24TRA104805,06/11/2024,Sale,-90.0,0.0,4,EARLY SWEET,Bag
BORQUEZ,24TRA104807,06/07/2024,Entry,2100.0,2100.0,0,EARLY SWEET,Bag
BORQUEZ,24TRA104807,06/08/2024,Sale,-600.0,1500.0,1,EARLY SWEET,Bag
BORQUEZ,24TRA104807,06/08/2024,Sale,-375.0,1125.0,1,EARLY SWEET,Bag
BORQUEZ,24TRA104807,06/10/2024,Sale,-225.0,900.0,3,EARLY SWEET,Bag
BORQUEZ,24TRA104807,06/10/2024,Sale,-900.0,0.0,3,EARLY SWEET,Bag
BORQUEZ,24TRA104808,06/06/2024,Entry,1890.0,1890.0,0,EARLY SWEET,Bag
BORQUEZ,24TRA104808,06/06/2024,Entry,525.0,2415.0,0,EARLY SWEET,Bag
BORQUEZ,24TRA104808,06/07/2024,Sale,-525.0,1890.0,1,EARLY SWEET,Bag
BORQUEZ,24TRA104808,06/10/2024,Sale,-1350.0,540.0,4,EARLY SWEET,Bag
BORQUEZ,24TRA104808,06/11/2024,Sale,-540.0,0.0,5,EARLY SWEET,Bag
BORQUEZ,24TRA104809,06/07/2024,Entry,1980.0,1980.0,0,EARLY SWEET,Bag
BORQUEZ,24TRA104809,06/08/2024,Sale,-1890.0,90.0,1,EARLY SWEET,Bag
BORQUEZ,24TRA104809,06/13/2024,Sale,-90.0,0.0,6,EARLY SWEET,Bag
BORQUEZ,24TRA104810,06/07/2024,Entry,150.0,150.0,0,EARLY SWEET,Clam
BORQUEZ,24TRA104810,06/21/2024,Sale,-150.0,0.0,14,EARLY SWEET,Clam
BORQUEZ,24TRA104815,06/07/2024,Entry,1980.0,1980.0,0,EARLY SWEET,Bag
BORQUEZ,24TRA104815,06/08/2024,Sale,-1980.0,0.0,1,EARLY SWEET,Bag
BORQUEZ,24TRA104816,06/07/2024,Entry,1980.0,1980.0,0,EARLY SWEET,Bag
BORQUEZ,24TRA104816,06/08/2024,Sale,-450.0,1530.0,1,EARLY SWEET,Bag
BORQUEZ,24TRA104816,06/08/2024,Sale,-180.0,1350.0,1,EARLY SWEET,Bag
BORQUEZ,24TRA104816,06/08/2024,Sale,-180.0,1170.0,1,EARLY SWEET,Bag
BORQUEZ,24TRA104816,06/10/2024,Sale,-360.0,810.0,3,EARLY SWEET,Bag
BORQUEZ,24TRA104816,06/10/2024,Sale,-90.0,720.0,3,EARLY SWEET,Bag
BORQUEZ,24TRA104816,06/14/2024,Sale,-90.0,630.0,7,EARLY SWEET,Bag
BORQUEZ,24TRA104820,06/07/2024,Entry,2250.0,2250.0,0,EARLY SWEET,Bag
BORQUEZ,24TRA104820,06/07/2024,Entry,270.0,2520.0,0,EARLY SWEET,Bag
BORQUEZ,24TRA104820,06/07/2024,Sale,-270.0,2250.0,0,EARLY SWEET,Bag
BORQUEZ,24TRA104820,06/11/2024,Sale,-270.0,1980.0,4,EARLY SWEET,Bag
BORQUEZ,24TRA104820,06/11/2024,Sale,-1980.0,0.0,4,EARLY SWEET,Bag
BORQUEZ,24TRA104823,06/08/2024,Entry,1440.0,1440.0,0,EARLY SWEET,Bag
BORQUEZ,24TRA104823,06/13/2024,Sale,-1440.0,0.0,5,EARLY SWEET,Bag
BORQUEZ,24TRA104825,06/08/2024,Entry,1980.0,1980.0,0,EARLY SWEET,Bag
BORQUEZ,24TRA104825,06/10/2024,Sale,-990.0,990.0,2,EARLY SWEET,Bag
BORQUEZ,24TRA104825,06/12/2024,Sale,-900.0,90.0,4,EARLY SWEET,Bag
BORQUEZ,24TRA104825,06/13/2024,Sale,-90.0,0.0,5,EARLY SWEET,Bag
BORQUEZ,24TRA104826,06/08/2024,Entry,360.0,360.0,0,EARLY SWEET,Bag
BORQUEZ,24TRA104826,06/08/2024,Entry,1620.0,1980.0,0,EARLY SWEET,Bag
BORQUEZ,24TRA104826,06/10/2024,Sale,-1620.0,360.0,2,EARLY SWEET,Bag
BORQUEZ,24TRA104826,06/14/2024,Sale,-270.0,90.0,6,EARLY SWEET,Bag
BORQUEZ,24TRA104826,06/24/2024,Sale,-90.0,0.0,16,EARLY SWEET,Bag
BORQUEZ,24TRA104827,06/08/2024,Entry,1980.0,1980.0,0,EARLY SWEET,Bag
BORQUEZ,24TRA104827,06/10/2024,Sale,-1980.0,0.0,2,EARLY SWEET,Bag
BORQUEZ,24TRA104831,06/09/2024,Entry,2100.0,2100.0,0,EARLY SWEET,Bag
BORQUEZ,24TRA104831,06/10/2024,Sale,-300.0,1800.0,1,EARLY SWEET,Bag
BORQUEZ,24TRA104831,06/13/2024,Sale,-600.0,1200.0,4,EARLY SWEET,Bag
BORQUEZ,24TRA104831,06/14/2024,Sale,-825.0,375.0,5,EARLY SWEET,Bag
BORQUEZ,24TRA104831,06/14/2024,Sale,-375.0,0.0,5,EARLY SWEET,Bag
BORQUEZ,24TRA104832,06/09/2024,Entry,1500.0,1500.0,0,EARLY SWEET,Bag
BORQUEZ,24TRA104832,06/10/2024,Sale,-75.0,1425.0,1,EARLY SWEET,Bag
BORQUEZ,24TRA104832,06/11/2024,Sale,-750.0,675.0,2,EARLY SWEET,Bag
BORQUEZ,24TRA104832,06/12/2024,Sale,-450.0,225.0,3,EARLY SWEET,Bag
BORQUEZ,24TRA104832,06/13/2024,Sale,-150.0,75.0,4,EARLY SWEET,Bag
BORQUEZ,24TRA104832,06/14/2024,Sale,-75.0,0.0,5,EARLY SWEET,Bag
BORQUEZ,24TRA104833,06/10/2024,Entry,180.0,180.0,0,EARLY SWEET,Clam
BORQUEZ,24TRA104833,06/10/2024,Entry,630.0,810.0,0,EARLY SWEET,Clam
BORQUEZ,24TRA104833,06/10/2024,Entry,1425.0,2235.0,0,EARLY SWEET,Clam
BORQUEZ,24TRA104833,06/13/2024,Sale,-1425.0,810.0,3,EARLY SWEET,Clam
BORQUEZ,24TRA104833,06/17/2024,Sale,-180.0,630.0,7,EARLY SWEET,Bag
BORQUEZ,24TRA104833,06/29/2024,Sale,-180.0,450.0,19,EARLY SWEET,Bag
BORQUEZ,24TRA104833,07/12/2024,Sale,-360.0,90.0,32,EARLY SWEET,Bag
BORQUEZ,24TRA104833,07/15/2024,Sale,-90.0,0.0,35,EARLY SWEET,Bag
BORQUEZ,24TRA104836,06/10/2024,Entry,450.0,450.0,0,EARLY SWEET,Clam
BORQUEZ,24TRA104836,06/13/2024,Sale,-375.0,75.0,3,EARLY SWEET,Clam
BORQUEZ,24TRA104836,06/13/2024,Sale,-75.0,0.0,3,EARLY SWEET,Clam
BORQUEZ,24TRA104838,06/10/2024,Entry,2520.0,2520.0,0,EARLY SWEET,Bag
BORQUEZ,24TRA104838,06/11/2024,Sale,-630.0,1890.0,1,EARLY SWEET,Bag
BORQUEZ,24TRA104838,06/13/2024,Sale,-360.0,1530.0,3,EARLY SWEET,Bag
BORQUEZ,24TRA104838,06/14/2024,Sale,-1080.0,450.0,4,EARLY SWEET,Bag
BORQUEZ,24TRA104838,07/30/2024,Sale,-28.0,422.0,50,EARLY SWEET,Bag
BORQUEZ,24TRA104839,06/10/2024,Entry,1170.0,1170.0,0,EARLY SWEET,Bag
BORQUEZ,24TRA104839,06/10/2024,Entry,1350.0,2520.0,0,EARLY SWEET,Bag
BORQUEZ,24TRA104839,06/11/2024,Sale,-1170.0,1350.0,1,EARLY SWEET,Bag
BORQUEZ,24TRA104839,06/11/2024,Sale,-1350.0,0.0,1,EARLY SWEET,Bag
BORQUEZ,24TRA104842,06/11/2024,Entry,2340.0,2340.0,0,EARLY SWEET,Bag
BORQUEZ,24TRA104842,06/12/2024,Sale,-90.0,2250.0,1,EARLY SWEET,Bag
BORQUEZ,24TRA104842,06/12/2024,Sale,-1980.0,270.0,1,EARLY SWEET,Bag
BORQUEZ,24TRA104842,06/17/2024,Sale,-180.0,90.0,6,EARLY SWEET,Bag
BORQUEZ,24TRA104842,06/21/2024,Sale,-90.0,0.0,10,EARLY SWEET,Bag
BORQUEZ,24TRA104844,06/11/2024,Entry,1980.0,1980.0,0,EARLY SWEET,Bag
BORQUEZ,24TRA104844,06/12/2024,Sale,-1890.0,90.0,1,EARLY SWEET,Bag
BORQUEZ,24TRA104844,06/21/2024,Sale,-90.0,0.0,10,EARLY SWEET,Bag
BORQUEZ,24TRA104845,06/12/2024,Entry,540.0,540.0,0,EARLY SWEET,Bag
BORQUEZ,24TRA104845,06/12/2024,Entry,1650.0,2190.0,0,EARLY SWEET,Bag
BORQUEZ,24TRA104845,06/12/2024,Sale,-540.0,1650.0,0,EARLY SWEET,Bag
BORQUEZ,24TRA104845,06/12/2024,Sale,-675.0,975.0,0,EARLY SWEET,Clam
BORQUEZ,24TRA104845,06/14/2024,Sale,-75.0,900.0,2,EARLY SWEET,Clam
BORQUEZ,24TRA104845,06/18/2024,Sale,-600.0,300.0,6,EARLY SWEET,Clam
BORQUEZ,24TRA104845,06/21/2024,Sale,-300.0,0.0,9,EARLY SWEET,Clam
BORQUEZ,24TRA104846,06/12/2024,Entry,270.0,270.0,0,EARLY SWEET,Bag
BORQUEZ,24TRA104846,06/12/2024,Entry,1080.0,1350.0,0,EARLY SWEET,Bag
BORQUEZ,24TRA104846,06/12/2024,Entry,1170.0,2520.0,0,EARLY SWEET,Bag
BORQUEZ,24TRA104846,06/13/2024,Sale,-90.0,2430.0,1,EARLY SWEET,Bag
BORQUEZ,24TRA104846,06/14/2024,Sale,-990.0,1440.0,2,EARLY SWEET,Bag
BORQUEZ,24TRA104846,06/14/2024,Sale,-630.0,810.0,2,EARLY SWEET,Bag
BORQUEZ,24TRA104846,06/17/2024,Sale,-270.0,540.0,5,EARLY SWEET,Bag
BORQUEZ,24TRA104846,06/21/2024,Sale,-270.0,270.0,9,EARLY SWEET,Bag
BORQUEZ,24TRA104846,06/26/2024,Sale,-90.0,180.0,14,EARLY SWEET,Bag
BORQUEZ,24TRA104846,07/02/2024,Sale,-90.0,90.0,20,EARLY SWEET,Bag
BORQUEZ,24TRA104848,06/12/2024,Entry,2520.0,2520.0,0,EARLY SWEET,Bag
BORQUEZ,24TRA104848,06/14/2024,Sale,-90.0,2430.0,2,EARLY SWEET,Bag
BORQUEZ,24TRA104848,06/15/2024,Sale,-1980.0,450.0,3,EARLY SWEET,Bag
BORQUEZ,24TRA104848,06/17/2024,Sale,-450.0,0.0,5,EARLY SWEET,Bag
BORQUEZ,24TRA104849,06/12/2024,Entry,990.0,990.0,0,EARLY SWEET,Clam
BORQUEZ,24TRA104849,06/12/2024,Entry,825.0,1815.0,0,EARLY SWEET,Clam
BORQUEZ,24TRA104849,06/13/2024,Sale,-825.0,990.0,1,EARLY SWEET,Clam
BORQUEZ,24TRA104849,06/17/2024,Sale,-990.0,0.0,5,EARLY SWEET,Bag
BORQUEZ,24TRA104850,06/12/2024,Entry,1079.0,1079.0,0,EARLY SWEET,Clam
BORQUEZ,24TRA104850,06/12/2024,Entry,750.0,1829.0,0,EARLY SWEET,Clam
BORQUEZ,24TRA104850,06/13/2024,Sale,-750.0,1079.0,1,EARLY SWEET,Clam
BORQUEZ,24TRA104850,06/18/2024,Sale,-450.0,629.0,6,EARLY SWEET,Bag
BORQUEZ,24TRA104850,06/24/2024,Sale,-629.0,0.0,12,EARLY SWEET,Bag
BORQUEZ,24TRA104857,06/13/2024,Entry,2520.0,2520.0,0,EARLY SWEET,Bag
BORQUEZ,24TRA104857,06/14/2024,Sale,-1890.0,630.0,1,EARLY SWEET,Bag
BORQUEZ,24TRA104857,06/14/2024,Sale,-630.0,0.0,1,EARLY SWEET,Bag
BORQUEZ,24TRA104859,06/13/2024,Entry,2100.0,2100.0,0,EARLY SWEET,Clam
BORQUEZ,24TRA104859,06/17/2024,Sale,-1800.0,300.0,4,EARLY SWEET,Clam
BORQUEZ,24TRA104859,06/21/2024,Sale,-300.0,0.0,8,EARLY SWEET,Clam
BORQUEZ,24TRA104866,06/14/2024,Entry,1980.0,1980.0,0,EARLY SWEET,Bag
BORQUEZ,24TRA104866,06/15/2024,Sale,-1980.0,0.0,1,EARLY SWEET,Bag
BORQUEZ,24TRA104867,06/14/2024,Entry,1980.0,1980.0,0,EARLY SWEET,Bag
BORQUEZ,24TRA104867,06/15/2024,Sale,-1980.0,0.0,1,EARLY SWEET,Bag
BORQUEZ,24TRA104868,06/14/2024,Entry,1425.0,1425.0,0,EARLY SWEET,Clam
BORQUEZ,24TRA104868,06/18/2024,Sale,-750.0,675.0,4,EARLY SWEET,Clam
BORQUEZ,24TRA104868,06/18/2024,Sale,-675.0,0.0,4,EARLY SWEET,Clam
BORQUEZ,24TRA104870,06/14/2024,Entry,2520.0,2520.0,0,EARLY SWEET,Bag
BORQUEZ,24TRA104870,06/15/2024,Sale,-810.0,1710.0,1,EARLY SWEET,Bag
BORQUEZ,24TRA104870,06/20/2024,Sale,-90.0,1620.0,6,EARLY SWEET,Bag
BORQUEZ,24TRA104870,06/26/2024,Sale,-90.0,1530.0,12,EARLY SWEET,Bag
BORQUEZ,24TRA104870,07/01/2024,Sale,-180.0,1350.0,17,EARLY SWEET,Bag
BORQUEZ,24TRA104870,07/02/2024,Sale,-1170.0,180.0,18,EARLY SWEET,Bag
BORQUEZ,24TRA104871,06/14/2024,Entry,375.0,375.0,0,EARLY SWEET,Clam
BORQUEZ,24TRA104871,06/14/2024,Entry,1840.0,2215.0,0,EARLY SWEET,Clam
BORQUEZ,24TRA104871,06/15/2024,Sale,-1840.0,375.0,1,EARLY SWEET,Clam
BORQUEZ,24TRA104871,06/18/2024,Sale,-150.0,225.0,4,EARLY SWEET,Clam
BORQUEZ,24TRA104871,06/18/2024,Sale,-225.0,0.0,4,EARLY SWEET,Clam
BORQUEZ,24TRA104872,06/15/2024,Entry,2520.0,2520.0,0,EARLY SWEET,Bag
BORQUEZ,24TRA104872,06/19/2024,Sale,-450.0,2070.0,4,EARLY SWEET,Bag
BORQUEZ,24TRA104872,06/20/2024,Sale,-450.0,1620.0,5,EARLY SWEET,Bag
BORQUEZ,24TRA104872,06/20/2024,Sale,-90.0,1530.0,5,EARLY SWEET,Bag
BORQUEZ,24TRA104872,06/24/2024,Sale,-1530.0,0.0,9,EARLY SWEET,Bag
BORQUEZ,24TRA104873,06/15/2024,Entry,2520.0,2520.0,0,EARLY SWEET,Bag
BORQUEZ,24TRA104873,07/01/2024,Sale,-1980.0,540.0,16,EARLY SWEET,Bag
BORQUEZ,24TRA104873,07/02/2024,Sale,-540.0,0.0,17,EARLY SWEET,Bag
BORQUEZ,24TRA104874,06/15/2024,Entry,1980.0,1980.0,0,EARLY SWEET,Bag
BORQUEZ,24TRA104874,06/18/2024,Sale,-1980.0,0.0,3,EARLY SWEET,Bag
BORQUEZ,24TRA104876,06/17/2024,Entry,1800.0,1800.0,0,EARLY SWEET,Bag
BORQUEZ,24TRA104876,07/02/2024,Sale,-1800.0,0.0,15,EARLY SWEET,Bag
BORQUEZ,24TRA104878,06/17/2024,Entry,2520.0,2520.0,0,EARLY SWEET,Bag
BORQUEZ,24TRA104878,06/20/2024,Sale,-90.0,2430.0,3,EARLY SWEET,Bag
BORQUEZ,24TRA104878,07/03/2024,Sale,-45.0,2385.0,16,EARLY SWEET,Bag
BORQUEZ,24TRA104878,07/03/2024,Sale,-45.0,2340.0,16,EARLY SWEET,Bag
BORQUEZ,24TRA104878,07/03/2024,Sale,-990.0,1350.0,16,EARLY SWEET,Bag
BORQUEZ,24TRA104878,07/03/2024,Sale,-720.0,630.0,16,EARLY SWEET,Bag
BORQUEZ,24TRA104878,07/06/2024,Sale,-360.0,270.0,19,EARLY SWEET,Bag
BORQUEZ,24TRA104879,06/17/2024,Entry,1980.0,1980.0,0,EARLY SWEET,Bag
BORQUEZ,24TRA104879,07/02/2024,Sale,-1350.0,630.0,15,EARLY SWEET,Bag
BORQUEZ,24TRA104879,07/02/2024,Sale,-180.0,450.0,15,EARLY SWEET,Bag
BORQUEZ,24TRA104879,07/22/2024,Sale,-450.0,0.0,35,EARLY SWEET,Bag
BORQUEZ,24TRA104880,06/17/2024,Entry,1980.0,1980.0,0,EARLY SWEET,Bag
BORQUEZ,24TRA104880,07/02/2024,Sale,-1170.0,810.0,15,EARLY SWEET,Bag
BORQUEZ,24TRA104880,07/02/2024,Sale,-810.0,0.0,15,EARLY SWEET,Bag
BORQUEZ,24TRA104882,06/18/2024,Entry,2520.0,2520.0,0,EARLY SWEET,Bag
BORQUEZ,24TRA104882,06/19/2024,Sale,-90.0,2430.0,1,EARLY SWEET,Bag
BORQUEZ,24TRA104882,07/02/2024,Sale,-1080.0,1350.0,14,EARLY SWEET,Bag
BORQUEZ,24TRA104882,07/03/2024,Sale,-90.0,1260.0,15,EARLY SWEET,Bag
BORQUEZ,24TRA104882,07/03/2024,Sale,-720.0,540.0,15,EARLY SWEET,Bag
BORQUEZ,24TRA104882,07/23/2024,Sale,-450.0,90.0,35,EARLY SWEET,Bag
BORQUEZ,24TRA104882,07/23/2024,Sale,-90.0,0.0,35,EARLY SWEET,Bag
BORQUEZ,24TRA104884,06/19/2024,Entry,2520.0,2520.0,0,EARLY SWEET,Bag
BORQUEZ,24TRA104884,06/21/2024,Sale,-450.0,2070.0,2,EARLY SWEET,Bag
BORQUEZ,24TRA104884,06/24/2024,Sale,-90.0,1980.0,5,EARLY SWEET,Bag
BORQUEZ,24TRA104884,07/02/2024,Sale,-810.0,1170.0,13,EARLY SWEET,Bag
BORQUEZ,24TRA104884,07/02/2024,Sale,-450.0,720.0,13,EARLY SWEET,Bag
BORQUEZ,24TRA104884,07/06/2024,Sale,-90.0,630.0,17,EARLY SWEET,Bag
BORQUEZ,24TRA104884,07/23/2024,Sale,-90.0,540.0,34,EARLY SWEET,Bag
BORQUEZ,24TRA104884,07/30/2024,Sale,-540.0,0.0,41,EARLY SWEET,Bag
BORQUEZ,24TRA104888,06/19/2024,Entry,450.0,450.0,0,EARLY SWEET,Bag
BORQUEZ,24TRA104888,06/24/2024,Sale,-450.0,0.0,5,EARLY SWEET,Bag
ECO,0001-0010239,11/12/2023,Entry,1800.0,1800.0,0,SWEET GLOBE,Bag
ECO,0001-0010239,11/15/2023,Sale,-90.0,1710.0,3,SWEET GLOBE,Bag
ECO,0001-0010239,11/21/2023,Sale,-900.0,810.0,9,SWEET GLOBE,Bag
ECO,0001-0010239,11/24/2023,Sale,-810.0,0.0,12,SWEET GLOBE,Bag
ECO,0001-0010317,11/27/2023,Entry,1800.0,1800.0,0,SWEET GLOBE,Bag
ECO,0001-0010317,11/28/2023,Sale,-270.0,1530.0,1,SWEET GLOBE,Bag
ECO,0001-0010317,11/30/2023,Sale,-540.0,990.0,3,SWEET GLOBE,Bag
ECO,0001-0010317,12/04/2023,Sale,-540.0,450.0,7,SWEET GLOBE,Bag
ECO,0001-0010317,12/04/2023,Sale,-450.0,0.0,7,SWEET GLOBE,Bag
ECO,0001-0010320,11/21/2023,Entry,1800.0,1800.0,0,SWEET GLOBE,Bag
ECO,0001-0010320,11/24/2023,Sale,-1438.0,362.0,3,SWEET GLOBE,Bag
ECO,0001-0010320,11/25/2023,Sale,-180.0,182.0,4,SWEET GLOBE,Bag
ECO,0001-0010320,11/27/2023,Sale,-180.0,2.0,6,SWEET GLOBE,Bag
ECO,0001-0010321,11/21/2023,Entry,1800.0,1800.0,0,SWEET GLOBE,Bag
ECO,0001-0010321,11/24/2023,Sale,-180.0,1620.0,3,SWEET GLOBE,Bag
ECO,0001-0010321,11/27/2023,Sale,-1620.0,0.0,6,SWEET GLOBE,Bag
ECO,0001-0010325,11/21/2023,Entry,1800.0,1800.0,0,SWEET GLOBE,Bag
ECO,0001-0010325,11/24/2023,Sale,-270.0,1530.0,3,SWEET GLOBE,Bag
ECO,0001-0010325,11/27/2023,Sale,-180.0,1350.0,6,SWEET GLOBE,Bag
ECO,0001-0010325,11/27/2023,Sale,-900.0,450.0,6,SWEET GLOBE,Bag
ECO,0001-0010325,11/28/2023,Sale,-360.0,90.0,7,SWEET GLOBE,Bag
ECO,0001-0010325,12/04/2023,Sale,-90.0,0.0,13,SWEET GLOBE,Bag
ECO,0001-0010352,11/21/2023,Entry,1800.0,1800.0,0,CRIMSON,Bag
ECO,0001-0010352,11/25/2023,Sale,-180.0,1620.0,4,CRIMSON,Bag
ECO,0001-0010352,11/27/2023,Sale,-180.0,1440.0,6,CRIMSON,Bag
ECO,0001-0010352,11/27/2023,Sale,-1440.0,0.0,6,CRIMSON,Bag
ECO,0001-0010355,11/21/2023,Entry,1800.0,1800.0,0,CRIMSON,Bag
ECO,0001-0010355,11/24/2023,Sale,-1800.0,0.0,3,CRIMSON,Bag
ECO,0001-0010361,11/17/2023,Entry,1800.0,1800.0,0,CRIMSON,Bag
ECO,0001-0010361,11/28/2023,Sale,-1800.0,0.0,11,CRIMSON,Bag
ECO,0001-0010384,11/21/2023,Entry,1800.0,1800.0,0,SWEET GLOBE,Bag
ECO,0001-0010384,11/24/2023,Sale,-1080.0,720.0,3,SWEET GLOBE,Bag
ECO,0001-0010384,11/28/2023,Sale,-90.0,630.0,7,SWEET GLOBE,Bag
ECO,0001-0010384,11/28/2023,Sale,-180.0,450.0,7,SWEET GLOBE,Bag
ECO,0001-0010384,11/28/2023,Sale,-90.0,360.0,7,SWEET GLOBE,Bag
ECO,0001-0010384,12/04/2023,Sale,-360.0,0.0,13,SWEET GLOBE,Bag
ECO,0001-0010387,11/21/2023,Entry,1800.0,1800.0,0,SWEETCELEBRATION,Bag
ECO,0001-0010387,11/24/2023,Sale,-1800.0,0.0,3,SWEETCELEBRATION,Bag
ECO,0001-0010444,11/22/2023,Entry,1800.0,1800.0,0,CRIMSON,Bag
ECO,0001-0010444,11/27/2023,Sale,-810.0,990.0,5,CRIMSON,Bag
ECO,0001-0010444,11/28/2023,Sale,-270.0,720.0,6,CRIMSON,Bag
ECO,0001-0010444,11/28/2023,Sale,-180.0,540.0,6,CRIMSON,Bag
ECO,0001-0010444,11/29/2023,Sale,-540.0,0.0,7,CRIMSON,Bag
ECO,0001-0010447,11/22/2023,Entry,1800.0,1800.0,0,CRIMSON,Bag
ECO,0001-0010447,11/27/2023,Sale,-1170.0,630.0,5,CRIMSON,Bag
ECO,0001-0010447,11/27/2023,Sale,-540.0,90.0,5,CRIMSON,Bag
ECO,0001-0010447,11/29/2023,Sale,-90.0,0.0,7,CRIMSON,Bag
ECO,0001-0010489,11/22/2023,Entry,1800.0,1800.0,0,CRIMSON,Bag
ECO,0001-0010489,11/29/2023,Sale,-1350.0,450.0,7,CRIMSON,Bag
ECO,0001-0010489,11/30/2023,Sale,-450.0,0.0,8,CRIMSON,Bag
ECO,0001-0010562,11/29/2023,Entry,1800.0,1800.0,0,SWEET GLOBE,Bag
ECO,0001-0010562,11/30/2023,Sale,-360.0,1440.0,1,SWEET GLOBE,Bag
ECO,0001-0010562,12/01/2023,Sale,-90.0,1350.0,2,SWEET GLOBE,Bag
ECO,0001-0010562,12/04/2023,Sale,-540.0,810.0,5,SWEET GLOBE,Bag
ECO,0001-0010562,12/05/2023,Sale,-360.0,450.0,6,SWEET GLOBE,Bag
ECO,0001-0010562,12/06/2023,Sale,-270.0,180.0,7,SWEET GLOBE,Bag
ECO,0001-0010562,12/08/2023,Sale,-90.0,90.0,9,SWEET GLOBE,Bag
ECO,0001-0010562,12/12/2023,Sale,-90.0,0.0,13,SWEET GLOBE,Bag
ECO,0001-0010564,11/29/2023,Entry,1800.0,1800.0,0,SWEET GLOBE,Bag
ECO,0001-0010564,12/01/2023,Sale,-1440.0,360.0,2,SWEET GLOBE,Bag
ECO,0001-0010564,12/05/2023,Sale,-360.0,0.0,6,SWEET GLOBE,Bag
ECO,0001-0010565,11/29/2023,Entry,1800.0,1800.0,0,SWEET GLOBE,Bag
ECO,0001-0010565,12/01/2023,Sale,-900.0,900.0,2,SWEET GLOBE,Bag
ECO,0001-0010565,12/05/2023,Sale,-900.0,0.0,6,SWEET GLOBE,Bag
ECO,0001-0010583,11/24/2023,Entry,1800.0,1800.0,0,CRIMSON,Bag
ECO,0001-0010583,11/28/2023,Sale,-90.0,1710.0,4,CRIMSON,Bag
ECO,0001-0010583,11/30/2023,Sale,-1530.0,180.0,6,CRIMSON,Bag
ECO,0001-0010583,11/30/2023,Sale,-180.0,0.0,6,CRIMSON,Bag
ECO,0001-0010651,11/29/2023,Entry,1800.0,1800.0,0,SWEET GLOBE,Bag
ECO,0001-0010651,12/01/2023,Sale,-90.0,1710.0,2,SWEET GLOBE,Bag
ECO,0001-0010651,12/05/2023,Sale,-180.0,1530.0,6,SWEET GLOBE,Bag
ECO,0001-0010651,12/05/2023,Sale,-90.0,1440.0,6,SWEET GLOBE,Bag
ECO,0001-0010651,12/06/2023,Sale,-180.0,1260.0,7,SWEET GLOBE,Bag
ECO,0001-0010651,12/07/2023,Sale,-810.0,450.0,8,SWEET GLOBE,Bag
ECO,0001-0010651,12/08/2023,Sale,-450.0,0.0,9,SWEET GLOBE,Bag
ECO,0001-0010653,11/29/2023,Entry,1800.0,1800.0,0,SWEET GLOBE,Bag
ECO,0001-0010653,12/05/2023,Sale,-180.0,1620.0,6,SWEET GLOBE,Bag
ECO,0001-0010653,12/08/2023,Sale,-1620.0,0.0,9,SWEET GLOBE,Bag
ECO,0001-0010695,11/29/2023,Entry,1800.0,1800.0,0,SWEET FAVORS,Bag
ECO,0001-0010695,12/01/2023,Sale,-900.0,900.0,2,SWEET FAVORS,Bag
ECO,0001-0010695,12/01/2023,Sale,-450.0,450.0,2,SWEET FAVORS,Bag
ECO,0001-0010695,12/04/2023,Sale,-90.0,360.0,5,SWEET FAVORS,Bag
ECO,0001-0010695,12/04/2023,Sale,-180.0,180.0,5,SWEET FAVORS,Bag
ECO,0001-0010695,12/04/2023,Sale,-180.0,0.0,5,SWEET FAVORS,Bag
ECO,0001-0010698,11/29/2023,Entry,1600.0,1600.0,0,SWEET GLOBE,Clam
ECO,0001-0010698,11/30/2023,Sale,-1600.0,0.0,1,SWEET GLOBE,Clam
ECO,0001-0010704,11/29/2023,Entry,1800.0,1800.0,0,CRIMSON,Bag
ECO,0001-0010704,12/05/2023,Sale,-270.0,1530.0,6,CRIMSON,Bag
ECO,0001-0010704,12/05/2023,Sale,-720.0,810.0,6,CRIMSON,Bag
ECO,0001-0010704,12/05/2023,Sale,-270.0,540.0,6,CRIMSON,Bag
ECO,0001-0010704,12/05/2023,Sale,-180.0,360.0,6,CRIMSON,Bag
ECO,0001-0010704,12/06/2023,Sale,-180.0,180.0,7,CRIMSON,Bag
ECO,0001-0010704,12/12/2023,Sale,-180.0,0.0,13,CRIMSON,Bag
ECO,0001-0010713,12/04/2023,Entry,1800.0,1800.0,0,SWEET FAVORS,Bag
ECO,0001-0010713,12/04/2023,Sale,-720.0,1080.0,0,SWEET FAVORS,Bag
ECO,0001-0010713,12/05/2023,Sale,-180.0,900.0,1,SWEET FAVORS,Bag
ECO,0001-0010713,12/05/2023,Sale,-360.0,540.0,1,SWEET FAVORS,Bag
ECO,0001-0010713,12/07/2023,Sale,-360.0,180.0,3,SWEET FAVORS,Bag
ECO,0001-0010713,12/11/2023,Sale,-90.0,90.0,7,SWEET FAVORS,Bag
ECO,0001-0010713,01/09/2024,Sale,-90.0,0.0,36,SWEET FAVORS,Bag
ECO,0001-0010727,11/29/2023,Entry,1800.0,1800.0,0,CRIMSON,Bag
ECO,0001-0010727,12/07/2023,Sale,-810.0,990.0,8,CRIMSON,Bag
ECO,0001-0010727,12/12/2023,Sale,-990.0,0.0,13,CRIMSON,Bag
ECO,0001-0010734,12/08/2023,Entry,1800.0,1800.0,0,SWEETCELEBRATION,Bag
ECO,0001-0010734,12/09/2023,Sale,-450.0,1350.0,1,SWEETCELEBRATION,Bag
ECO,0001-0010734,12/14/2023,Sale,-180.0,1170.0,6,SWEETCELEBRATION,Bag
ECO,0001-0010734,12/14/2023,Sale,-25.0,1145.0,6,SWEETCELEBRATION,Bag
ECO,0001-0010734,12/14/2023,Sale,-30.0,1115.0,6,SWEETCELEBRATION,Bag
ECO,0001-0010734,12/14/2023,Sale,-101.0,1014.0,6,SWEETCELEBRATION,Bag
ECO,0001-0010734,12/14/2023,Sale,-40.0,974.0,6,SWEETCELEBRATION,Bag
ECO,0001-0010734,12/15/2023,Sale,-360.0,614.0,7,SWEETCELEBRATION,Bag
ECO,0001-0010734,12/15/2023,Sale,-98.0,516.0,7,SWEETCELEBRATION,Bag
ECO,0001-0010734,12/15/2023,Sale,-60.0,456.0,7,SWEETCELEBRATION,Bag
ECO,0001-0010734,12/15/2023,Sale,-45.0,411.0,7,SWEETCELEBRATION,Bag
ECO,0001-0010734,12/15/2023,Sale,-60.0,351.0,7,SWEETCELEBRATION,Bag
ECO,0001-0010734,12/15/2023,Sale,-4.0,347.0,7,SWEETCELEBRATION,Unknown
ECO,0001-0010734,12/19/2023,Sale,-45.0,302.0,11,SWEETCELEBRATION,Bag
ECO,0001-0010734,12/19/2023,Sale,-5.0,297.0,11,SWEETCELEBRATION,Bag
ECO,0001-0010734,12/19/2023,Sale,-54.0,243.0,11,SWEETCELEBRATION,Bag
ECO,0001-0010734,12/19/2023,Sale,-180.0,63.0,11,SWEETCELEBRATION,Bag
ECO,0001-0010734,12/19/2023,Sale,-22.0,41.0,11,SWEETCELEBRATION,Bag
ECO,0001-0010734,12/19/2023,Sale,-40.0,1.0,11,SWEETCELEBRATION,Bag
ECO,0001-0010758,11/29/2023,Entry,1800.0,1800.0,0,SWEET FAVORS,Bag
ECO,0001-0010758,12/13/2023,Sale,-450.0,1350.0,14,SWEET FAVORS,Bag
ECO,0001-0010758,12/15/2023,Sale,-180.0,1170.0,16,SWEET FAVORS,Bag
ECO,0001-0010758,12/19/2023,Sale,-180.0,990.0,20,SWEET FAVORS,Bag
ECO,0001-0010758,12/19/2023,Sale,-360.0,630.0,20,SWEET FAVORS,Bag
ECO,0001-0010758,12/20/2023,Sale,-270.0,360.0,21,SWEET FAVORS,Bag
ECO,0001-0010758,12/21/2023,Sale,-360.0,0.0,22,SWEET FAVORS,Bag
ECO,0001-0010768,12/08/2023,Entry,1800.0,1800.0,0,SWEET FAVORS,Bag
ECO,0001-0010768,12/09/2023,Sale,-45.0,1755.0,1,SWEET FAVORS,Bag
ECO,0001-0010768,12/15/2023,Sale,-45.0,1710.0,7,SWEET FAVORS,Bag
ECO,0001-0010768,12/21/2023,Sale,-90.0,1620.0,13,SWEET FAVORS,Bag
ECO,0001-0010768,12/21/2023,Sale,-180.0,1440.0,13,SWEET FAVORS,Bag
ECO,0001-0010768,12/26/2023,Sale,-90.0,1350.0,18,SWEET FAVORS,Bag
ECO,0001-0010768,12/26/2023,Sale,-180.0,1170.0,18,SWEET FAVORS,Bag
ECO,0001-0010768,12/27/2023,Sale,-180.0,990.0,19,SWEET FAVORS,Bag
ECO,0001-0010768,12/27/2023,Sale,-630.0,360.0,19,SWEET FAVORS,Bag
ECO,0001-0010768,12/27/2023,Sale,-360.0,0.0,19,SWEET FAVORS,Bag
ECO,0001-0010793,12/09/2023,Entry,1530.0,1530.0,0,SWEET GLOBE,Bag
ECO,0001-0010793,12/09/2023,Entry,270.0,1800.0,0,SWEETCELEBRATION,Bag
ECO,0001-0010793,12/09/2023,Sale,-540.0,1260.0,0,SWEET GLOBE,Bag
ECO,0001-0010793,12/12/2023,Sale,-270.0,990.0,3,SWEET GLOBE,Bag
ECO,0001-0010793,12/12/2023,Sale,-10.0,980.0,3,SWEET GLOBE,Bag
ECO,0001-0010793,12/12/2023,Sale,-1.0,979.0,3,SWEET GLOBE,Bag
ECO,0001-0010793,12/12/2023,Sale,-5.0,974.0,3,SWEET GLOBE,Bag
ECO,0001-0010793,12/12/2023,Sale,-6.0,968.0,3,SWEET GLOBE,Bag
ECO,0001-0010793,12/12/2023,Sale,-14.0,954.0,3,SWEET GLOBE,Bag
ECO,0001-0010793,12/12/2023,Sale,-45.0,909.0,3,SWEET GLOBE,Bag
ECO,0001-0010793,12/12/2023,Sale,-5.0,904.0,3,SWEET GLOBE,Bag
ECO,0001-0010793,12/12/2023,Sale,-5.0,899.0,3,SWEET GLOBE,Bag
ECO,0001-0010793,12/14/2023,Sale,-180.0,719.0,5,SWEET GLOBE,Bag
ECO,0001-0010793,12/14/2023,Sale,-90.0,629.0,5,SWEET GLOBE,Bag
ECO,0001-0010793,12/14/2023,Sale,-72.0,557.0,5,SWEETCELEBRATION,Bag
ECO,0001-0010793,12/14/2023,Sale,-4.0,553.0,5,SWEETCELEBRATION,Bag
ECO,0001-0010793,12/14/2023,Sale,-14.0,539.0,5,SWEETCELEBRATION,Bag
ECO,0001-0010793,12/15/2023,Sale,-270.0,269.0,6,SWEET GLOBE,Bag
ECO,0001-0010793,12/15/2023,Sale,-90.0,179.0,6,SWEETCELEBRATION,Bag
ECO,0001-0010793,12/19/2023,Sale,-15.0,164.0,10,SWEET GLOBE,Bag
ECO,0001-0010793,12/19/2023,Sale,-3.0,161.0,10,SWEET GLOBE,Bag
ECO,0001-0010793,12/19/2023,Sale,-3.0,158.0,10,SWEET GLOBE,Bag
ECO,0001-0010793,12/19/2023,Sale,-7.0,151.0,10,SWEET GLOBE,Bag
ECO,0001-0010793,12/19/2023,Sale,-20.0,131.0,10,SWEET GLOBE,Bag
ECO,0001-0010793,12/19/2023,Sale,-15.0,116.0,10,SWEET GLOBE,Bag
ECO,0001-0010793,12/19/2023,Sale,-13.0,103.0,10,SWEET GLOBE,Bag
ECO,0001-0010793,12/19/2023,Sale,-3.0,100.0,10,SWEET GLOBE,Bag
ECO,0001-0010793,12/19/2023,Sale,-15.0,85.0,10,SWEETCELEBRATION,Bag
ECO,0001-0010793,12/19/2023,Sale,-5.0,80.0,10,SWEETCELEBRATION,Bag
ECO,0001-0010793,12/19/2023,Sale,-70.0,10.0,10,SWEETCELEBRATION,Bag
ECO,0001-0010793,12/26/2023,Sale,-3.0,7.0,17,SWEET GLOBE,Bag
ECO,0001-0010793,12/26/2023,Sale,-1.0,6.0,17,SWEET GLOBE,Bag
ECO,0001-0010793,12/26/2023,Sale,-6.0,0.0,17,SWEET GLOBE,Bag
ECO,0001-0010802,12/11/2023,Sale,-900.0,-900.0,0,CRIMSON,Bag
ECO,0001-0010802,12/12/2023,Sale,-35.0,-935.0,1,CRIMSON,Bag
ECO,0001-0010802,12/12/2023,Sale,-40.0,-975.0,1,CRIMSON,Bag
ECO,0001-0010802,12/12/2023,Sale,-20.0,-995.0,1,CRIMSON,Bag
ECO,0001-0010802,12/12/2023,Sale,-72.0,-1067.0,1,CRIMSON,Bag
ECO,0001-0010802,12/12/2023,Sale,-105.0,-1172.0,1,CRIMSON,Bag
ECO,0001-0010802,12/12/2023,Sale,-6.0,-1178.0,1,CRIMSON,Bag
ECO,0001-0010802,12/12/2023,Sale,-35.0,-1213.0,1,CRIMSON,Bag
ECO,0001-0010802,12/12/2023,Sale,-150.0,-1363.0,1,CRIMSON,Bag
ECO,0001-0010802,12/12/2023,Sale,-60.0,-1423.0,1,CRIMSON,Bag
ECO,0001-0010802,12/12/2023,Sale,-90.0,-1513.0,1,CRIMSON,Bag
ECO,0001-0010802,12/12/2023,Sale,-50.0,-1563.0,1,CRIMSON,Bag
ECO,0001-0010802,12/12/2023,Sale,-6.0,-1569.0,1,CRIMSON,Unknown
ECO,0001-0010802,12/15/2023,Entry,1800.0,231.0,4,CRIMSON,Unknown
ECO,0001-0010802,12/15/2023,Sale,-49.0,182.0,4,CRIMSON,Bag
ECO,0001-0010802,12/19/2023,Sale,-180.0,2.0,8,CRIMSON,Bag
ECO,0001-0010850,11/29/2023,Entry,1800.0,1800.0,0,SWEET GLOBE,Bag
ECO,0001-0010850,12/06/2023,Sale,-1800.0,0.0,7,SWEET GLOBE,Bag
ECO,0001-0010851,11/29/2023,Entry,1800.0,1800.0,0,SWEET GLOBE,Bag
ECO,0001-0010851,12/06/2023,Sale,-180.0,1620.0,7,SWEET GLOBE,Bag
ECO,0001-0010851,12/06/2023,Sale,-1620.0,0.0,7,SWEET GLOBE,Bag
ECO,0001-0010947,11/29/2023,Entry,1700.0,1700.0,0,SWEET GLOBE,Clam
ECO,0001-0010947,12/11/2023,Sale,-1680.0,20.0,12,SWEET GLOBE,Clam
ECO,0001-0010947,12/28/2023,Sale,-20.0,0.0,29,SWEET GLOBE,Clam
ECO,0001-0010970,11/29/2023,Entry,1700.0,1700.0,0,SWEETCELEBRATION,Clam
ECO,0001-0010970,12/11/2023,Sale,-1680.0,20.0,12,SWEETCELEBRATION,Clam
ECO,0001-0010970,12/21/2023,Sale,-20.0,0.0,22,SWEETCELEBRATION,Clam
ECO,0001-0010973,12/06/2023,Sale,-90.0,-90.0,0,SWEET FAVORS,Bag
ECO,0001-0010973,12/06/2023,Sale,-90.0,-180.0,0,SWEET FAVORS,Bag
ECO,0001-0010973,12/06/2023,Sale,-180.0,-360.0,0,SWEET FAVORS,Bag
ECO,0001-0010973,12/06/2023,Sale,-180.0,-540.0,0,SWEET FAVORS,Bag
ECO,0001-0010973,12/07/2023,Sale,-180.0,-720.0,1,SWEET FAVORS,Bag
ECO,0001-0010973,12/07/2023,Sale,-360.0,-1080.0,1,SWEET FAVORS,Bag
ECO,0001-0010973,12/07/2023,Sale,-90.0,-1170.0,1,SWEET FAVORS,Bag
ECO,0001-0010973,12/07/2023,Sale,-450.0,-1620.0,1,SWEET FAVORS,Bag
ECO,0001-0010973,12/08/2023,Entry,1800.0,180.0,2,SWEET FAVORS,Bag
ECO,0001-0010973,12/08/2023,Sale,-180.0,0.0,2,SWEET FAVORS,Bag
ECO,0001-0010978,12/04/2023,Entry,1800.0,1800.0,0,SWEETCELEBRATION,Bag
ECO,0001-0010978,12/07/2023,Sale,-1800.0,0.0,3,SWEETCELEBRATION,Bag
ECO,0001-0010989,12/10/2023,Entry,1700.0,1700.0,0,SWEET GLOBE,Clam
ECO,0001-0010989,12/11/2023,Sale,-800.0,900.0,1,SWEET GLOBE,Clam
ECO,0001-0010989,12/13/2023,Sale,-720.0,180.0,3,SWEET GLOBE,Clam
ECO,0001-0010989,12/28/2023,Sale,-180.0,0.0,18,SWEET GLOBE,Clam
ECO,0001-0010998,12/10/2023,Entry,1700.0,1700.0,0,SWEET GLOBE,Clam
ECO,0001-0010998,12/11/2023,Sale,-800.0,900.0,1,SWEET GLOBE,Clam
ECO,0001-0010998,12/13/2023,Sale,-880.0,20.0,3,SWEET GLOBE,Clam
ECO,0001-0010998,12/28/2023,Sale,-20.0,0.0,18,SWEET GLOBE,Clam
ECO,0001-0011035,12/15/2023,Entry,1800.0,1800.0,0,SWEETCELEBRATION,Bag
ECO,0001-0011035,12/19/2023,Sale,-360.0,1440.0,4,SWEETCELEBRATION,Bag
ECO,0001-0011035,12/19/2023,Sale,-130.0,1310.0,4,SWEETCELEBRATION,Bag
ECO,0001-0011035,12/19/2023,Sale,-5.0,1305.0,4,SWEETCELEBRATION,Bag
ECO,0001-0011035,12/19/2023,Sale,-45.0,1260.0,4,SWEETCELEBRATION,Bag
ECO,0001-0011035,12/20/2023,Sale,-450.0,810.0,5,SWEETCELEBRATION,Bag
ECO,0001-0011035,12/21/2023,Sale,-15.0,795.0,6,SWEETCELEBRATION,Bag
ECO,0001-0011035,12/21/2023,Sale,-8.0,787.0,6,SWEETCELEBRATION,Bag
ECO,0001-0011035,12/21/2023,Sale,-40.0,747.0,6,SWEETCELEBRATION,Bag
ECO,0001-0011035,12/22/2023,Sale,-101.0,646.0,7,SWEETCELEBRATION,Bag
ECO,0001-0011035,12/22/2023,Sale,-60.0,586.0,7,SWEETCELEBRATION,Bag
ECO,0001-0011035,12/22/2023,Sale,-30.0,556.0,7,SWEETCELEBRATION,Bag
ECO,0001-0011035,12/22/2023,Sale,-35.0,521.0,7,SWEETCELEBRATION,Bag
ECO,0001-0011035,12/26/2023,Sale,-360.0,161.0,11,SWEETCELEBRATION,Bag
ECO,0001-0011035,12/27/2023,Sale,-90.0,71.0,12,SWEETCELEBRATION,Bag
ECO,0001-0011035,12/30/2023,Sale,-71.0,0.0,15,SWEETCELEBRATION,Bag
ECO,0001-0011045,12/08/2023,Entry,1800.0,1800.0,0,CRIMSON,Bag
ECO,0001-0011045,12/12/2023,Sale,-810.0,990.0,4,CRIMSON,Bag
ECO,0001-0011045,12/13/2023,Sale,-180.0,810.0,5,CRIMSON,Bag
ECO,0001-0011045,12/13/2023,Sale,-270.0,540.0,5,CRIMSON,Bag
ECO,0001-0011045,12/16/2023,Sale,-90.0,450.0,8,CRIMSON,Bag
ECO,0001-0011045,12/18/2023,Sale,-450.0,0.0,10,CRIMSON,Bag
ECO,0001-0011049,12/13/2023,Sale,-1800.0,-1800.0,0,CRIMSON,Bag
ECO,0001-0011049,12/15/2023,Entry,1800.0,0.0,2,CRIMSON,Bag
ECO,0001-0011056,12/15/2023,Entry,1800.0,1800.0,0,SWEET FAVORS,Bag
ECO,0001-0011056,12/27/2023,Sale,-45.0,1755.0,12,SWEET FAVORS,Bag
ECO,0001-0011056,12/28/2023,Sale,-90.0,1665.0,13,SWEET FAVORS,Bag
ECO,0001-0011056,12/28/2023,Sale,-180.0,1485.0,13,SWEET FAVORS,Bag
ECO,0001-0011056,12/29/2023,Sale,-1440.0,45.0,14,SWEET FAVORS,Bag
ECO,0001-0011056,01/02/2024,Sale,-45.0,0.0,18,SWEET FAVORS,Bag
ECO,0001-0011069,12/15/2023,Entry,1800.0,1800.0,0,SWEET FAVORS,Bag
ECO,0001-0011069,12/29/2023,Sale,-630.0,1170.0,14,SWEET FAVORS,Bag
ECO,0001-0011069,01/02/2024,Sale,-180.0,990.0,18,SWEET FAVORS,Bag
ECO,0001-0011069,01/02/2024,Sale,-990.0,0.0,18,SWEET FAVORS,Bag
ECO,0001-0011104,12/15/2023,Entry,720.0,720.0,0,CRIMSON,Bag
ECO,0001-0011104,12/15/2023,Entry,1080.0,1800.0,0,SWEETCELEBRATION,Bag
ECO,0001-0011104,12/21/2023,Sale,-270.0,1530.0,6,CRIMSON,Bag
ECO,0001-0011104,12/21/2023,Sale,-90.0,1440.0,6,CRIMSON,Bag
ECO,0001-0011104,12/21/2023,Sale,-180.0,1260.0,6,CRIMSON,Bag
ECO,0001-0011104,12/21/2023,Sale,-12.0,1248.0,6,SWEETCELEBRATION,Bag
ECO,0001-0011104,12/21/2023,Sale,-36.0,1212.0,6,SWEETCELEBRATION,Bag
ECO,0001-0011104,12/21/2023,Sale,-30.0,1182.0,6,SWEETCELEBRATION,Bag
ECO,0001-0011104,12/21/2023,Sale,-12.0,1170.0,6,SWEETCELEBRATION,Bag
ECO,0001-0011104,12/26/2023,Sale,-180.0,990.0,11,CRIMSON,Bag
ECO,0001-0011104,12/26/2023,Sale,-270.0,720.0,11,SWEETCELEBRATION,Bag
ECO,0001-0011104,12/26/2023,Sale,-540.0,180.0,11,SWEETCELEBRATION,Bag
ECO,0001-0011104,12/27/2023,Sale,-180.0,0.0,12,SWEETCELEBRATION,Bag
ECO,0001-0011110,12/15/2023,Entry,1800.0,1800.0,0,SWEET GLOBE,Bag
ECO,0001-0011110,12/15/2023,Sale,-180.0,1620.0,0,SWEET GLOBE,Bag
ECO,0001-0011110,12/20/2023,Sale,-990.0,630.0,5,SWEET GLOBE,Bag
ECO,0001-0011110,12/21/2023,Sale,-90.0,540.0,6,SWEET GLOBE,Bag
ECO,0001-0011110,12/21/2023,Sale,-90.0,450.0,6,SWEET GLOBE,Bag
ECO,0001-0011110,12/22/2023,Sale,-90.0,360.0,7,SWEET GLOBE,Bag
ECO,0001-0011110,12/26/2023,Sale,-90.0,270.0,11,SWEET GLOBE,Bag
ECO,0001-0011110,12/27/2023,Sale,-270.0,0.0,12,SWEET GLOBE,Bag
ECO,0001-0011130,12/08/2023,Entry,1800.0,1800.0,0,SWEET GLOBE,Bag
ECO,0001-0011130,12/20/2023,Sale,-540.0,1260.0,12,SWEET GLOBE,Bag
ECO,0001-0011130,12/20/2023,Sale,-900.0,360.0,12,SWEET GLOBE,Bag
ECO,0001-0011130,12/20/2023,Sale,-90.0,270.0,12,SWEET GLOBE,Bag
ECO,0001-0011130,12/21/2023,Sale,-90.0,180.0,13,SWEET GLOBE,Bag
ECO,0001-0011130,12/21/2023,Sale,-3.0,177.0,13,SWEET GLOBE,Bag
ECO,0001-0011130,12/21/2023,Sale,-3.0,174.0,13,SWEET GLOBE,Bag
ECO,0001-0011130,12/21/2023,Sale,-6.0,168.0,13,SWEET GLOBE,Bag
ECO,0001-0011130,12/22/2023,Sale,-30.0,138.0,14,SWEET GLOBE,Bag
ECO,0001-0011130,12/22/2023,Sale,-5.0,133.0,14,SWEET GLOBE,Bag
ECO,0001-0011130,12/22/2023,Sale,-5.0,128.0,14,SWEET GLOBE,Bag
ECO,0001-0011130,12/26/2023,Sale,-90.0,38.0,18,SWEET GLOBE,Bag
ECO,0001-0011130,12/26/2023,Sale,-15.0,23.0,18,SWEET GLOBE,Bag
ECO,0001-0011130,12/26/2023,Sale,-1.0,22.0,18,SWEET GLOBE,Bag
ECO,0001-0011130,12/26/2023,Sale,-5.0,17.0,18,SWEET GLOBE,Bag
ECO,0001-0011130,12/27/2023,Sale,-17.0,0.0,19,SWEET GLOBE,Bag
ECO,0001-0011155,12/08/2023,Entry,1800.0,1800.0,0,SWEET GLOBE,Bag
ECO,0001-0011155,12/12/2023,Sale,-1800.0,0.0,4,SWEET GLOBE,Bag
ECO,0001-0011175,12/08/2023,Entry,1800.0,1800.0,0,SWEET FAVORS,Bag
ECO,0001-0011175,12/13/2023,Sale,-180.0,1620.0,5,SWEET FAVORS,Bag
ECO,0001-0011175,12/13/2023,Sale,-360.0,1260.0,5,SWEET FAVORS,Bag
ECO,0001-0011175,12/14/2023,Sale,-90.0,1170.0,6,SWEET FAVORS,Bag
ECO,0001-0011175,12/15/2023,Sale,-180.0,990.0,7,SWEET FAVORS,Bag
ECO,0001-0011175,12/19/2023,Sale,-90.0,900.0,11,SWEET FAVORS,Bag
ECO,0001-0011175,12/19/2023,Sale,-180.0,720.0,11,SWEET FAVORS,Bag
ECO,0001-0011175,12/19/2023,Sale,-540.0,180.0,11,SWEET FAVORS,Bag
ECO,0001-0011175,12/22/2023,Sale,-180.0,0.0,14,SWEET FAVORS,Bag
ECO,0001-0011222,12/10/2023,Entry,1600.0,1600.0,0,SWEETCELEBRATION,Clam
ECO,0001-0011222,12/15/2023,Sale,-1600.0,0.0,5,SWEETCELEBRATION,Clam
ECO,0001-0011277,12/10/2023,Entry,1600.0,1600.0,0,SWEETCELEBRATION,Clam
ECO,0001-0011277,12/15/2023,Sale,-80.0,1520.0,5,SWEETCELEBRATION,Clam
ECO,0001-0011277,12/18/2023,Sale,-240.0,1280.0,8,SWEETCELEBRATION,Clam
ECO,0001-0011277,12/21/2023,Sale,-780.0,500.0,11,SWEETCELEBRATION,Clam
ECO,0001-0011277,12/28/2023,Sale,-480.0,20.0,18,SWEETCELEBRATION,Clam
ECO,0001-0011277,01/30/2024,Sale,-20.0,0.0,51,SWEETCELEBRATION,Clam
ECO,0001-0011312,12/12/2023,Entry,1800.0,1800.0,0,SWEET GLOBE,Bag
ECO,0001-0011312,12/20/2023,Sale,-1800.0,0.0,8,SWEET GLOBE,Bag
ECO,0001-0011330,12/12/2023,Entry,1800.0,1800.0,0,SWEET GLOBE,Bag
ECO,0001-0011330,12/20/2023,Sale,-180.0,1620.0,8,SWEET GLOBE,Bag
ECO,0001-0011330,12/20/2023,Sale,-1260.0,360.0,8,SWEET GLOBE,Bag
ECO,0001-0011330,12/21/2023,Sale,-90.0,270.0,9,SWEET GLOBE,Bag
ECO,0001-0011330,12/22/2023,Sale,-270.0,0.0,10,SWEET GLOBE,Bag
ECO,0001-0011345,12/15/2023,Entry,1800.0,1800.0,0,SWEET FAVORS,Bag
ECO,0001-0011345,12/20/2023,Sale,-180.0,1620.0,5,SWEET FAVORS,Bag
ECO,0001-0011345,12/22/2023,Sale,-90.0,1530.0,7,SWEET FAVORS,Bag
ECO,0001-0011345,12/22/2023,Sale,-270.0,1260.0,7,SWEET FAVORS,Bag
ECO,0001-0011345,12/26/2023,Sale,-90.0,1170.0,11,SWEET FAVORS,Bag
ECO,0001-0011345,12/27/2023,Sale,-90.0,1080.0,12,SWEET FAVORS,Bag
ECO,0001-0011345,12/27/2023,Sale,-90.0,990.0,12,SWEET FAVORS,Bag
ECO,0001-0011345,12/28/2023,Sale,-180.0,810.0,13,SWEET FAVORS,Bag
ECO,0001-0011345,12/30/2023,Sale,-180.0,630.0,15,SWEET FAVORS,Bag
ECO,0001-0011345,12/30/2023,Sale,-180.0,450.0,15,SWEET FAVORS,Bag
ECO,0001-0011345,12/30/2023,Sale,-90.0,360.0,15,SWEET FAVORS,Bag
ECO,0001-0011345,01/02/2024,Sale,-180.0,180.0,18,SWEET FAVORS,Bag
ECO,0001-0011345,01/04/2024,Sale,-90.0,90.0,20,SWEET FAVORS,Bag
ECO,0001-0011345,01/05/2024,Sale,-90.0,0.0,21,SWEET FAVORS,Bag
ECO,0001-0011354,12/15/2023,Entry,1800.0,1800.0,0,CRIMSON,Bag
ECO,0001-0011354,12/20/2023,Sale,-1350.0,450.0,5,CRIMSON,Bag
ECO,0001-0011354,12/22/2023,Sale,-360.0,90.0,7,CRIMSON,Bag
ECO,0001-0011354,12/26/2023,Sale,-90.0,0.0,11,CRIMSON,Bag
ECO,0001-0011411,12/15/2023,Entry,1600.0,1600.0,0,SWEET GLOBE,Clam
ECO,0001-0011411,12/28/2023,Sale,-1600.0,0.0,13,SWEET GLOBE,Clam
ECO,0001-0011419,12/15/2023,Entry,1800.0,1800.0,0,CRIMSON,Bag
ECO,0001-0011419,12/18/2023,Sale,-180.0,1620.0,3,CRIMSON,Bag
ECO,0001-0011419,12/19/2023,Sale,-450.0,1170.0,4,CRIMSON,Bag
ECO,0001-0011419,12/20/2023,Sale,-630.0,540.0,5,CRIMSON,Bag
ECO,0001-0011419,12/27/2023,Sale,-450.0,90.0,12,CRIMSON,Bag
ECO,0001-0011419,01/10/2024,Sale,-90.0,0.0,26,CRIMSON,Bag
ECO,0001-0011441,12/15/2023,Entry,1600.0,1600.0,0,SWEET GLOBE,Clam
ECO,0001-0011441,12/28/2023,Sale,-100.0,1500.0,13,SWEET GLOBE,Clam
ECO,0001-0011441,12/30/2023,Sale,-1500.0,0.0,15,SWEET GLOBE,Clam
ECO,0001-0011468,12/17/2023,Entry,1800.0,1800.0,0,SWEET FAVORS,Bag
ECO,0001-0011468,01/02/2024,Sale,-90.0,1710.0,16,SWEET FAVORS,Bag
ECO,0001-0011468,01/02/2024,Sale,-990.0,720.0,16,SWEET FAVORS,Bag
ECO,0001-0011468,01/06/2024,Sale,-270.0,450.0,20,SWEET FAVORS,Bag
ECO,0001-0011468,01/11/2024,Sale,-180.0,270.0,25,SWEET FAVORS,Bag
ECO,0001-0011468,01/15/2024,Sale,-270.0,0.0,29,SWEET FAVORS,Bag
ECO,0001-0011483,12/15/2023,Entry,1800.0,1800.0,0,SWEET GLOBE,Bag
ECO,0001-0011483,01/16/2024,Sale,-450.0,1350.0,32,SWEET GLOBE,Bag
ECO,0001-0011483,01/16/2024,Sale,-630.0,720.0,32,SWEET GLOBE,Bag
ECO,0001-0011483,01/19/2024,Sale,-720.0,0.0,35,SWEET GLOBE,Bag
ECO,0001-0011515,12/17/2023,Entry,1800.0,1800.0,0,CRIMSON,Bag
ECO,0001-0011515,12/21/2023,Sale,-360.0,1440.0,4,CRIMSON,Bag
ECO,0001-0011515,12/26/2023,Sale,-540.0,900.0,9,CRIMSON,Bag
ECO,0001-0011515,12/27/2023,Sale,-360.0,540.0,10,CRIMSON,Bag
ECO,0001-0011515,12/28/2023,Sale,-540.0,0.0,11,CRIMSON,Bag
ECO,0001-0011544,12/15/2023,Entry,1600.0,1600.0,0,SWEET GLOBE,Clam
ECO,0001-0011544,12/30/2023,Sale,-420.0,1180.0,15,SWEET GLOBE,Clam
ECO,0001-0011544,12/31/2023,Sale,-320.0,860.0,16,SWEET GLOBE,Clam
ECO,0001-0011544,01/04/2024,Sale,-80.0,780.0,20,SWEET GLOBE,Clam
ECO,0001-0011544,01/04/2024,Sale,-780.0,0.0,20,SWEET GLOBE,Clam
ECO,0001-0011545,12/15/2023,Entry,1600.0,1600.0,0,SWEET GLOBE,Clam
ECO,0001-0011545,01/04/2024,Sale,-340.0,1260.0,20,SWEET GLOBE,Clam
ECO,0001-0011545,01/04/2024,Sale,-1260.0,0.0,20,SWEET GLOBE,Clam
ECO,0001-0011551,12/15/2023,Entry,1600.0,1600.0,0,SWEETCELEBRATION,Clam
ECO,0001-0011551,12/27/2023,Sale,-400.0,1200.0,12,SWEETCELEBRATION,Clam
ECO,0001-0011551,12/28/2023,Sale,-1200.0,0.0,13,SWEETCELEBRATION,Clam
ECO,0001-0011557,12/17/2023,Entry,1600.0,1600.0,0,SWEET GLOBE,Clam
ECO,0001-0011557,12/31/2023,Sale,-1600.0,0.0,14,SWEET GLOBE,Clam
ECO,0001-0011606,12/15/2023,Entry,1600.0,1600.0,0,SWEET GLOBE,Clam
ECO,0001-0011606,01/04/2024,Sale,-940.0,660.0,20,SWEET GLOBE,Clam
ECO,0001-0011606,01/04/2024,Sale,-660.0,0.0,20,SWEET GLOBE,Clam
ELC,23E402041013,01/31/2024,Sale,-192.0,-192.0,0,PASSION FIRE,Bag
ELC,23E402041013,02/03/2024,Sale,-672.0,-864.0,3,IVORY,Bag
ELC,23E402041013,02/05/2024,Sale,-96.0,-960.0,5,PASSION FIRE,Bag
ELC,23E402041013,02/07/2024,Entry,960.0,0.0,7,IVORY,Bag
ELC,23E402041013,02/07/2024,Entry,864.0,864.0,7,IVORY,Bag
ELC,23E402041013,02/07/2024,Entry,288.0,1152.0,7,PASSION FIRE,Bag
ELC,23E402041013,02/09/2024,Sale,-192.0,960.0,9,IVORY,Bag
ELC,23E402041013,02/15/2024,Sale,-96.0,864.0,15,IVORY,Bag
ELC,23E402041013,02/15/2024,Sale,-96.0,768.0,15,IVORY,Bag
ELC,23E402041013,02/17/2024,Sale,-384.0,384.0,17,IVORY,Bag
ELC,23E402041013,02/17/2024,Sale,-384.0,0.0,17,IVORY,Bag
ELC,BMOU9248284,02/21/2024,Entry,648.0,648.0,0,ALLISON,Bag
ELC,BMOU9248284,02/21/2024,Entry,80.0,728.0,0,GREAT GREEN,Bag
ELC,BMOU9248284,02/21/2024,Entry,240.0,968.0,0,GREAT GREEN,Bag
ELC,BMOU9248284,02/21/2024,Entry,108.0,1076.0,0,IVORY,Bag
ELC,BMOU9248284,02/21/2024,Entry,160.0,1236.0,0,IVORY,Bag
ELC,BMOU9248284,02/21/2024,Entry,320.0,1556.0,0,TIMCO,Bag
ELC,BMOU9248284,02/21/2024,Entry,240.0,1796.0,0,TIMCO,Bag
ELC,BMOU9248284,02/22/2024,Sale,-324.0,1472.0,1,ALLISON,Bag
ELC,BMOU9248284,02/23/2024,Sale,-80.0,1392.0,2,GREAT GREEN,Clam
ELC,BMOU9248284,02/24/2024,Sale,-324.0,1068.0,3,ALLISON,Bag
ELC,BMOU9248284,02/26/2024,Sale,-108.0,960.0,5,IVORY,Bag
ELC,BMOU9248284,02/29/2024,Sale,-240.0,720.0,8,TIMCO,Clam
ELC,BMOU9248284,03/04/2024,Sale,-80.0,640.0,12,GREAT GREEN,Clam
ELC,BMOU9248284,03/05/2024,Sale,-240.0,400.0,13,TIMCO,Clam
ELC,BMOU9248284,03/06/2024,Sale,-160.0,240.0,14,GREAT GREEN,Clam
ELC,BMOU9248284,03/06/2024,Sale,-160.0,80.0,14,IVORY,Clam
ELC,BMOU9248284,03/11/2024,Sale,-79.0,1.0,19,TIMCO,Clam
ELC,BMOU9248290,02/26/2024,Sale,-216.0,-216.0,0,ALLISON,Bag
ELC,BMOU9248290,02/28/2024,Sale,-756.0,-972.0,2,ALLISON,Bag
ELC,BMOU9248290,02/29/2024,Entry,1944.0,972.0,3,ALLISON,Bag
ELC,BMOU9248290,02/29/2024,Entry,216.0,1188.0,3,IVORY,Bag
ELC,BMOU9248290,02/29/2024,Sale,-756.0,432.0,3,ALLISON,Bag
ELC,BMOU9248290,02/29/2024,Sale,-92.0,340.0,3,IVORY,Bag
ELC,BMOU9248290,02/29/2024,Sale,-108.0,232.0,3,IVORY,Bag
ELC,BMOU9248290,03/04/2024,Sale,-216.0,16.0,7,ALLISON,Bag
ELC,BMOU9293452,03/01/2024,Sale,-80.0,-80.0,0,TIMCO,Clam
ELC,BMOU9293452,03/02/2024,Entry,1188.0,1108.0,1,ALLISON,Clam
ELC,BMOU9293452,03/02/2024,Entry,216.0,1324.0,1,ALLISON,Clam
ELC,BMOU9293452,03/02/2024,Entry,324.0,1648.0,1,IVORY,Clam
ELC,BMOU9293452,03/02/2024,Entry,240.0,1888.0,1,TIMCO,Clam
ELC,BMOU9293452,03/02/2024,Entry,80.0,1968.0,1,TIMCO,Clam
ELC,BMOU9293452,03/04/2024,Sale,-108.0,1860.0,3,ALLISON,Bag
ELC,BMOU9293452,03/05/2024,Sale,-216.0,1644.0,4,ALLISON,Bag
ELC,BMOU9293452,03/06/2024,Sale,-80.0,1564.0,5,TIMCO,Clam
ELC,BMOU9293452,03/06/2024,Sale,-160.0,1404.0,5,TIMCO,Clam
ELC,BMOU9293452,03/07/2024,Sale,-1080.0,324.0,6,ALLISON,Bag
ELC,BMOU9293452,03/07/2024,Sale,-278.0,46.0,6,IVORY,Bag
ELC,BMOU9293600,03/01/2024,Sale,-160.0,-160.0,0,TIMCO,Clam
ELC,BMOU9293600,03/02/2024,Entry,640.0,480.0,1,ALLISON,Clam
ELC,BMOU9293600,03/02/2024,Entry,400.0,880.0,1,ALLISON,Clam
ELC,BMOU9293600,03/02/2024,Entry,80.0,960.0,1,GREAT GREEN,Clam
ELC,BMOU9293600,03/02/2024,Entry,80.0,1040.0,1,IVORY,Clam
ELC,BMOU9293600,03/02/2024,Entry,240.0,1280.0,1,TIMCO,Clam
ELC,BMOU9293600,03/02/2024,Entry,160.0,1440.0,1,TIMCO,Clam
ELC,BMOU9293600,03/06/2024,Sale,-560.0,880.0,5,ALLISON,Clam
ELC,BMOU9293600,03/06/2024,Sale,-80.0,800.0,5,GREAT GREEN,Clam
ELC,BMOU9293600,03/06/2024,Sale,-80.0,720.0,5,TIMCO,Clam
ELC,BMOU9293600,03/11/2024,Sale,-400.0,320.0,10,ALLISON,Clam
ELC,BMOU9293600,03/11/2024,Sale,-160.0,160.0,10,TIMCO,Clam
ELC,BMOU9293600,03/12/2024,Sale,-80.0,80.0,11,IVORY,Clam
ELC,BMOU9293600,03/13/2024,Sale,-80.0,0.0,12,ALLISON,Clam
ELC,BMOU9330941,03/05/2024,Entry,720.0,720.0,0,ALLISON,Clam
ELC,BMOU9330941,03/05/2024,Entry,880.0,1600.0,0,ALLISON,Clam
ELC,BMOU9330941,03/11/2024,Sale,-800.0,800.0,6,ALLISON,Clam
ELC,BMOU9330941,03/13/2024,Sale,-720.0,80.0,8,ALLISON,Clam
ELC,BMOU9330941,03/13/2024,Sale,-80.0,0.0,8,ALLISON,Clam
ELC,BMOU9331378,03/12/2024,Entry,540.0,540.0,0,ALLISON,Bag
ELC,BMOU9331378,03/12/2024,Entry,648.0,1188.0,0,ALLISON,Bag
ELC,BMOU9331378,03/12/2024,Entry,560.0,1748.0,0,ALLISON,Bag
ELC,BMOU9331378,03/12/2024,Entry,160.0,1908.0,0,ALLISON,Bag
ELC,BMOU9331378,03/14/2024,Sale,-216.0,1692.0,2,ALLISON,Bag
ELC,BMOU9331378,03/15/2024,Sale,-648.0,1044.0,3,ALLISON,Bag
ELC,BMOU9331378,03/15/2024,Sale,-324.0,720.0,3,ALLISON,Bag
ELC,BMOU9331378,03/23/2024,Sale,-240.0,480.0,11,ALLISON,Clam
ELC,BMOU9331378,03/25/2024,Sale,-240.0,240.0,13,ALLISON,Clam
ELC,BMOU9331378,03/27/2024,Sale,-160.0,80.0,15,ALLISON,Clam
ELC,BMOU9331378,03/27/2024,Sale,-80.0,0.0,15,ALLISON,Clam
ELC,BMOU9337695,03/04/2024,Entry,324.0,324.0,0,ALLISON,Bag
ELC,BMOU9337695,03/04/2024,Entry,1080.0,1404.0,0,ALLISON,Bag
ELC,BMOU9337695,03/04/2024,Entry,432.0,1836.0,0,GREAT GREEN,Bag
ELC,BMOU9337695,03/04/2024,Entry,324.0,2160.0,0,GREAT GREEN,Bag
ELC,BMOU9337695,03/05/2024,Sale,-324.0,1836.0,1,GREAT GREEN,Bag
ELC,BMOU9337695,03/07/2024,Sale,-1080.0,756.0,3,ALLISON,Bag
ELC,BMOU9337695,03/08/2024,Sale,-216.0,540.0,4,GREAT GREEN,Bag
ELC,BMOU9337695,03/09/2024,Sale,-324.0,216.0,5,ALLISON,Bag
ELC,BMOU9337695,03/09/2024,Sale,-71.0,145.0,5,GREAT GREEN,Bag
ELC,BMOU9338599,03/04/2024,Entry,1620.0,1620.0,0,GREAT GREEN,Bag
ELC,BMOU9338599,03/04/2024,Entry,540.0,2160.0,0,GREAT GREEN,Bag
ELC,BMOU9338599,03/05/2024,Sale,-1620.0,540.0,1,GREAT GREEN,Bag
ELC,BMOU9338599,03/08/2024,Sale,-216.0,324.0,4,GREAT GREEN,Bag
ELC,BMOU9338599,03/09/2024,Sale,-324.0,0.0,5,GREAT GREEN,Bag
ELC,BMOU9338855,02/29/2024,Entry,80.0,80.0,0,TIMCO,Clam
ELC,BMOU9338855,02/29/2024,Entry,640.0,720.0,0,TIMCO,Clam
ELC,BMOU9338855,02/29/2024,Entry,880.0,1600.0,0,TIMCO,Clam
ELC,BMOU9338855,02/29/2024,Sale,-80.0,1520.0,0,TIMCO,Clam
ELC,BMOU9338855,03/01/2024,Sale,-720.0,800.0,1,TIMCO,Clam
ELC,BMOU9338855,03/06/2024,Sale,-640.0,160.0,6,TIMCO,Clam
ELC,BMOU9338855,03/06/2024,Sale,-160.0,0.0,6,TIMCO,Clam
ELC,BMOU9345509,02/03/2024,Sale,-432.0,-432.0,0,PASSION FIRE,Bag
ELC,BMOU9345509,02/05/2024,Sale,-324.0,-756.0,2,IVORY,Bag
ELC,BMOU9345509,02/05/2024,Sale,-216.0,-972.0,2,PASSION FIRE,Bag
ELC,BMOU9345509,02/05/2024,Sale,-216.0,-1188.0,2,PASSION FIRE,Bag
ELC,BMOU9345509,02/07/2024,Entry,1296.0,108.0,4,IVORY,Bag
ELC,BMOU9345509,02/07/2024,Entry,864.0,972.0,4,PASSION FIRE,Bag
ELC,BMOU9345509,02/14/2024,Sale,-192.0,780.0,11,IVORY,Bag
ELC,BMOU9345509,02/15/2024,Sale,-432.0,348.0,12,IVORY,Bag
ELC,BMOU9345509,02/17/2024,Sale,-192.0,156.0,14,IVORY,Bag
ELC,BMOU9345509,02/17/2024,Sale,-64.0,92.0,14,IVORY,Bag
ELC,BMOU9352278,02/07/2024,Entry,1600.0,1600.0,0,IVORY,Clam
ELC,BMOU9352278,02/09/2024,Sale,-1600.0,0.0,2,IVORY,Clam
ELC,CXRU1582880,02/08/2024,Entry,2160.0,2160.0,0,IVORY,Bag
ELC,CXRU1582880,02/16/2024,Sale,-864.0,1296.0,8,IVORY,Bag
ELC,CXRU1582880,02/16/2024,Sale,-108.0,1188.0,8,IVORY,Bag
ELC,CXRU1582880,02/17/2024,Sale,-262.0,926.0,9,IVORY,Bag
ELC,CXRU1582880,02/20/2024,Sale,-216.0,710.0,12,IVORY,Bag
ELC,MSDU9850290,03/16/2024,Entry,432.0,432.0,0,ALLISON,Clam
ELC,MSDU9850290,03/16/2024,Entry,560.0,992.0,0,ALLISON,Clam
ELC,MSDU9850290,03/16/2024,Entry,320.0,1312.0,0,ALLISON,Clam
ELC,MSDU9850290,03/16/2024,Entry,400.0,1712.0,0,ALLISON,Clam
ELC,MSDU9850290,03/23/2024,Sale,-320.0,1392.0,7,ALLISON,Clam
ELC,MSDU9850290,03/23/2024,Sale,-480.0,912.0,7,ALLISON,Clam
ELC,MSDU9850290,03/25/2024,Sale,-216.0,696.0,9,ALLISON,Bag
ELC,MSDU9850290,03/25/2024,Sale,-108.0,588.0,9,ALLISON,Bag
ELC,MSDU9850290,03/26/2024,Sale,-108.0,480.0,10,ALLISON,Bag
ELC,MSDU9850290,03/27/2024,Sale,-80.0,400.0,11,ALLISON,Clam
ELC,MSDU9850290,03/27/2024,Sale,-80.0,320.0,11,ALLISON,Clam
ELC,MSDU9850290,03/27/2024,Sale,-315.0,5.0,11,ALLISON,Clam
ELC,MSDU9850290,04/10/2024,Sale,-5.0,0.0,25,ALLISON,Clam
ELC,OTPU6082080,02/13/2024,Entry,972.0,972.0,0,IVORY,Clam
ELC,OTPU6082080,02/13/2024,Entry,880.0,1852.0,0,IVORY,Clam
ELC,OTPU6082080,02/16/2024,Sale,-880.0,972.0,3,IVORY,Clam
ELC,OTPU6082080,02/17/2024,Sale,-328.0,644.0,4,IVORY,Bag
ELC,OTPU6082080,02/17/2024,Sale,-308.0,336.0,4,IVORY,Bag
ELC,OTPU6082080,02/17/2024,Sale,-108.0,228.0,4,IVORY,Bag
ELC,OTPU6082080,02/20/2024,Sale,-62.0,166.0,7,IVORY,Bag
ELC,OTPU6082080,02/20/2024,Sale,-108.0,58.0,7,IVORY,Bag
ELC,OTPU6085602,02/13/2024,Entry,1600.0,1600.0,0,IVORY,Clam
ELC,OTPU6085602,02/15/2024,Sale,-1600.0,0.0,2,IVORY,Clam
ELC,OTPU6320770,02/24/2024,Sale,-108.0,-108.0,0,ALLISON,Bag
ELC,OTPU6320770,02/26/2024,Sale,-108.0,-216.0,2,ALLISON,Bag
ELC,OTPU6320770,02/26/2024,Sale,-1080.0,-1296.0,2,ALLISON,Bag
ELC,OTPU6320770,02/26/2024,Sale,-108.0,-1404.0,2,IVORY,Bag
ELC,OTPU6320770,02/26/2024,Sale,-108.0,-1512.0,2,IVORY,Bag
ELC,OTPU6320770,02/29/2024,Entry,1404.0,-108.0,5,ALLISON,Bag
ELC,OTPU6320770,02/29/2024,Entry,756.0,648.0,5,IVORY,Bag
ELC,OTPU6320770,02/29/2024,Sale,-108.0,540.0,5,ALLISON,Bag
ELC,OTPU6320770,02/29/2024,Sale,-324.0,216.0,5,IVORY,Bag
ELC,OTPU6320770,02/29/2024,Sale,-24.0,192.0,5,IVORY,Bag
ELC,OTPU6320770,03/01/2024,Sale,-108.0,84.0,6,IVORY,Bag
ELC,OTPU6321591,02/13/2024,Entry,1944.0,1944.0,0,IVORY,Bag
ELC,OTPU6321591,02/13/2024,Entry,216.0,2160.0,0,PASSION FIRE,Bag
ELC,OTPU6321591,02/14/2024,Sale,-864.0,1296.0,1,IVORY,Bag
ELC,OTPU6321591,02/14/2024,Sale,-432.0,864.0,1,IVORY,Bag
ELC,OTPU6321591,02/15/2024,Sale,-648.0,216.0,2,IVORY,Bag
ELC,OTPU6321591,02/17/2024,Sale,-216.0,0.0,4,PASSION FIRE,Bag
ELC,OTPU6323260,02/26/2024,Sale,-324.0,-324.0,0,ALLISON,Bag
ELC,OTPU6323260,02/28/2024,Sale,-540.0,-864.0,2,ALLISON,Bag
ELC,OTPU6323260,02/29/2024,Entry,1404.0,540.0,3,ALLISON,Bag
ELC,OTPU6323260,02/29/2024,Entry,756.0,1296.0,3,IVORY,Bag
ELC,OTPU6323260,02/29/2024,Sale,-216.0,1080.0,3,ALLISON,Bag
ELC,OTPU6323260,02/29/2024,Sale,-216.0,864.0,3,ALLISON,Bag
ELC,OTPU6323260,02/29/2024,Sale,-432.0,432.0,3,IVORY,Bag
ELC,OTPU6323260,02/29/2024,Sale,-208.0,224.0,3,IVORY,Bag
ELC,OTPU6323260,03/01/2024,Sale,-32.0,192.0,4,IVORY,Bag
ELC,OTPU6323260,03/04/2024,Sale,-108.0,84.0,7,ALLISON,Bag
ELC,OTPU6374122,02/21/2024,Entry,560.0,560.0,0,GREAT GREEN,Clam
ELC,OTPU6374122,02/21/2024,Entry,1040.0,1600.0,0,GREAT GREEN,Clam
ELC,OTPU6374122,02/23/2024,Sale,-1040.0,560.0,2,GREAT GREEN,Clam
ELC,OTPU6374122,02/23/2024,Sale,-320.0,240.0,2,GREAT GREEN,Clam
ELC,OTPU6374122,03/04/2024,Sale,-240.0,0.0,12,GREAT GREEN,Clam
ELC,OTPU6374375,02/21/2024,Entry,640.0,640.0,0,GREAT GREEN,Clam
ELC,OTPU6374375,02/21/2024,Entry,960.0,1600.0,0,GREAT GREEN,Clam
ELC,OTPU6374375,02/23/2024,Sale,-560.0,1040.0,2,GREAT GREEN,Clam
ELC,OTPU6374375,02/23/2024,Sale,-640.0,400.0,2,GREAT GREEN,Clam
ELC,OTPU6374375,02/23/2024,Sale,-400.0,0.0,2,GREAT GREEN,Clam
ELC,OTPU6374842,02/22/2024,Entry,1600.0,1600.0,0,IVORY,Clam
ELC,OTPU6374842,03/06/2024,Sale,-92.0,1508.0,13,IVORY,Clam
ELC,OTPU6374842,03/07/2024,Sale,-1440.0,68.0,14,IVORY,Clam
ELC,OTPU6374842,03/19/2024,Sale,-44.0,24.0,26,IVORY,Clam
ELC,OTPU6374842,03/19/2024,Sale,-12.0,12.0,26,IVORY,Clam
ELC,OTPU6374930,02/23/2024,Entry,880.0,880.0,0,GREAT GREEN,Clam
ELC,OTPU6374930,02/23/2024,Entry,720.0,1600.0,0,GREAT GREEN,Clam
ELC,OTPU6374930,02/23/2024,Sale,-160.0,1440.0,0,GREAT GREEN,Clam
ELC,OTPU6374930,03/04/2024,Sale,-880.0,560.0,10,GREAT GREEN,Clam
ELC,OTPU6374930,03/06/2024,Sale,-240.0,320.0,12,GREAT GREEN,Clam
ELC,OTPU6374930,03/06/2024,Sale,-308.0,12.0,12,GREAT GREEN,Clam
ELC,OTPU6375005,02/29/2024,Entry,320.0,320.0,0,GREAT GREEN,Clam
ELC,OTPU6375005,02/29/2024,Entry,880.0,1200.0,0,GREAT GREEN,Clam
ELC,OTPU6375005,02/29/2024,Entry,400.0,1600.0,0,IVORY,Clam
ELC,OTPU6375005,03/04/2024,Sale,-320.0,1280.0,4,GREAT GREEN,Clam
ELC,OTPU6375005,03/06/2024,Sale,-880.0,400.0,6,GREAT GREEN,Clam
ELC,OTPU6375005,03/07/2024,Sale,-160.0,240.0,7,IVORY,Clam
ELC,OTPU6375005,03/12/2024,Sale,-240.0,0.0,12,IVORY,Clam
ELC,OTPU6375330,02/13/2024,Entry,2160.0,2160.0,0,IVORY,Bag
ELC,OTPU6375330,02/15/2024,Sale,-1512.0,648.0,2,IVORY,Bag
ELC,OTPU6375330,02/17/2024,Sale,-344.0,304.0,4,IVORY,Bag
ELC,OTPU6375330,02/17/2024,Sale,-216.0,88.0,4,IVORY,Bag
ELC,SEGU9181341,03/27/2024,Entry,160.0,160.0,0,ALLISON,Bag
ELC,SEGU9181341,03/27/2024,Entry,216.0,376.0,0,ALLISON,Bag
ELC,SEGU9181341,03/27/2024,Entry,480.0,856.0,0,ALLISON,Bag
ELC,SEGU9181341,03/27/2024,Entry,800.0,1656.0,0,ALLISON,Bag
ELC,SEGU9181341,03/28/2024,Sale,-160.0,1496.0,1,ALLISON,Bag
ELC,SEGU9181341,03/28/2024,Sale,-216.0,1280.0,1,ALLISON,Bag
ELC,SEGU9181341,04/02/2024,Sale,-800.0,480.0,6,ALLISON,Clam
ELC,SEGU9181341,04/02/2024,Sale,-480.0,0.0,6,ALLISON,Clam
ELC,SEGU9625852,02/23/2024,Entry,640.0,640.0,0,TIMCO,Clam
ELC,SEGU9625852,02/23/2024,Entry,960.0,1600.0,0,TIMCO,Clam
ELC,SEGU9625852,03/01/2024,Sale,-640.0,960.0,7,TIMCO,Clam
ELC,SEGU9625852,03/05/2024,Sale,-80.0,880.0,11,TIMCO,Clam
ELC,SEGU9625852,03/06/2024,Sale,-880.0,0.0,12,TIMCO,Clam
ELC,SEGU9696347,02/07/2024,Entry,2160.0,2160.0,0,IVORY,Bag
ELC,SEGU9696347,02/16/2024,Sale,-324.0,1836.0,9,IVORY,Bag
ELC,SEGU9696347,02/16/2024,Sale,-216.0,1620.0,9,IVORY,Bag
ELC,SEGU9696347,02/17/2024,Sale,-382.0,1238.0,10,IVORY,Bag
ELC,SEGU9696347,02/20/2024,Sale,-540.0,698.0,13,IVORY,Bag
ELC,SEGU9721120,02/07/2024,Entry,2160.0,2160.0,0,IVORY,Bag
ELC,SEGU9721120,02/16/2024,Sale,-324.0,1836.0,9,IVORY,Bag
ELC,SEGU9721120,02/17/2024,Sale,-147.0,1689.0,10,IVORY,Bag
ELC,SEGU9721120,02/17/2024,Sale,-434.0,1255.0,10,IVORY,Bag
ELC,SEGU9721120,02/20/2024,Sale,-108.0,1147.0,13,IVORY,Bag
ELC,SEGU9721120,02/20/2024,Sale,-540.0,607.0,13,IVORY,Bag
ELC,SEGU9740922,02/22/2024,Entry,80.0,80.0,0,GREAT GREEN,Clam
ELC,SEGU9740922,02/22/2024,Entry,560.0,640.0,0,GREAT GREEN,Clam
ELC,SEGU9740922,02/22/2024,Entry,480.0,1120.0,0,TIMCO,Clam
ELC,SEGU9740922,02/22/2024,Entry,480.0,1600.0,0,TIMCO,Clam
ELC,SEGU9740922,02/29/2024,Sale,-480.0,1120.0,7,TIMCO,Clam
ELC,SEGU9740922,03/04/2024,Sale,-80.0,1040.0,11,GREAT GREEN,Clam
ELC,SEGU9740922,03/05/2024,Sale,-480.0,560.0,12,TIMCO,Clam
ELC,SEGU9740922,03/06/2024,Sale,-560.0,0.0,13,GREAT GREEN,Clam
ELC,SEGU9776503,03/06/2024,Entry,400.0,400.0,0,ALLISON,Clam
ELC,SEGU9776503,03/06/2024,Entry,880.0,1280.0,0,ALLISON,Clam
ELC,SEGU9776503,03/06/2024,Entry,320.0,1600.0,0,ALLISON,Clam
ELC,SEGU9776503,03/23/2024,Sale,-400.0,1200.0,17,ALLISON,Clam
ELC,SEGU9776503,03/23/2024,Sale,-160.0,1040.0,17,ALLISON,Clam
ELC,SEGU9776503,03/25/2024,Sale,-480.0,560.0,19,ALLISON,Clam
ELC,SEGU9776503,03/27/2024,Sale,-240.0,320.0,21,ALLISON,Clam
ELC,SEGU9776503,03/27/2024,Sale,-320.0,0.0,21,ALLISON,Clam
ELC,SEKU9181500,02/07/2024,Entry,2160.0,2160.0,0,IVORY,Unknown
ELC,SEKU9181500,02/16/2024,Sale,-108.0,2052.0,9,IVORY,Unknown
ELC,SEKU9181500,02/16/2024,Sale,-324.0,1728.0,9,IVORY,Unknown
ELC,SEKU9181500,02/17/2024,Sale,-395.0,1333.0,10,IVORY,Unknown
ELC,SEKU9181500,02/20/2024,Sale,-648.0,685.0,13,IVORY,Unknown
ELC,SEKU9295544,02/22/2024,Entry,800.0,800.0,0,TIMCO,Unknown
ELC,SEKU9295544,02/22/2024,Entry,800.0,1600.0,0,TIMCO,Unknown
ELC,SEKU9295544,02/29/2024,Sale,-800.0,800.0,7,TIMCO,Unknown
ELC,SEKU9295544,03/05/2024,Sale,-800.0,0.0,12,TIMCO,Unknown
ELC,TTNU8498921,03/25/2024,Entry,324.0,324.0,0,ALLISON,Unknown
ELC,TTNU8498921,03/25/2024,Entry,108.0,432.0,0,ALLISON,Unknown
ELC,TTNU8498921,03/25/2024,Entry,1728.0,2160.0,0,ALLISON,Unknown
ELC,TTNU8498921,04/02/2024,Sale,-540.0,1620.0,8,ALLISON,Unknown
ELC,TTNU8498921,04/03/2024,Sale,-216.0,1404.0,9,ALLISON,Unknown
ELC,TTNU8498921,04/03/2024,Sale,-108.0,1296.0,9,ALLISON,Unknown
ELC,TTNU8498921,04/03/2024,Sale,-432.0,864.0,9,ALLISON,Unknown
ELC,TTNU8498921,04/05/2024,Sale,-756.0,108.0,11,ALLISON,Unknown
ELC,TTNU8498921,04/11/2024,Sale,-108.0,0.0,17,ALLISON,Unknown
MDT,MEDU9701534,04/20/2024,Entry,1600.0,1600.0,0,SWEETCELEBRATION,Clam
MDT,MEDU9701534,04/26/2024,Sale,-1600.0,0.0,6,SWEETCELEBRATION,Clam
MDT,MEDU9760537,04/20/2024,Entry,1600.0,1600.0,0,SWEETCELEBRATION,Clam
MDT,MEDU9760537,04/27/2024,Sale,-1600.0,0.0,7,SWEETCELEBRATION,Clam
MDT,MSDU9036869,05/05/2024,Entry,1600.0,1600.0,0,SWEET GLOBE,Clam
MDT,MSDU9036869,05/10/2024,Sale,-240.0,1360.0,5,SWEET GLOBE,Clam
MDT,MSDU9036869,05/10/2024,Sale,-160.0,1200.0,5,SWEET GLOBE,Clam
MDT,MSDU9036869,05/10/2024,Sale,-400.0,800.0,5,SWEET GLOBE,Clam
MDT,MSDU9036869,05/11/2024,Sale,-400.0,400.0,6,SWEET GLOBE,Clam
MDT,MSDU9036869,05/13/2024,Sale,-400.0,0.0,8,SWEET GLOBE,Clam
MDT,SEGU9281314,05/29/2024,Entry,1700.0,1700.0,0,CRIMSON,Bag
MDT,SEGU9281314,06/05/2024,Sale,-1190.0,510.0,7,CRIMSON,Bag
MDT,SEGU9281314,06/05/2024,Sale,-10.0,500.0,7,CRIMSON,Bag
MDT,SEGU9281314,06/18/2024,Sale,-500.0,0.0,20,CRIMSON,Bag
MDT,SZLU9085547,05/08/2024,Sale,-1600.0,-1600.0,0,SWEET GLOBE,Unknown
MDT,SZLU9085547,05/10/2024,Entry,1600.0,0.0,2,SWEET GLOBE,Unknown
MDT,TEMU9022372,04/28/2024,Entry,1600.0,1600.0,0,SWEETCELEBRATION,Unknown
MDT,TEMU9022372,05/07/2024,Sale,-1598.0,2.0,9,SWEETCELEBRATION,Unknown
MDT,TEMU9022372,06/07/2024,Sale,-2.0,0.0,40,SWEETCELEBRATION,Unknown
MDT,TEMU9178827,05/29/2024,Entry,1445.0,1445.0,0,CRIMSON,Unknown
MDT,TEMU9178827,05/29/2024,Entry,255.0,1700.0,0,CRIMSON,Unknown
MDT,TEMU9178827,06/05/2024,Sale,-680.0,1020.0,7,CRIMSON,Unknown
MDT,TEMU9178827,06/18/2024,Sale,-255.0,765.0,20,CRIMSON,Unknown
MDT,TEMU9178827,06/18/2024,Sale,-765.0,0.0,20,CRIMSON,Unknown
MDT,TRIU8018082,05/05/2024,Entry,1600.0,1600.0,0,SWEETCELEBRATION,Unknown
MDT,TRIU8018082,05/13/2024,Sale,-480.0,1120.0,8,SWEETCELEBRATION,Unknown
MDT,TRIU8018082,05/13/2024,Sale,-560.0,560.0,8,SWEETCELEBRATION,Unknown
MDT,TRIU8018082,05/13/2024,Sale,-320.0,240.0,8,SWEETCELEBRATION,Unknown
MDT,TRIU8018082,05/13/2024,Sale,-240.0,0.0,8,SWEETCELEBRATION,Unknown
Quintay,23Q166414132,04/21/2024,Entry,1920.0,1920.0,0,CRIMSON,Bag
Quintay,23Q166414132,04/21/2024,Entry,1200.0,3120.0,0,CRIMSON,Bag
Quintay,23Q166414132,04/21/2024,Entry,1500.0,4620.0,0,CRIMSON,Bag
Quintay,23Q166414132,04/21/2024,Entry,7678.0,12298.0,0,RED GLOBE,Bag
Quintay,23Q166414132,04/22/2024,Sale,-1727.0,10571.0,1,RED GLOBE,Bag
Quintay,23Q166414132,04/23/2024,Sale,-960.0,9611.0,2,CRIMSON,Bag
Quintay,23Q166414132,04/23/2024,Sale,-960.0,8651.0,2,CRIMSON,Bag
Quintay,23Q166414132,04/23/2024,Sale,-2688.0,5963.0,2,RED GLOBE,Bag
Quintay,23Q166414132,04/24/2024,Sale,-1500.0,4463.0,3,CRIMSON,Unknown
Quintay,23Q166414132,04/24/2024,Sale,-2303.0,2160.0,3,RED GLOBE,Bag
Quintay,23Q166414132,04/24/2024,Sale,-960.0,1200.0,3,RED GLOBE,Bag
Quintay,23Q166414132,05/02/2024,Sale,-1200.0,0.0,11,CRIMSON,Unknown
Quintay,23Q771413169,04/09/2024,Entry,1440.0,1440.0,0,RED GLOBE,Bag
Quintay,23Q771413169,04/09/2024,Entry,2805.0,4245.0,0,Unknown Variety,Bag
Quintay,23Q771413169,04/09/2024,Entry,5014.0,9259.0,0,Unknown Variety,Bag
Quintay,23Q771413169,04/09/2024,Entry,2465.0,11724.0,0,Unknown Variety,Bag
Quintay,23Q771413169,04/15/2024,Sale,-1440.0,10284.0,6,RED GLOBE,Bag
Quintay,23Q771413169,04/15/2024,Sale,-170.0,10114.0,6,Unknown Variety,Bag
Quintay,23Q771413169,04/15/2024,Sale,-1275.0,8839.0,6,Unknown Variety,Bag
Quintay,23Q771413169,04/17/2024,Sale,-340.0,8499.0,8,Unknown Variety,Bag
Quintay,23Q771413169,04/17/2024,Sale,-85.0,8414.0,8,Unknown Variety,Bag
Quintay,23Q771413169,04/18/2024,Sale,-170.0,8244.0,9,Unknown Variety,Bag
Quintay,23Q771413169,04/18/2024,Sale,-170.0,8074.0,9,Unknown Variety,Bag
Quintay,23Q771413169,04/18/2024,Sale,-255.0,7819.0,9,Unknown Variety,Bag
Quintay,23Q771413169,04/19/2024,Sale,-170.0,7649.0,10,Unknown Variety,Bag
Quintay,23Q771413169,04/20/2024,Sale,-510.0,7139.0,11,Unknown Variety,Bag
Quintay,23Q771413169,04/20/2024,Sale,-935.0,6204.0,11,Unknown Variety,Bag
Quintay,23Q771413169,04/20/2024,Sale,-510.0,5694.0,11,Unknown Variety,Bag
Quintay,23Q771413169,04/22/2024,Sale,-680.0,5014.0,13,Unknown Variety,Bag
Quintay,23Q771413169,04/23/2024,Sale,-170.0,4844.0,14,Unknown Variety,Bag
Quintay,23Q771413169,04/23/2024,Sale,-255.0,4589.0,14,Unknown Variety,Bag
Quintay,23Q771413169,04/23/2024,Sale,-680.0,3909.0,14,Unknown Variety,Bag
Quintay,23Q771413169,04/23/2024,Sale,-170.0,3739.0,14,Unknown Variety,Bag
Quintay,23Q771413169,04/24/2024,Sale,-340.0,3399.0,15,Unknown Variety,Bag
Quintay,23Q771413169,04/24/2024,Sale,-85.0,3314.0,15,Unknown Variety,Bag
Quintay,23Q771413169,04/25/2024,Sale,-85.0,3229.0,16,Unknown Variety,Bag
Quintay,23Q771413169,04/25/2024,Sale,-85.0,3144.0,16,Unknown Variety,Bag
Quintay,23Q771413169,04/26/2024,Sale,-85.0,3059.0,17,Unknown Variety,Bag
Quintay,23Q771413169,04/29/2024,Sale,-850.0,2209.0,20,Unknown Variety,Bag
Quintay,23Q771413169,04/29/2024,Sale,-85.0,2124.0,20,Unknown Variety,Bag
Quintay,23Q771413169,05/09/2024,Sale,-72.0,2052.0,30,Unknown Variety,Bag
Quintay,23Q771413169,05/09/2024,Sale,-85.0,1967.0,30,Unknown Variety,Bag
Quintay,23Q771413169,05/09/2024,Sale,-579.0,1388.0,30,Unknown Variety,Bag
Quintay,23Q771413169,05/10/2024,Sale,-255.0,1133.0,31,Unknown Variety,Bag
Quintay,23Q771413169,05/10/2024,Sale,-85.0,1048.0,31,Unknown Variety,Bag
Quintay,23Q771413169,05/11/2024,Sale,-425.0,623.0,32,Unknown Variety,Bag
Quintay,23Q771413169,05/13/2024,Sale,-85.0,538.0,34,Unknown Variety,Bag
Quintay,23Q771413169,05/13/2024,Sale,-85.0,453.0,34,Unknown Variety,Bag
Quintay,23Q838411136,03/31/2024,Entry,7140.0,7140.0,0,Unknown Variety,Bag
Quintay,23Q838411136,03/31/2024,Entry,3825.0,10965.0,0,Unknown Variety,Bag
Quintay,23Q838411136,03/31/2024,Entry,1275.0,12240.0,0,Unknown Variety,Bag
Quintay,23Q838411136,04/08/2024,Sale,-170.0,12070.0,8,Unknown Variety,Bag
Quintay,23Q838411136,04/08/2024,Sale,-425.0,11645.0,8,Unknown Variety,Bag
Quintay,23Q838411136,04/10/2024,Sale,-510.0,11135.0,10,Unknown Variety,Bag
Quintay,23Q838411136,04/10/2024,Sale,-340.0,10795.0,10,Unknown Variety,Bag
Quintay,23Q838411136,04/17/2024,Sale,-340.0,10455.0,17,Unknown Variety,Bag
Quintay,23Q838411136,04/19/2024,Sale,-85.0,10370.0,19,Unknown Variety,Bag
Quintay,23Q838411136,04/20/2024,Sale,-170.0,10200.0,20,Unknown Variety,Bag
Quintay,23Q838411136,04/29/2024,Sale,-1020.0,9180.0,29,Unknown Variety,Bag
Quintay,23Q838411136,04/30/2024,Sale,-170.0,9010.0,30,Unknown Variety,Bag
Quintay,23Q838411136,04/30/2024,Sale,-85.0,8925.0,30,Unknown Variety,Bag
Quintay,23Q838411136,05/04/2024,Sale,-765.0,8160.0,34,Unknown Variety,Bag
Quintay,23Q838411136,05/06/2024,Sale,-170.0,7990.0,36,Unknown Variety,Bag
Quintay,23Q838411136,05/07/2024,Sale,-850.0,7140.0,37,Unknown Variety,Bag
Quintay,23Q838411136,05/08/2024,Sale,-595.0,6545.0,38,Unknown Variety,Bag
Quintay,23Q838411136,05/08/2024,Sale,-255.0,6290.0,38,Unknown Variety,Bag
Quintay,23Q838411136,05/08/2024,Sale,-170.0,6120.0,38,Unknown Variety,Bag
Quintay,23Q838411136,05/08/2024,Sale,-1870.0,4250.0,38,Unknown Variety,Bag
Quintay,23Q838411136,05/08/2024,Sale,-1275.0,2975.0,38,Unknown Variety,Bag
Quintay,23Q838411136,05/08/2024,Sale,-425.0,2550.0,38,Unknown Variety,Bag
Quintay,23Q838411136,05/09/2024,Sale,-935.0,1615.0,39,Unknown Variety,Bag
Quintay,23Q838411136,05/09/2024,Sale,-340.0,1275.0,39,Unknown Variety,Bag
Quintay,23Q838411136,05/10/2024,Sale,-32.0,1243.0,40,Unknown Variety,Bag
Quintay,23Q838411136,05/11/2024,Sale,-85.0,1158.0,41,Unknown Variety,Bag
Quintay,23Q838411136,05/13/2024,Sale,-255.0,903.0,43,Unknown Variety,Bag
Quintay,23Q838411136,05/13/2024,Sale,-85.0,818.0,43,Unknown Variety,Bag
Quintay,23Q838411136,05/13/2024,Sale,-85.0,733.0,43,Unknown Variety,Bag
Quintay,23Q838411136,06/07/2024,Sale,-6.0,727.0,68,Unknown Variety,Bag
Quintay,23QPU6321591,03/27/2024,Entry,855.0,855.0,0,Unknown Variety,Clam
Quintay,23QPU6321591,03/27/2024,Entry,1045.0,1900.0,0,Unknown Variety,Clam
Quintay,23QPU6321591,05/14/2024,Sale,-240.0,1660.0,48,Unknown Variety,Clam
Quintay,23QPU6321591,05/14/2024,Sale,-310.0,1350.0,48,Unknown Variety,Clam
Quintay,23QPU6321591,05/15/2024,Sale,-400.0,950.0,49,Unknown Variety,Clam
Quintay,23QPU6321591,05/16/2024,Sale,-289.0,661.0,50,Unknown Variety,Clam
Quintay,23QPU6321591,05/16/2024,Sale,-200.0,461.0,50,Unknown Variety,Clam
Quintay,BMOU9296786,03/23/2024,Entry,1296.0,1296.0,0,Unknown Variety,Clam
Quintay,BMOU9296786,03/23/2024,Entry,864.0,2160.0,0,Unknown Variety,Clam
Quintay,BMOU9296786,04/02/2024,Sale,-1596.0,564.0,10,Unknown Variety,Clam
Quintay,BMOU9296786,04/05/2024,Sale,-320.0,244.0,13,Unknown Variety,Clam
Quintay,BMOU9306539,03/23/2024,Entry,972.0,972.0,0,Unknown Variety,Clam
Quintay,BMOU9306539,03/23/2024,Entry,1188.0,2160.0,0,Unknown Variety,Clam
Quintay,BMOU9306539,04/02/2024,Sale,-560.0,1600.0,10,Unknown Variety,Clam
Quintay,BMOU9306539,04/02/2024,Sale,-160.0,1440.0,10,Unknown Variety,Clam
Quintay,BMOU9306539,04/05/2024,Sale,-1120.0,320.0,13,Unknown Variety,Clam
Quintay,BMOU9307920,03/28/2024,Entry,1235.0,1235.0,0,Unknown Variety,Bag
Quintay,BMOU9307920,03/28/2024,Entry,665.0,1900.0,0,Unknown Variety,Bag
Quintay,BMOU9307920,05/01/2024,Sale,-190.0,1710.0,34,Unknown Variety,Bag
Quintay,BMOU9307920,05/03/2024,Sale,-15.0,1695.0,36,Unknown Variety,Bag
Quintay,BMOU9307920,05/06/2024,Sale,-95.0,1600.0,39,Unknown Variety,Bag
Quintay,BMOU9307920,05/06/2024,Sale,-935.0,665.0,39,Unknown Variety,Bag
Quintay,BMOU9307920,05/07/2024,Sale,-190.0,475.0,40,Unknown Variety,Bag
Quintay,BMOU9307920,05/08/2024,Sale,-85.0,390.0,41,Unknown Variety,Bag
Quintay,BMOU9307920,05/08/2024,Sale,-181.0,209.0,41,Unknown Variety,Bag
Quintay,BMOU9307920,05/08/2024,Sale,-85.0,124.0,41,Unknown Variety,Bag
Quintay,BMOU9308450,03/28/2024,Entry,760.0,760.0,0,Unknown Variety,Bag
Quintay,BMOU9308450,03/28/2024,Entry,760.0,1520.0,0,Unknown Variety,Bag
Quintay,BMOU9308450,03/28/2024,Entry,380.0,1900.0,0,Unknown Variety,Bag
Quintay,BMOU9308450,04/22/2024,Sale,-95.0,1805.0,25,Unknown Variety,Bag
Quintay,BMOU9308450,04/26/2024,Sale,-380.0,1425.0,29,Unknown Variety,Bag
Quintay,BMOU9308450,04/26/2024,Sale,-285.0,1140.0,29,Unknown Variety,Bag
Quintay,BMOU9308450,04/30/2024,Sale,-285.0,855.0,33,Unknown Variety,Bag
Quintay,BMOU9308450,04/30/2024,Sale,-95.0,760.0,33,Unknown Variety,Bag
Quintay,BMOU9308450,05/06/2024,Sale,-285.0,475.0,39,Unknown Variety,Bag
Quintay,BMOU9308450,05/08/2024,Sale,-285.0,190.0,41,Unknown Variety,Bag
Quintay,BMOU9308450,05/08/2024,Sale,-90.0,100.0,41,Unknown Variety,Bag
Quintay,BMOU9308450,05/16/2024,Sale,-10.0,90.0,49,Unknown Variety,Clam
Quintay,BMOU9337083,03/28/2024,Entry,1045.0,1045.0,0,Unknown Variety,Bag
Quintay,BMOU9337083,03/28/2024,Entry,855.0,1900.0,0,Unknown Variety,Bag
Quintay,BMOU9337083,04/25/2024,Sale,-570.0,1330.0,28,Unknown Variety,Bag
Quintay,BMOU9337083,04/26/2024,Sale,-285.0,1045.0,29,Unknown Variety,Bag
Quintay,BMOU9337083,04/30/2024,Sale,-190.0,855.0,33,Unknown Variety,Bag
Quintay,BMOU9337083,05/06/2024,Sale,-760.0,95.0,39,Unknown Variety,Bag
Quintay,BMOU9338813,03/28/2024,Entry,95.0,95.0,0,Unknown Variety,Clam
Quintay,BMOU9338813,03/28/2024,Entry,380.0,475.0,0,Unknown Variety,Clam
Quintay,BMOU9338813,03/28/2024,Entry,380.0,855.0,0,Unknown Variety,Clam
Quintay,BMOU9338813,03/28/2024,Entry,880.0,1735.0,0,Unknown Variety,Clam
Quintay,BMOU9338813,04/04/2024,Sale,-880.0,855.0,7,Unknown Variety,Clam
Quintay,BMOU9338813,04/08/2024,Sale,-377.0,478.0,11,Unknown Variety,Bag
Quintay,BMOU9338813,04/08/2024,Sale,-3.0,475.0,11,Unknown Variety,Bag
Quintay,BMOU9338813,04/15/2024,Sale,-95.0,380.0,18,Unknown Variety,Bag
Quintay,BMOU9338813,04/17/2024,Sale,-190.0,190.0,20,Unknown Variety,Bag
Quintay,BMOU9338813,04/18/2024,Sale,-95.0,95.0,21,Unknown Variety,Bag
Quintay,BMOU9338813,04/22/2024,Sale,-95.0,0.0,25,Unknown Variety,Bag
Quintay,BMOU9349187,03/23/2024,Entry,1080.0,1080.0,0,Unknown Variety,Bag
Quintay,BMOU9349187,03/23/2024,Entry,1080.0,2160.0,0,Unknown Variety,Bag
Quintay,BMOU9349187,04/26/2024,Sale,-432.0,1728.0,34,Unknown Variety,Bag
Quintay,BMOU9349187,04/27/2024,Sale,-540.0,1188.0,35,Unknown Variety,Bag
Quintay,BMOU9349187,05/09/2024,Sale,-16.0,1172.0,47,Unknown Variety,Bag
Quintay,BMOU9349187,05/10/2024,Sale,-41.0,1131.0,48,Unknown Variety,Bag
Quintay,BMOU9349187,05/11/2024,Sale,-30.0,1101.0,49,Unknown Variety,Bag
Quintay,BMOU9349187,05/13/2024,Sale,-232.0,869.0,51,Unknown Variety,Bag
Quintay,BMOU9349187,05/14/2024,Sale,-34.0,835.0,52,Unknown Variety,Bag
Quintay,BMOU9349187,05/14/2024,Sale,-108.0,727.0,52,Unknown Variety,Bag
Quintay,BMOU9349187,05/16/2024,Sale,-31.0,696.0,54,Unknown Variety,Clam
Quintay,BMOU9349187,05/16/2024,Sale,-110.0,586.0,54,Unknown Variety,Clam
Quintay,BMOU9349187,05/16/2024,Sale,-160.0,426.0,54,Unknown Variety,Clam
Quintay,BMOU9349187,05/17/2024,Sale,-39.0,387.0,55,Unknown Variety,Bag
Quintay,BMOU9350300,03/29/2024,Entry,1425.0,1425.0,0,Unknown Variety,Bag
Quintay,BMOU9350300,03/29/2024,Entry,475.0,1900.0,0,Unknown Variety,Bag
Quintay,BMOU9350300,04/05/2024,Sale,-95.0,1805.0,7,Unknown Variety,Bag
Quintay,BMOU9350300,04/09/2024,Sale,-95.0,1710.0,11,Unknown Variety,Bag
Quintay,BMOU9350300,04/12/2024,Sale,-190.0,1520.0,14,Unknown Variety,Bag
Quintay,BMOU9350300,04/13/2024,Sale,-95.0,1425.0,15,Unknown Variety,Bag
Quintay,BMOU9350300,05/01/2024,Sale,-190.0,1235.0,33,Unknown Variety,Bag
Quintay,BMOU9350300,05/05/2024,Sale,-1235.0,0.0,37,Unknown Variety,Bag
Quintay,BMOU9350980,03/23/2024,Entry,432.0,432.0,0,Unknown Variety,Clam
Quintay,BMOU9350980,03/23/2024,Entry,1080.0,1512.0,0,Unknown Variety,Clam
Quintay,BMOU9350980,03/23/2024,Entry,648.0,2160.0,0,Unknown Variety,Clam
Quintay,BMOU9350980,03/28/2024,Sale,-1600.0,560.0,5,Unknown Variety,Clam
Quintay,BMOU9350980,03/29/2024,Sale,-320.0,240.0,6,Unknown Variety,Clam
Quintay,BMOU9350980,04/02/2024,Sale,-4.0,236.0,10,Unknown Variety,Clam
Quintay,BMOU9352030,03/23/2024,Entry,1477.0,1477.0,0,Unknown Variety,Bag
Quintay,BMOU9352030,03/23/2024,Entry,216.0,1693.0,0,Unknown Variety,Bag
Quintay,BMOU9352030,03/23/2024,Entry,311.0,2004.0,0,Unknown Variety,Bag
Quintay,BMOU9352030,03/27/2024,Sale,-216.0,1788.0,4,Unknown Variety,Bag
Quintay,BMOU9352030,04/04/2024,Sale,-108.0,1680.0,12,Unknown Variety,Bag
Quintay,BMOU9352030,04/05/2024,Sale,-95.0,1585.0,13,Unknown Variety,Bag
Quintay,BMOU9352030,04/08/2024,Sale,-190.0,1395.0,16,Unknown Variety,Bag
Quintay,BMOU9352030,04/08/2024,Sale,-95.0,1300.0,16,Unknown Variety,Bag
Quintay,BMOU9352030,04/08/2024,Sale,-285.0,1015.0,16,Unknown Variety,Bag
Quintay,BMOU9352030,04/10/2024,Sale,-108.0,907.0,18,Unknown Variety,Bag
Quintay,BMOU9352030,04/10/2024,Sale,-95.0,812.0,18,Unknown Variety,Bag
Quintay,BMOU9352030,04/10/2024,Sale,-216.0,596.0,18,Unknown Variety,Bag
Quintay,BMOU9352030,04/12/2024,Sale,-95.0,501.0,20,Unknown Variety,Bag
Quintay,BMOU9352030,04/12/2024,Sale,-190.0,311.0,20,Unknown Variety,Bag
Quintay,BMOU9352030,04/17/2024,Sale,-95.0,216.0,25,Unknown Variety,Bag
Quintay,BMOU9352030,04/26/2024,Sale,-108.0,108.0,34,Unknown Variety,Bag
Quintay,BMOU9352030,05/09/2024,Sale,-13.0,95.0,47,Unknown Variety,Bag
Quintay,BMOU9352030,05/10/2024,Sale,-55.0,40.0,48,Unknown Variety,Bag
Quintay,BMOU9655166,03/28/2024,Entry,570.0,570.0,0,Unknown Variety,Bag
Quintay,BMOU9655166,03/28/2024,Entry,380.0,950.0,0,Unknown Variety,Bag
Quintay,BMOU9655166,03/28/2024,Entry,950.0,1900.0,0,Unknown Variety,Bag
Quintay,BMOU9655166,04/26/2024,Sale,-475.0,1425.0,29,Unknown Variety,Bag
Quintay,BMOU9655166,04/30/2024,Sale,-95.0,1330.0,33,Unknown Variety,Bag
Quintay,BMOU9655166,05/04/2024,Sale,-380.0,950.0,37,Unknown Variety,Bag
Quintay,BMOU9655166,05/08/2024,Sale,-584.0,366.0,41,Unknown Variety,Bag
Quintay,BMOU9655166,05/08/2024,Sale,-85.0,281.0,41,Unknown Variety,Bag
Quintay,BMOU9655166,05/10/2024,Sale,-153.0,128.0,43,Unknown Variety,Bag
Quintay,BMOU9656711,03/28/2024,Entry,380.0,380.0,0,Unknown Variety,Bag
Quintay,BMOU9656711,03/28/2024,Entry,950.0,1330.0,0,Unknown Variety,Bag
Quintay,BMOU9656711,03/28/2024,Entry,570.0,1900.0,0,Unknown Variety,Bag
Quintay,BMOU9656711,04/25/2024,Sale,-95.0,1805.0,28,Unknown Variety,Bag
Quintay,BMOU9656711,04/25/2024,Sale,-285.0,1520.0,28,Unknown Variety,Bag
Quintay,BMOU9656711,04/25/2024,Sale,-475.0,1045.0,28,Unknown Variety,Bag
Quintay,BMOU9656711,04/26/2024,Sale,-665.0,380.0,29,Unknown Variety,Bag
Quintay,BMOU9656711,04/26/2024,Sale,-95.0,285.0,29,Unknown Variety,Bag
Quintay,BMOU9656711,04/30/2024,Sale,-190.0,95.0,33,Unknown Variety,Bag
Quintay,BMOU9656711,04/30/2024,Sale,-95.0,0.0,33,Unknown Variety,Bag
Quintay,CXRU1412836,03/09/2024,Entry,665.0,665.0,0,SWEETIES,Bag
Quintay,CXRU1412836,03/09/2024,Entry,190.0,855.0,0,SWEETIES,Bag
Quintay,CXRU1412836,03/09/2024,Entry,1045.0,1900.0,0,SWEETIES,Bag
Quintay,CXRU1412836,03/14/2024,Sale,-190.0,1710.0,5,SWEETIES,Bag
Quintay,CXRU1412836,03/14/2024,Sale,-380.0,1330.0,5,SWEETIES,Bag
Quintay,CXRU1412836,03/14/2024,Sale,-950.0,380.0,5,SWEETIES,Bag
Quintay,CXRU1412836,03/14/2024,Sale,-95.0,285.0,5,SWEETIES,Bag
Quintay,CXRU1412836,03/14/2024,Sale,-95.0,190.0,5,SWEETIES,Bag
Quintay,CXRU1412836,03/14/2024,Sale,-190.0,0.0,5,SWEETIES,Bag
Quintay,CXRU1580906,03/23/2024,Entry,756.0,756.0,0,Unknown Variety,Bag
Quintay,CXRU1580906,03/23/2024,Entry,432.0,1188.0,0,Unknown Variety,Bag
Quintay,CXRU1580906,03/23/2024,Entry,972.0,2160.0,0,Unknown Variety,Bag
Quintay,CXRU1580906,04/20/2024,Sale,-648.0,1512.0,28,Unknown Variety,Bag
Quintay,CXRU1580906,04/26/2024,Sale,-324.0,1188.0,34,Unknown Variety,Bag
Quintay,CXRU1580906,05/10/2024,Sale,-76.0,1112.0,48,Unknown Variety,Bag
Quintay,CXRU1580906,05/10/2024,Sale,-432.0,680.0,48,Unknown Variety,Bag
Quintay,CXRU1580906,05/13/2024,Sale,-108.0,572.0,51,Unknown Variety,Bag
Quintay,CXRU1580906,05/13/2024,Sale,-108.0,464.0,51,Unknown Variety,Bag
Quintay,CXRU1580906,05/14/2024,Sale,-74.0,390.0,52,Unknown Variety,Bag
Quintay,CXRU1580906,05/17/2024,Sale,-177.0,213.0,55,Unknown Variety,Bag
Quintay,CXRU1580906,05/17/2024,Sale,-80.0,133.0,55,Unknown Variety,Clam
Quintay,CXRU1581395,03/23/2024,Entry,95.0,95.0,0,Unknown Variety,Clam
Quintay,CXRU1581395,03/23/2024,Entry,1520.0,1615.0,0,Unknown Variety,Clam
Quintay,CXRU1581395,04/01/2024,Sale,-1520.0,95.0,9,Unknown Variety,Clam
Quintay,CXRU1581395,04/05/2024,Sale,-95.0,0.0,13,Unknown Variety,Bag
Quintay,CXRU1618241,03/27/2024,Entry,216.0,216.0,0,Unknown Variety,Bag
Quintay,CXRU1618241,03/27/2024,Entry,1944.0,2160.0,0,Unknown Variety,Bag
Quintay,CXRU1618241,04/11/2024,Sale,-108.0,2052.0,15,Unknown Variety,Bag
Quintay,CXRU1618241,04/13/2024,Sale,-1080.0,972.0,17,Unknown Variety,Bag
Quintay,CXRU1618241,04/13/2024,Sale,-108.0,864.0,17,Unknown Variety,Bag
Quintay,CXRU1618241,05/13/2024,Sale,-864.0,0.0,47,Unknown Variety,Bag
Quintay,FBIU5126200,05/01/2024,Entry,1600.0,1600.0,0,Unknown Variety,Clam
Quintay,FBIU5126200,05/11/2024,Sale,-880.0,720.0,10,Unknown Variety,Clam
Quintay,FBIU5126200,05/16/2024,Sale,-720.0,0.0,15,Unknown Variety,Clam
Quintay,MEDU9703964,04/27/2024,Entry,1600.0,1600.0,0,Unknown Variety,Clam
Quintay,MEDU9703964,05/08/2024,Sale,-240.0,1360.0,11,Unknown Variety,Clam
Quintay,MEDU9703964,05/08/2024,Sale,-480.0,880.0,11,Unknown Variety,Clam
Quintay,MEDU9703964,05/09/2024,Sale,-480.0,400.0,12,Unknown Variety,Clam
Quintay,MEDU9703964,05/10/2024,Sale,-400.0,0.0,13,Unknown Variety,Clam
Quintay,MEDU9712040,05/12/2024,Entry,1200.0,1200.0,0,CRIMSON,Clam
Quintay,MEDU9712040,05/12/2024,Entry,400.0,1600.0,0,CRIMSON,Clam
Quintay,MEDU9712040,05/22/2024,Sale,-480.0,1120.0,10,CRIMSON,Clam
Quintay,MEDU9712040,05/23/2024,Sale,-480.0,640.0,11,CRIMSON,Clam
Quintay,MEDU9712040,05/23/2024,Sale,-560.0,80.0,11,CRIMSON,Clam
Quintay,MEDU9725069,03/16/2024,Entry,845.0,845.0,0,SWEETIES,Bag
Quintay,MEDU9725069,03/16/2024,Entry,900.0,1745.0,0,SWEETIES,Bag
Quintay,MEDU9725069,03/16/2024,Entry,95.0,1840.0,0,SWEETIES,Bag
Quintay,MEDU9725069,03/20/2024,Sale,-190.0,1650.0,4,SWEETIES,Bag
Quintay,MEDU9725069,03/21/2024,Sale,-380.0,1270.0,5,SWEETIES,Bag
Quintay,MEDU9725069,03/21/2024,Sale,-900.0,370.0,5,SWEETIES,Bag
Quintay,MEDU9725069,04/09/2024,Sale,-180.0,190.0,24,SWEETIES,Bag
Quintay,MEDU9725069,04/10/2024,Sale,-95.0,95.0,25,SWEETIES,Bag
Quintay,MEDU9725069,04/11/2024,Sale,-95.0,0.0,26,SWEETIES,Bag
Quintay,MSCU7382534,05/12/2024,Entry,320.0,320.0,0,CRIMSON,Clam
Quintay,MSCU7382534,05/12/2024,Entry,1280.0,1600.0,0,CRIMSON,Clam
Quintay,MSCU7382534,05/22/2024,Sale,-880.0,720.0,10,CRIMSON,Clam
Quintay,MSCU7382534,05/23/2024,Sale,-545.0,175.0,11,CRIMSON,Clam
Quintay,MSCU7382534,05/23/2024,Sale,-25.0,150.0,11,CRIMSON,Clam
Quintay,MSDU9019218,05/12/2024,Entry,160.0,160.0,0,CRIMSON,Clam
Quintay,MSDU9019218,05/12/2024,Entry,1440.0,1600.0,0,CRIMSON,Clam
Quintay,MSDU9019218,05/23/2024,Sale,-110.0,1490.0,11,CRIMSON,Clam
Quintay,MSDU9019218,05/23/2024,Sale,-1088.0,402.0,11,CRIMSON,Clam
Quintay,OTPU6082455,03/23/2024,Entry,216.0,216.0,0,Unknown Variety,Clam
Quintay,OTPU6082455,03/23/2024,Entry,1944.0,2160.0,0,Unknown Variety,Clam
Quintay,OTPU6082455,04/02/2024,Sale,-240.0,1920.0,10,Unknown Variety,Clam
Quintay,OTPU6082455,04/02/2024,Sale,-640.0,1280.0,10,Unknown Variety,Clam
Quintay,OTPU6082455,04/05/2024,Sale,-14.0,1266.0,13,GREEN SEEDLESS,Clam
Quintay,OTPU6082455,04/05/2024,Sale,-80.0,1186.0,13,Unknown Variety,Clam
Quintay,OTPU6082455,04/20/2024,Sale,-864.0,322.0,28,Unknown Variety,Bag
Quintay,OTPU6082455,05/10/2024,Sale,-17.0,305.0,48,Unknown Variety,Bag
Quintay,OTPU6082455,05/10/2024,Sale,-216.0,89.0,48,Unknown Variety,Bag
Quintay,OTPU6375387,03/23/2024,Entry,855.0,855.0,0,Unknown Variety,Bag
Quintay,OTPU6375387,03/23/2024,Entry,1045.0,1900.0,0,Unknown Variety,Bag
Quintay,OTPU6375387,04/02/2024,Sale,-190.0,1710.0,10,Unknown Variety,Bag
Quintay,OTPU6375387,04/03/2024,Sale,-95.0,1615.0,11,Unknown Variety,Bag
Quintay,OTPU6375387,04/03/2024,Sale,-190.0,1425.0,11,Unknown Variety,Bag
Quintay,OTPU6375387,04/04/2024,Sale,-95.0,1330.0,12,Unknown Variety,Bag
Quintay,OTPU6375387,04/05/2024,Sale,-95.0,1235.0,13,Unknown Variety,Bag
Quintay,OTPU6375387,04/06/2024,Sale,-190.0,1045.0,14,Unknown Variety,Bag
Quintay,OTPU6375387,04/08/2024,Sale,-95.0,950.0,16,Unknown Variety,Bag
Quintay,OTPU6375387,04/08/2024,Sale,-95.0,855.0,16,Unknown Variety,Bag
Quintay,OTPU6375387,04/09/2024,Sale,-475.0,380.0,17,Unknown Variety,Bag
Quintay,OTPU6375387,04/12/2024,Sale,-95.0,285.0,20,Unknown Variety,Bag
Quintay,OTPU6375387,04/12/2024,Sale,-95.0,190.0,20,Unknown Variety,Bag
Quintay,OTPU6375387,04/13/2024,Sale,-190.0,0.0,21,Unknown Variety,Bag
Quintay,SEGU9077960,04/08/2024,Entry,950.0,950.0,0,Unknown Variety,Bag
Quintay,SEGU9077960,04/08/2024,Entry,85.0,1035.0,0,Unknown Variety,Bag
Quintay,SEGU9077960,04/08/2024,Entry,855.0,1890.0,0,Unknown Variety,Bag
Quintay,SEGU9077960,04/19/2024,Sale,-95.0,1795.0,11,Unknown Variety,Bag
Quintay,SEGU9077960,04/19/2024,Sale,-570.0,1225.0,11,Unknown Variety,Bag
Quintay,SEGU9077960,04/22/2024,Sale,-95.0,1130.0,14,Unknown Variety,Bag
Quintay,SEGU9077960,04/22/2024,Sale,-95.0,1035.0,14,Unknown Variety,Bag
Quintay,SEGU9077960,04/23/2024,Sale,-380.0,655.0,15,Unknown Variety,Bag
Quintay,SEGU9077960,04/25/2024,Sale,-85.0,570.0,17,Unknown Variety,Bag
Quintay,SEGU9077960,04/25/2024,Sale,-95.0,475.0,17,Unknown Variety,Bag
Quintay,SEGU9077960,04/25/2024,Sale,-95.0,380.0,17,Unknown Variety,Bag
Quintay,SEGU9077960,04/25/2024,Sale,-190.0,190.0,17,Unknown Variety,Bag
Quintay,SEGU9077960,05/05/2024,Sale,-190.0,0.0,27,Unknown Variety,Bag
Quintay,SEGU9088352,03/21/2024,Sale,-216.0,-216.0,0,Unknown Variety,Bag
Quintay,SEGU9088352,03/22/2024,Sale,-540.0,-756.0,1,Unknown Variety,Bag
Quintay,SEGU9088352,03/22/2024,Sale,-1404.0,-2160.0,1,Unknown Variety,Bag
Quintay,SEGU9088352,03/30/2024,Entry,756.0,-1404.0,9,Unknown Variety,Bag
Quintay,SEGU9088352,03/30/2024,Entry,1404.0,0.0,9,Unknown Variety,Bag
Quintay,SEGU9147455,04/08/2024,Entry,760.0,760.0,0,Unknown Variety,Bag
Quintay,SEGU9147455,04/08/2024,Entry,1140.0,1900.0,0,Unknown Variety,Bag
Quintay,SEGU9147455,04/27/2024,Sale,-380.0,1520.0,19,Unknown Variety,Bag
Quintay,SEGU9147455,04/30/2024,Sale,-95.0,1425.0,22,Unknown Variety,Bag
Quintay,SEGU9147455,05/01/2024,Sale,-570.0,855.0,23,Unknown Variety,Bag
Quintay,SEGU9147455,05/01/2024,Sale,-95.0,760.0,23,Unknown Variety,Bag
Quintay,SEGU9147455,05/03/2024,Sale,-380.0,380.0,25,Unknown Variety,Bag
Quintay,SEGU9147455,05/13/2024,Sale,-95.0,285.0,35,Unknown Variety,Bag
Quintay,SEGU9147455,05/15/2024,Sale,-95.0,190.0,37,Unknown Variety,Bag
Quintay,SEGU9147455,05/16/2024,Sale,-190.0,0.0,38,Unknown Variety,Bag
Quintay,SEGU9300230,03/19/2024,Sale,-216.0,-216.0,0,Unknown Variety,Bag
Quintay,SEGU9300230,03/20/2024,Sale,-648.0,-864.0,1,Unknown Variety,Bag
Quintay,SEGU9300230,03/20/2024,Sale,-756.0,-1620.0,1,Unknown Variety,Bag
Quintay,SEGU9300230,03/20/2024,Sale,-540.0,-2160.0,1,Unknown Variety,Bag
Quintay,SEGU9300230,03/30/2024,Entry,864.0,-1296.0,11,Unknown Variety,Bag
Quintay,SEGU9300230,03/30/2024,Entry,756.0,-540.0,11,Unknown Variety,Bag
Quintay,SEGU9300230,03/30/2024,Entry,540.0,0.0,11,Unknown Variety,Bag
Quintay,SEGU9302274,03/31/2024,Entry,1425.0,1425.0,0,Unknown Variety,Bag
Quintay,SEGU9302274,03/31/2024,Entry,475.0,1900.0,0,Unknown Variety,Bag
Quintay,SEGU9302274,04/13/2024,Sale,-475.0,1425.0,13,Unknown Variety,Bag
Quintay,SEGU9302274,05/01/2024,Sale,-285.0,1140.0,31,Unknown Variety,Bag
Quintay,SEGU9302274,05/05/2024,Sale,-855.0,285.0,35,Unknown Variety,Bag
Quintay,SEGU9302274,05/13/2024,Sale,-285.0,0.0,43,Unknown Variety,Bag
Quintay,SEGU9474268,05/19/2024,Entry,108.0,108.0,0,CRIMSON,Bag
Quintay,SEGU9474268,05/19/2024,Entry,108.0,216.0,0,CRIMSON,Bag
Quintay,SEGU9474268,05/19/2024,Entry,756.0,972.0,0,CRIMSON,Bag
Quintay,SEGU9474268,05/19/2024,Entry,1188.0,2160.0,0,RED GLOBE,Bag
Quintay,SEGU9474268,05/28/2024,Sale,-648.0,1512.0,9,CRIMSON,Bag
Quintay,SEGU9474268,05/28/2024,Sale,-108.0,1404.0,9,CRIMSON,Bag
Quintay,SEGU9474268,05/30/2024,Sale,-216.0,1188.0,11,RED GLOBE,Bag
Quintay,SEGU9474268,05/30/2024,Sale,-108.0,1080.0,11,RED GLOBE,Bag
Quintay,SEGU9474268,06/03/2024,Sale,-108.0,972.0,15,RED GLOBE,Bag
Quintay,SEGU9474268,06/05/2024,Sale,-108.0,864.0,17,RED GLOBE,Bag
Quintay,SEGU9474268,06/07/2024,Sale,-108.0,756.0,19,RED GLOBE,Bag
Quintay,SEGU9474268,06/08/2024,Sale,-108.0,648.0,20,RED GLOBE,Bag
Quintay,SEGU9474268,06/10/2024,Sale,-108.0,540.0,22,RED GLOBE,Bag
Quintay,SEGU9474268,06/14/2024,Sale,-108.0,432.0,26,RED GLOBE,Bag
Quintay,SEGU9474268,06/17/2024,Sale,-108.0,324.0,29,RED GLOBE,Bag
Quintay,SEGU9474268,06/18/2024,Sale,-108.0,216.0,30,CRIMSON,Bag
Quintay,SEGU9474268,06/18/2024,Sale,-108.0,108.0,30,CRIMSON,Bag
Quintay,SEGU9474268,06/18/2024,Sale,-108.0,0.0,30,RED GLOBE,Bag
Quintay,SEGU9619612,03/28/2024,Entry,855.0,855.0,0,Unknown Variety,Bag
Quintay,SEGU9619612,03/28/2024,Entry,1045.0,1900.0,0,Unknown Variety,Bag
Quintay,SEGU9619612,04/22/2024,Sale,-760.0,1140.0,25,Unknown Variety,Bag
Quintay,SEGU9619612,04/23/2024,Sale,-570.0,570.0,26,Unknown Variety,Bag
Quintay,SEGU9619612,04/24/2024,Sale,-285.0,285.0,27,Unknown Variety,Bag
Quintay,SEGU9619612,04/26/2024,Sale,-95.0,190.0,29,Unknown Variety,Bag
Quintay,SEGU9619612,05/03/2024,Sale,-95.0,95.0,36,Unknown Variety,Bag
Quintay,SEGU9619612,05/04/2024,Sale,-95.0,0.0,37,Unknown Variety,Bag
Quintay,SEGU9625030,03/23/2024,Entry,475.0,475.0,0,Unknown Variety,Bag
Quintay,SEGU9625030,03/23/2024,Entry,1425.0,1900.0,0,Unknown Variety,Bag
Quintay,SEGU9625030,03/30/2024,Sale,-95.0,1805.0,7,Unknown Variety,Bag
Quintay,SEGU9625030,04/01/2024,Sale,-285.0,1520.0,9,Unknown Variety,Bag
Quintay,SEGU9625030,04/09/2024,Sale,-475.0,1045.0,17,Unknown Variety,Bag
Quintay,SEGU9625030,04/11/2024,Sale,-95.0,950.0,19,Unknown Variety,Bag
Quintay,SEGU9625030,04/12/2024,Sale,-190.0,760.0,20,Unknown Variety,Bag
Quintay,SEGU9625030,04/15/2024,Sale,-95.0,665.0,23,Unknown Variety,Bag
Quintay,SEGU9625030,04/15/2024,Sale,-380.0,285.0,23,Unknown Variety,Bag
Quintay,SEGU9625030,04/17/2024,Sale,-95.0,190.0,25,Unknown Variety,Bag
Quintay,SEGU9625030,04/19/2024,Sale,-95.0,95.0,27,Unknown Variety,Bag
Quintay,SEGU9625030,04/22/2024,Sale,-95.0,0.0,30,Unknown Variety,Bag
Quintay,SEGU9641391,03/23/2024,Entry,1600.0,1600.0,0,Unknown Variety,Clam
Quintay,SEGU9641391,03/29/2024,Sale,-480.0,1120.0,6,Unknown Variety,Clam
Quintay,SEGU9641391,03/29/2024,Sale,-1120.0,0.0,6,Unknown Variety,Clam
Quintay,SEGU9676799,03/29/2024,Entry,190.0,190.0,0,Unknown Variety,Bag
Quintay,SEGU9676799,03/29/2024,Entry,950.0,1140.0,0,Unknown Variety,Bag
Quintay,SEGU9676799,03/29/2024,Entry,760.0,1900.0,0,Unknown Variety,Bag
Quintay,SEGU9676799,04/08/2024,Sale,-760.0,1140.0,10,Unknown Variety,Bag
Quintay,SEGU9676799,04/09/2024,Sale,-570.0,570.0,11,Unknown Variety,Bag
Quintay,SEGU9676799,04/09/2024,Sale,-190.0,380.0,11,Unknown Variety,Bag
Quintay,SEGU9676799,04/09/2024,Sale,-190.0,190.0,11,Unknown Variety,Bag
Quintay,SEGU9676799,04/09/2024,Sale,-190.0,0.0,11,Unknown Variety,Bag
Quintay,SEGU9694663,03/28/2024,Entry,760.0,760.0,0,Unknown Variety,Bag
Quintay,SEGU9694663,03/28/2024,Entry,1140.0,1900.0,0,Unknown Variety,Bag
Quintay,SEGU9694663,04/25/2024,Sale,-95.0,1805.0,28,Unknown Variety,Bag
Quintay,SEGU9694663,04/25/2024,Sale,-665.0,1140.0,28,Unknown Variety,Bag
Quintay,SEGU9694663,04/26/2024,Sale,-95.0,1045.0,29,Unknown Variety,Bag
Quintay,SEGU9694663,04/30/2024,Sale,-190.0,855.0,33,Unknown Variety,Bag
Quintay,SEGU9694663,05/03/2024,Sale,-95.0,760.0,36,Unknown Variety,Bag
Quintay,SEGU9694663,05/03/2024,Sale,-78.0,682.0,36,Unknown Variety,Bag
Quintay,SEGU9694663,05/03/2024,Sale,-112.0,570.0,36,Unknown Variety,Bag
Quintay,SEGU9694663,05/06/2024,Sale,-536.0,34.0,39,Unknown Variety,Bag
Quintay,SEGU9695464,04/09/2024,Entry,1600.0,1600.0,0,Unknown Variety,Clam
Quintay,SEGU9695464,04/16/2024,Sale,-1520.0,80.0,7,Unknown Variety,Clam
Quintay,SEGU9695464,04/22/2024,Sale,-80.0,0.0,13,Unknown Variety,Clam
Quintay,SEGU9696265,04/09/2024,Entry,1600.0,1600.0,0,Unknown Variety,Clam
Quintay,SEGU9696265,04/16/2024,Sale,-80.0,1520.0,7,Unknown Variety,Clam
Quintay,SEGU9696265,04/16/2024,Sale,-1520.0,0.0,7,Unknown Variety,Clam
Quintay,SEGU9696692,04/09/2024,Entry,1600.0,1600.0,0,Unknown Variety,Clam
Quintay,SEGU9696692,04/15/2024,Sale,-1600.0,0.0,6,Unknown Variety,Clam
Quintay,SEGU9698463,03/23/2024,Entry,1600.0,1600.0,0,Unknown Variety,Clam
Quintay,SEGU9698463,03/29/2024,Sale,-80.0,1520.0,6,Unknown Variety,Clam
Quintay,SEGU9698463,04/01/2024,Sale,-1440.0,80.0,9,Unknown Variety,Clam
Quintay,SEGU9698463,04/01/2024,Sale,-80.0,0.0,9,Unknown Variety,Clam
Quintay,SEGU9721687,04/09/2024,Entry,1600.0,1600.0,0,Unknown Variety,Clam
Quintay,SEGU9721687,04/16/2024,Sale,-80.0,1520.0,7,Unknown Variety,Clam
Quintay,SEGU9721687,04/22/2024,Sale,-1120.0,400.0,13,Unknown Variety,Clam
Quintay,SEGU9721687,04/25/2024,Sale,-400.0,0.0,16,Unknown Variety,Clam
Quintay,SEGU9741852,03/28/2024,Entry,570.0,570.0,0,Unknown Variety,Bag
Quintay,SEGU9741852,03/28/2024,Entry,380.0,950.0,0,Unknown Variety,Bag
Quintay,SEGU9741852,03/28/2024,Entry,950.0,1900.0,0,Unknown Variety,Bag
Quintay,SEGU9741852,04/24/2024,Sale,-380.0,1520.0,27,Unknown Variety,Bag
Quintay,SEGU9741852,04/25/2024,Sale,-190.0,1330.0,28,Unknown Variety,Bag
Quintay,SEGU9741852,04/25/2024,Sale,-380.0,950.0,28,Unknown Variety,Bag
Quintay,SEGU9741852,04/26/2024,Sale,-855.0,95.0,29,Unknown Variety,Bag
Quintay,SEGU9741852,04/27/2024,Sale,-95.0,0.0,30,Unknown Variety,Bag
Quintay,SEGU9861499,03/23/2024,Entry,89.0,89.0,0,CRIMSON,Bag
Quintay,SEGU9861499,03/23/2024,Entry,432.0,521.0,0,CRIMSON,Bag
Quintay,SEGU9861499,03/23/2024,Entry,95.0,616.0,0,Unknown Variety,Bag
Quintay,SEGU9861499,03/23/2024,Entry,1120.0,1736.0,0,Unknown Variety,Bag
Quintay,SEGU9861499,03/29/2024,Sale,-216.0,1520.0,6,CRIMSON,Bag
Quintay,SEGU9861499,03/29/2024,Sale,-960.0,560.0,6,Unknown Variety,Clam
Quintay,SEGU9861499,03/29/2024,Sale,-80.0,480.0,6,Unknown Variety,Clam
Quintay,SEGU9861499,03/30/2024,Sale,-216.0,264.0,7,CRIMSON,Bag
Quintay,SEGU9861499,04/01/2024,Sale,-80.0,184.0,9,Unknown Variety,Unknown
Quintay,SEGU9861499,04/04/2024,Sale,-95.0,89.0,12,Unknown Variety,Bag
Quintay,SEGU9861499,04/11/2024,Sale,-89.0,0.0,19,CRIMSON,Bag
Quintay,SEGU9861842,04/09/2024,Entry,1600.0,1600.0,0,Unknown Variety,Unknown
Quintay,SEGU9861842,04/17/2024,Sale,-1360.0,240.0,8,Unknown Variety,Unknown
Quintay,SEGU9861842,04/17/2024,Sale,-240.0,0.0,8,Unknown Variety,Unknown
Quintay,SEGU9865540,04/09/2024,Entry,1600.0,1600.0,0,Unknown Variety,Unknown
Quintay,SEGU9865540,04/17/2024,Sale,-240.0,1360.0,8,Unknown Variety,Unknown
Quintay,SEGU9865540,04/20/2024,Sale,-880.0,480.0,11,Unknown Variety,Unknown
Quintay,SEGU9865540,04/25/2024,Sale,-480.0,0.0,16,Unknown Variety,Unknown
Quintay,SEGU9869191,04/09/2024,Entry,1600.0,1600.0,0,Unknown Variety,Unknown
Quintay,SEGU9869191,04/15/2024,Sale,-1600.0,0.0,6,Unknown Variety,Unknown
Quintay,SEKU9296495,03/28/2024,Entry,760.0,760.0,0,Unknown Variety,Unknown
Quintay,SEKU9296495,03/28/2024,Entry,760.0,1520.0,0,Unknown Variety,Unknown
Quintay,SEKU9296495,03/28/2024,Entry,380.0,1900.0,0,Unknown Variety,Unknown
Quintay,SEKU9296495,04/25/2024,Sale,-760.0,1140.0,28,Unknown Variety,Unknown
Quintay,SEKU9296495,04/26/2024,Sale,-95.0,1045.0,29,Unknown Variety,Unknown
Quintay,SEKU9296495,04/27/2024,Sale,-95.0,950.0,30,Unknown Variety,Unknown
Quintay,SEKU9296495,04/30/2024,Sale,-95.0,855.0,33,Unknown Variety,Unknown
Quintay,SEKU9296495,05/06/2024,Sale,-604.0,251.0,39,Unknown Variety,Unknown
Quintay,SEKU9296495,05/08/2024,Sale,-170.0,81.0,41,Unknown Variety,Unknown
Quintay,SEKU9296495,05/08/2024,Sale,-5.0,76.0,41,Unknown Variety,Unknown
Quintay,SZLU9568099,05/09/2024,Sale,-972.0,-972.0,0,RED GLOBE,Unknown
Quintay,SZLU9568099,05/10/2024,Entry,972.0,0.0,1,CRIMSON,Unknown
Quintay,SZLU9568099,05/10/2024,Entry,150.0,150.0,1,CRIMSON,Unknown
Quintay,SZLU9568099,05/10/2024,Entry,972.0,1122.0,1,RED GLOBE,Unknown
Quintay,SZLU9568099,05/10/2024,Sale,-432.0,690.0,1,CRIMSON,Unknown
Quintay,SZLU9568099,05/10/2024,Sale,-216.0,474.0,1,CRIMSON,Unknown
Quintay,SZLU9568099,05/11/2024,Sale,-216.0,258.0,2,CRIMSON,Unknown
Quintay,SZLU9568099,05/13/2024,Sale,-108.0,150.0,4,CRIMSON,Unknown
Quintay,SZLU9568099,05/15/2024,Sale,-80.0,70.0,6,CRIMSON,Unknown
Quintay,SZLU9568099,06/10/2024,Sale,-70.0,0.0,32,CRIMSON,Unknown
Quintay,TEMU9052361,05/12/2024,Entry,216.0,216.0,0,CRIMSON,Unknown
Quintay,TEMU9052361,05/12/2024,Entry,1080.0,1296.0,0,CRIMSON,Unknown
Quintay,TEMU9052361,05/12/2024,Entry,864.0,2160.0,0,CRIMSON,Unknown
Quintay,TEMU9052361,05/21/2024,Sale,-108.0,2052.0,9,CRIMSON,Unknown
Quintay,TEMU9052361,05/21/2024,Sale,-108.0,1944.0,9,CRIMSON,Unknown
Quintay,TEMU9052361,05/28/2024,Sale,-864.0,1080.0,16,CRIMSON,Unknown
Quintay,TEMU9052361,05/28/2024,Sale,-864.0,216.0,16,CRIMSON,Unknown
Quintay,TEMU9052361,05/28/2024,Sale,-108.0,108.0,16,CRIMSON,Unknown
Quintay,TEMU9052361,06/18/2024,Sale,-108.0,0.0,37,CRIMSON,Unknown
Quintay,TRIU8374843,05/12/2024,Entry,1404.0,1404.0,0,CRIMSON,Unknown
Quintay,TRIU8374843,05/12/2024,Entry,324.0,1728.0,0,CRIMSON,Unknown
Quintay,TRIU8374843,05/12/2024,Entry,160.0,1888.0,0,CRIMSON,Unknown
Quintay,TRIU8374843,05/12/2024,Entry,160.0,2048.0,0,CRIMSON,Unknown
Quintay,TRIU8374843,05/21/2024,Sale,-108.0,1940.0,9,CRIMSON,Unknown
Quintay,TRIU8374843,05/22/2024,Sale,-160.0,1780.0,10,CRIMSON,Unknown
Quintay,TRIU8374843,05/23/2024,Sale,-145.0,1635.0,11,CRIMSON,Unknown
Quintay,TRIU8374843,05/23/2024,Sale,-7.0,1628.0,11,CRIMSON,Unknown
Quintay,TRIU8374843,05/28/2024,Sale,-216.0,1412.0,16,CRIMSON,Unknown
Quintay,TRIU8374843,05/28/2024,Sale,-1188.0,224.0,16,CRIMSON,Unknown
Quintay,TRIU8374843,05/30/2024,Sale,-216.0,8.0,18,CRIMSON,Unknown
Quintay,TRLU1888336,05/19/2024,Entry,2160.0,2160.0,0,RED GLOBE,Unknown
Quintay,TRLU1888336,05/28/2024,Sale,-108.0,2052.0,9,RED GLOBE,Unknown
Quintay,TRLU1888336,05/30/2024,Sale,-1170.0,882.0,11,RED GLOBE,Unknown
Quintay,TRLU1888336,06/03/2024,Sale,-108.0,774.0,15,RED GLOBE,Unknown
Quintay,TRLU1888336,06/05/2024,Sale,-108.0,666.0,17,RED GLOBE,Unknown
Quintay,TRLU1888336,06/07/2024,Sale,-18.0,648.0,19,RED GLOBE,Unknown
Quintay,TRLU1888336,06/07/2024,Sale,-108.0,540.0,19,RED GLOBE,Unknown
Quintay,TRLU1888336,06/10/2024,Sale,-108.0,432.0,22,RED GLOBE,Unknown
Quintay,TRLU1888336,06/11/2024,Sale,-108.0,324.0,23,RED GLOBE,Unknown
Quintay,TRLU1888336,06/13/2024,Sale,-108.0,216.0,25,RED GLOBE,Unknown
Quintay,TRLU1888336,06/14/2024,Sale,-108.0,108.0,26,RED GLOBE,Unknown
Quintay,TRLU1888336,06/17/2024,Sale,-108.0,0.0,29,RED GLOBE,Unknown
Quintay,TTNU8410329,05/09/2024,Sale,-432.0,-432.0,0,RED GLOBE,Unknown
Quintay,TTNU8410329,05/09/2024,Sale,-1727.0,-2159.0,0,RED GLOBE,Unknown
Quintay,TTNU8410329,05/10/2024,Entry,2160.0,1.0,1,RED GLOBE,Unknown
Quintay,TTNU8972753,03/31/2024,Entry,1140.0,1140.0,0,Unknown Variety,Unknown
Quintay,TTNU8972753,03/31/2024,Entry,760.0,1900.0,0,Unknown Variety,Unknown
Quintay,TTNU8972753,04/19/2024,Sale,-380.0,1520.0,19,Unknown Variety,Unknown
Quintay,TTNU8972753,04/22/2024,Sale,-190.0,1330.0,22,Unknown Variety,Unknown
Quintay,TTNU8972753,04/22/2024,Sale,-95.0,1235.0,22,Unknown Variety,Unknown
Quintay,TTNU8972753,04/23/2024,Sale,-380.0,855.0,23,Unknown Variety,Unknown
Quintay,TTNU8972753,04/23/2024,Sale,-95.0,760.0,23,Unknown Variety,Unknown
Quintay,TTNU8972753,04/25/2024,Sale,-285.0,475.0,25,Unknown Variety,Unknown
Quintay,TTNU8972753,04/25/2024,Sale,-95.0,380.0,25,Unknown Variety,Unknown
Quintay,TTNU8972753,05/05/2024,Sale,-380.0,0.0,35,Unknown Variety,Unknown
Rio King,23R028411176,03/30/2024,Entry,3400.0,3400.0,0,CANDY HEARTS,Bag
Rio King,23R028411176,03/30/2024,Entry,800.0,4200.0,0,COTTON CANDY,Bag
Rio King,23R028411176,03/30/2024,Entry,800.0,5000.0,0,COTTON CANDY,Bag
Rio King,23R028411176,03/30/2024,Entry,85.0,5085.0,0,RED SDLS,Bag
Rio King,23R028411176,03/30/2024,Entry,1020.0,6105.0,0,SWEETCELEBRATION,Bag
Rio King,23R028411176,03/30/2024,Entry,765.0,6870.0,0,SWEETCELEBRATION,Bag
Rio King,23R028411176,03/30/2024,Entry,255.0,7125.0,0,SWEETCELEBRATION,Bag
Rio King,23R028411176,03/30/2024,Entry,425.0,7550.0,0,TIMCO,Bag
Rio King,23R028411176,03/30/2024,Entry,340.0,7890.0,0,TIMCO,Bag
Rio King,23R028411176,03/30/2024,Entry,425.0,8315.0,0,TIMPSON,Bag
Rio King,23R028411176,04/05/2024,Sale,-80.0,8235.0,6,COTTON CANDY,Bag
Rio King,23R028411176,04/06/2024,Sale,-425.0,7810.0,7,TIMPSON,Bag
Rio King,23R028411176,04/08/2024,Sale,-255.0,7555.0,9,TIMCO,Bag
Rio King,23R028411176,04/08/2024,Sale,-425.0,7130.0,9,TIMCO,Bag
Rio King,23R028411176,04/09/2024,Sale,-850.0,6280.0,10,CANDY HEARTS,Bag
Rio King,23R028411176,04/09/2024,Sale,-255.0,6025.0,10,CANDY HEARTS,Bag
Rio King,23R028411176,04/09/2024,Sale,-85.0,5940.0,10,RED SDLS,Bag
Rio King,23R028411176,04/09/2024,Sale,-255.0,5685.0,10,SWEETCELEBRATION,Bag
Rio King,23R028411176,04/09/2024,Sale,-765.0,4920.0,10,SWEETCELEBRATION,Bag
Rio King,23R028411176,04/09/2024,Sale,-85.0,4835.0,10,SWEETCELEBRATION,Bag
Rio King,23R028411176,04/11/2024,Sale,-680.0,4155.0,12,SWEETCELEBRATION,Bag
Rio King,23R028411176,04/12/2024,Sale,-170.0,3985.0,13,SWEETCELEBRATION,Bag
Rio King,23R028411176,04/15/2024,Sale,-595.0,3390.0,16,CANDY HEARTS,Bag
Rio King,23R028411176,04/18/2024,Sale,-80.0,3310.0,19,COTTON CANDY,Bag
Rio King,23R028411176,04/19/2024,Sale,-80.0,3230.0,20,COTTON CANDY,Bag
Rio King,23R028411176,04/19/2024,Sale,-85.0,3145.0,20,TIMCO,Bag
Rio King,23R028411176,04/22/2024,Sale,-1530.0,1615.0,23,CANDY HEARTS,Bag
Rio King,23R028411176,04/22/2024,Sale,-170.0,1445.0,23,CANDY HEARTS,Bag
Rio King,23R028411176,04/22/2024,Sale,-320.0,1125.0,23,COTTON CANDY,Bag
Rio King,23R028411176,04/22/2024,Sale,-85.0,1040.0,23,SWEETCELEBRATION,Bag
Rio King,23R028411176,04/25/2024,Sale,-80.0,960.0,26,COTTON CANDY,Bag
Rio King,23R028411176,04/30/2024,Sale,-240.0,720.0,31,COTTON CANDY,Bag
Rio King,23R028411176,04/30/2024,Sale,-160.0,560.0,31,COTTON CANDY,Bag
Rio King,23R028411176,05/01/2024,Sale,-240.0,320.0,32,COTTON CANDY,Bag
Rio King,23R028411176,05/03/2024,Sale,-160.0,160.0,34,COTTON CANDY,Bag
Rio King,23R028411176,05/07/2024,Sale,-160.0,0.0,38,COTTON CANDY,Bag
Rio King,23R029407069,03/06/2024,Entry,85.0,85.0,0,CANDY HEARTS,Bag
Rio King,23R029407069,03/06/2024,Entry,765.0,850.0,0,CANDY HEARTS,Bag
Rio King,23R029407069,03/06/2024,Entry,850.0,1700.0,0,CANDY HEARTS,Bag
Rio King,23R029407069,03/06/2024,Entry,680.0,2380.0,0,COTTON CANDY,Bag
Rio King,23R029407069,03/06/2024,Entry,340.0,2720.0,0,COTTON CANDY,Bag
Rio King,23R029407069,03/06/2024,Entry,680.0,3400.0,0,COTTON CANDY,Bag
Rio King,23R029407069,03/06/2024,Sale,-85.0,3315.0,0,COTTON CANDY,Bag
Rio King,23R029407069,03/11/2024,Sale,-1045.0,2270.0,5,BI-COLOR,Clam
Rio King,23R029407069,03/12/2024,Sale,-255.0,2015.0,6,CANDY HEARTS,Bag
Rio King,23R029407069,03/13/2024,Sale,-752.0,1263.0,7,RED SDLS,Clam
Rio King,23R029407069,03/14/2024,Sale,-85.0,1178.0,8,COTTON CANDY,Bag
Rio King,23R029407069,03/14/2024,Sale,-85.0,1093.0,8,COTTON CANDY,Bag
Rio King,23R029407069,03/14/2024,Sale,-85.0,1008.0,8,COTTON CANDY,Bag
Rio King,23R029407069,03/15/2024,Sale,-85.0,923.0,9,COTTON CANDY,Bag
Rio King,23R029407069,03/18/2024,Sale,-85.0,838.0,12,COTTON CANDY,Bag
Rio King,23R029407069,03/22/2024,Sale,-170.0,668.0,16,COTTON CANDY,Bag
Rio King,23R029407069,03/25/2024,Sale,-85.0,583.0,19,COTTON CANDY,Bag
Rio King,23R029407069,03/28/2024,Sale,-85.0,498.0,22,COTTON CANDY,Bag
Rio King,23R029407069,04/12/2024,Sale,-7.0,491.0,37,GREEN SEEDLESS,Clam
Rio King,23R029407069,04/23/2024,Sale,-17.0,474.0,48,GREEN SEEDLESS,Clam
Rio King,23R029407069,05/20/2024,Sale,-1.0,473.0,75,GREEN SEEDLESS,Clam
Rio King,23R033412282,04/10/2024,Entry,3655.0,3655.0,0,KRISSY,Bag
Rio King,23R033412282,04/10/2024,Entry,1105.0,4760.0,0,KRISSY,Bag
Rio King,23R033412282,04/10/2024,Entry,170.0,4930.0,0,KRISSY,Bag
Rio King,23R033412282,04/10/2024,Entry,3230.0,8160.0,0,SWEET FAVORS,Bag
Rio King,23R033412282,04/10/2024,Entry,170.0,8330.0,0,SWEET FAVORS,Bag
Rio King,23R033412282,04/10/2024,Entry,895.0,9225.0,0,SWEET GLOBE,Bag
Rio King,23R033412282,04/10/2024,Entry,80.0,9305.0,0,SWEET GLOBE,Bag
Rio King,23R033412282,04/10/2024,Entry,935.0,10240.0,0,SWEETCELEBRATION,Bag
Rio King,23R033412282,04/10/2024,Entry,935.0,11175.0,0,TIMCO,Bag
Rio King,23R033412282,04/10/2024,Entry,85.0,11260.0,0,TIMCO,Bag
Rio King,23R033412282,04/10/2024,Entry,1190.0,12450.0,0,TIMPSON,Bag
Rio King,23R033412282,04/10/2024,Entry,1020.0,13470.0,0,TIMPSON,Bag
Rio King,23R033412282,04/18/2024,Sale,-170.0,13300.0,8,KRISSY,Bag
Rio King,23R033412282,04/18/2024,Sale,-85.0,13215.0,8,KRISSY,Bag
Rio King,23R033412282,04/18/2024,Sale,-1105.0,12110.0,8,KRISSY,Bag
Rio King,23R033412282,04/18/2024,Sale,-85.0,12025.0,8,SWEET FAVORS,Bag
Rio King,23R033412282,04/19/2024,Sale,-850.0,11175.0,9,KRISSY,Bag
Rio King,23R033412282,04/19/2024,Sale,-425.0,10750.0,9,SWEET FAVORS,Bag
Rio King,23R033412282,04/19/2024,Sale,-850.0,9900.0,9,TIMCO,Bag
Rio King,23R033412282,04/19/2024,Sale,-85.0,9815.0,9,TIMPSON,Bag
Rio King,23R033412282,04/22/2024,Sale,-425.0,9390.0,12,KRISSY,Bag
Rio King,23R033412282,04/22/2024,Sale,-935.0,8455.0,12,KRISSY,Bag
Rio King,23R033412282,04/22/2024,Sale,-85.0,8370.0,12,TIMPSON,Bag
Rio King,23R033412282,04/23/2024,Sale,-85.0,8285.0,13,SWEET FAVORS,Bag
Rio King,23R033412282,04/23/2024,Sale,-595.0,7690.0,13,SWEETCELEBRATION,Bag
Rio King,23R033412282,04/23/2024,Sale,-85.0,7605.0,13,TIMCO,Bag
Rio King,23R033412282,04/24/2024,Sale,-1275.0,6330.0,14,SWEET FAVORS,Bag
Rio King,23R033412282,04/24/2024,Sale,-170.0,6160.0,14,SWEET FAVORS,Bag
Rio King,23R033412282,04/24/2024,Sale,-340.0,5820.0,14,SWEET FAVORS,Bag
Rio King,23R033412282,04/29/2024,Sale,-935.0,4885.0,19,SWEET FAVORS,Bag
Rio King,23R033412282,04/29/2024,Sale,-510.0,4375.0,19,TIMPSON,Bag
Rio King,23R033412282,05/01/2024,Sale,-935.0,3440.0,21,KRISSY,Bag
Rio King,23R033412282,05/01/2024,Sale,-508.0,2932.0,21,TIMPSON,Bag
Rio King,23R033412282,05/02/2024,Sale,-85.0,2847.0,22,SWEET FAVORS,Bag
Rio King,23R033412282,05/02/2024,Sale,-935.0,1912.0,22,TIMPSON,Bag
Rio King,23R033412282,05/02/2024,Sale,-85.0,1827.0,22,TIMPSON,Bag
Rio King,23R033412282,05/06/2024,Sale,-340.0,1487.0,26,SWEETCELEBRATION,Bag
Rio King,23R033412282,05/10/2024,Sale,-490.0,997.0,30,SWEET GLOBE,Bag
Rio King,23R033412282,05/13/2024,Sale,-80.0,917.0,33,SWEET GLOBE,Bag
Rio King,23R033412282,05/13/2024,Sale,-320.0,597.0,33,SWEET GLOBE,Bag
Rio King,23R033412282,05/15/2024,Sale,-255.0,342.0,35,KRISSY,Bag
Rio King,23R033412282,05/15/2024,Sale,-170.0,172.0,35,KRISSY,Bag
Rio King,23R033412282,05/15/2024,Sale,-85.0,87.0,35,TIMCO,Bag
Rio King,23R033412282,05/15/2024,Sale,-2.0,85.0,35,TIMPSON,Bag
Rio King,23R033412282,05/23/2024,Sale,-85.0,0.0,43,SWEET GLOBE,Bag
Rio King,23R682409134,03/17/2024,Entry,3060.0,3060.0,0,IVORY,Bag
Rio King,23R682409134,03/17/2024,Entry,85.0,3145.0,0,IVORY,Bag
Rio King,23R682409134,03/17/2024,Entry,1700.0,4845.0,0,KRISSY,Bag
Rio King,23R682409134,03/17/2024,Entry,170.0,5015.0,0,TIMPSON,Bag
Rio King,23R682409134,03/17/2024,Entry,85.0,5100.0,0,TIMPSON,Bag
Rio King,23R682409134,03/22/2024,Sale,-170.0,4930.0,5,TIMPSON,Bag
Rio King,23R682409134,03/25/2024,Sale,-340.0,4590.0,8,IVORY,Bag
Rio King,23R682409134,03/26/2024,Sale,-850.0,3740.0,9,IVORY,Bag
Rio King,23R682409134,03/26/2024,Sale,-85.0,3655.0,9,IVORY,Bag
Rio King,23R682409134,03/26/2024,Sale,-765.0,2890.0,9,KRISSY,Bag
Rio King,23R682409134,03/28/2024,Sale,-595.0,2295.0,11,IVORY,Bag
Rio King,23R682409134,03/28/2024,Sale,-170.0,2125.0,11,KRISSY,Bag
Rio King,23R682409134,03/29/2024,Sale,-425.0,1700.0,12,IVORY,Bag
Rio King,23R682409134,03/29/2024,Sale,-765.0,935.0,12,KRISSY,Bag
Rio King,23R682409134,04/02/2024,Sale,-510.0,425.0,16,IVORY,Bag
Rio King,23R682409134,04/02/2024,Sale,-340.0,85.0,16,IVORY,Bag
Rio King,23R682409134,04/02/2024,Sale,-85.0,0.0,16,TIMPSON,Bag
Rio King,23R738405107,02/26/2024,Sale,-720.0,-720.0,0,CANDY HEARTS,Bag
Rio King,23R738405107,02/26/2024,Sale,-80.0,-800.0,0,COTTON CANDY,Bag
Rio King,23R738405107,02/29/2024,Sale,-80.0,-880.0,3,COTTON CANDY,Bag
Rio King,23R738405107,02/29/2024,Sale,-640.0,-1520.0,3,COTTON CANDY,Bag
Rio King,23R738405107,03/01/2024,Sale,-80.0,-1600.0,4,CANDY HEARTS,Bag
Rio King,23R738405107,03/04/2024,Entry,80.0,-1520.0,7,CANDY HEARTS,Bag
Rio King,23R738405107,03/04/2024,Entry,720.0,-800.0,7,CANDY HEARTS,Bag
Rio King,23R738405107,03/04/2024,Entry,800.0,0.0,7,COTTON CANDY,Bag
Rio King,23R745408217,03/12/2024,Entry,1700.0,1700.0,0,SWEET GLOBE,Bag
Rio King,23R745408217,03/14/2024,Sale,-510.0,1190.0,2,SWEET GLOBE,Bag
Rio King,23R745408217,03/14/2024,Sale,-255.0,935.0,2,SWEET GLOBE,Bag
Rio King,23R745408217,03/15/2024,Sale,-935.0,0.0,3,SWEET GLOBE,Bag
Rio King,23R745408218,03/12/2024,Entry,1598.0,1598.0,0,COTTON CANDY,Bag
Rio King,23R745408218,03/15/2024,Sale,-160.0,1438.0,3,COTTON CANDY,Bag
Rio King,23R745408218,03/15/2024,Sale,-320.0,1118.0,3,COTTON CANDY,Bag
Rio King,23R745408218,03/16/2024,Sale,-80.0,1038.0,4,COTTON CANDY,Bag
Rio King,23R745408218,03/21/2024,Sale,-80.0,958.0,9,COTTON CANDY,Bag
Rio King,23R745408218,04/01/2024,Sale,-879.0,79.0,20,COTTON CANDY,Bag
Rio King,23R745408218,04/12/2024,Sale,-80.0,-1.0,31,GREEN SEEDLESS,Clam
Rio King,23RK07410148,03/23/2024,Entry,1600.0,1600.0,0,COTTON CANDY,Bag
Rio King,23RK07410148,03/23/2024,Entry,1700.0,3300.0,0,SWEETCELEBRATION,Bag
Rio King,23RK07410148,03/23/2024,Entry,765.0,4065.0,0,TIMPSON,Bag
Rio King,23RK07410148,03/23/2024,Entry,850.0,4915.0,0,TIMPSON,Bag
Rio King,23RK07410148,03/23/2024,Entry,85.0,5000.0,0,TIMPSON,Bag
Rio King,23RK07410148,03/26/2024,Sale,-510.0,4490.0,3,SWEETCELEBRATION,Bag
Rio King,23RK07410148,03/26/2024,Sale,-340.0,4150.0,3,TIMPSON,Bag
Rio King,23RK07410148,03/26/2024,Sale,-340.0,3810.0,3,TIMPSON,Bag
Rio King,23RK07410148,03/27/2024,Sale,-170.0,3640.0,4,SWEETCELEBRATION,Bag
Rio King,23RK07410148,03/28/2024,Sale,-85.0,3555.0,5,SWEETCELEBRATION,Bag
Rio King,23RK07410148,03/28/2024,Sale,-340.0,3215.0,5,SWEETCELEBRATION,Bag
Rio King,23RK07410148,03/28/2024,Sale,-85.0,3130.0,5,TIMPSON,Bag
Rio King,23RK07410148,03/30/2024,Sale,-551.0,2579.0,7,SWEETCELEBRATION,Clam
Rio King,23RK07410148,04/01/2024,Sale,-1.0,2578.0,9,COTTON CANDY,Bag
Rio King,23RK07410148,04/03/2024,Sale,-85.0,2493.0,11,TIMPSON,Bag
Rio King,23RK07410148,04/09/2024,Sale,-160.0,2333.0,17,COTTON CANDY,Bag
Rio King,23RK07410148,04/10/2024,Sale,-160.0,2173.0,18,COTTON CANDY,Bag
Rio King,23RK07410148,04/10/2024,Sale,-80.0,2093.0,18,COTTON CANDY,Bag
Rio King,23RK07410148,04/11/2024,Sale,-255.0,1838.0,19,TIMPSON,Bag
Rio King,23RK07410148,04/12/2024,Sale,-880.0,958.0,20,GREEN SEEDLESS,Clam
Rio King,23RK07410148,04/16/2024,Sale,-170.0,788.0,24,TIMPSON,Bag
Rio King,23RK07410148,04/22/2024,Sale,-85.0,703.0,30,TIMPSON,Bag
Rio King,23RK07410148,04/29/2024,Sale,-85.0,618.0,37,TIMPSON,Bag
Rio King,23RK07410148,05/13/2024,Sale,-192.0,426.0,51,TIMPSON,Bag
Rio King,23RK38411147,04/01/2024,Entry,479.0,479.0,0,COTTON CANDY,Bag
Rio King,23RK38411147,04/01/2024,Entry,1120.0,1599.0,0,COTTON CANDY,Bag
Rio King,23RK38411147,04/01/2024,Entry,425.0,2024.0,0,SWEET GLOBE,Bag
Rio King,23RK38411147,04/01/2024,Entry,1105.0,3129.0,0,SWEET GLOBE,Bag
Rio King,23RK38411147,04/01/2024,Entry,85.0,3214.0,0,TIMPSON,Bag
Rio King,23RK38411147,04/01/2024,Entry,85.0,3299.0,0,TIMPSON,Bag
Rio King,23RK38411147,04/03/2024,Sale,-170.0,3129.0,2,SWEET GLOBE,Bag
Rio King,23RK38411147,04/03/2024,Sale,-425.0,2704.0,2,SWEET GLOBE,Bag
Rio King,23RK38411147,04/05/2024,Sale,-80.0,2624.0,4,COTTON CANDY,Bag
Rio King,23RK38411147,04/05/2024,Sale,-800.0,1824.0,4,GREEN SEEDLESS,Clam
Rio King,23RK38411147,04/10/2024,Sale,-398.0,1426.0,9,COTTON CANDY,Bag
Rio King,23RK38411147,04/12/2024,Sale,-170.0,1256.0,11,SWEET GLOBE,Bag
Rio King,23RK38411147,04/16/2024,Sale,-425.0,831.0,15,SWEET GLOBE,Bag
Rio King,23RK38411147,04/16/2024,Sale,-85.0,746.0,15,TIMPSON,Bag
Rio King,23RK38411147,04/22/2024,Sale,-85.0,661.0,21,TIMPSON,Bag
Rio King,23RK38411147,04/25/2024,Sale,-339.0,322.0,24,SWEET GLOBE,Bag
Rio King,23RK71413153,04/09/2024,Entry,255.0,255.0,0,CANDY HEARTS,Bag
Rio King,23RK71413153,04/09/2024,Entry,3060.0,3315.0,0,CANDY HEARTS,Bag
Rio King,23RK71413153,04/09/2024,Entry,85.0,3400.0,0,CANDY HEARTS,Bag
Rio King,23RK71413153,04/09/2024,Entry,320.0,3720.0,0,COTTON CANDY,Bag
Rio King,23RK71413153,04/09/2024,Entry,2160.0,5880.0,0,COTTON CANDY,Bag
Rio King,23RK71413153,04/09/2024,Entry,85.0,5965.0,0,COTTON CANDY,Bag
Rio King,23RK71413153,04/09/2024,Entry,80.0,6045.0,0,COTTON CANDY,Bag
Rio King,23RK71413153,04/09/2024,Entry,1275.0,7320.0,0,SWEET FAVORS,Bag
Rio King,23RK71413153,04/09/2024,Entry,1955.0,9275.0,0,SWEET FAVORS,Bag
Rio King,23RK71413153,04/09/2024,Entry,1360.0,10635.0,0,SWEETCELEBRATION,Bag
Rio King,23RK71413153,04/09/2024,Entry,1615.0,12250.0,0,SWEETCELEBRATION,Bag
Rio King,23RK71413153,04/15/2024,Sale,-340.0,11910.0,6,CANDY HEARTS,Bag
Rio King,23RK71413153,04/15/2024,Sale,-80.0,11830.0,6,COTTON CANDY,Bag
Rio King,23RK71413153,04/17/2024,Sale,-255.0,11575.0,8,CANDY HEARTS,Bag
Rio King,23RK71413153,04/17/2024,Sale,-255.0,11320.0,8,SWEET FAVORS,Bag
Rio King,23RK71413153,04/17/2024,Sale,-170.0,11150.0,8,SWEETCELEBRATION,Bag
Rio King,23RK71413153,04/17/2024,Sale,-255.0,10895.0,8,SWEETCELEBRATION,Bag
Rio King,23RK71413153,04/18/2024,Sale,-170.0,10725.0,9,SWEETCELEBRATION,Bag
Rio King,23RK71413153,04/18/2024,Sale,-255.0,10470.0,9,SWEETCELEBRATION,Bag
Rio King,23RK71413153,04/19/2024,Sale,-255.0,10215.0,10,CANDY HEARTS,Bag
Rio King,23RK71413153,04/19/2024,Sale,-720.0,9495.0,10,COTTON CANDY,Bag
Rio King,23RK71413153,04/19/2024,Sale,-160.0,9335.0,10,COTTON CANDY,Bag
Rio King,23RK71413153,04/19/2024,Sale,-85.0,9250.0,10,SWEET FAVORS,Bag
Rio King,23RK71413153,04/19/2024,Sale,-255.0,8995.0,10,SWEET FAVORS,Bag
Rio King,23RK71413153,04/19/2024,Sale,-85.0,8910.0,10,SWEETCELEBRATION,Bag
Rio King,23RK71413153,04/20/2024,Sale,-80.0,8830.0,11,COTTON CANDY,Bag
Rio King,23RK71413153,04/20/2024,Sale,-80.0,8750.0,11,COTTON CANDY,Bag
Rio King,23RK71413153,04/20/2024,Sale,-80.0,8670.0,11,COTTON CANDY,Bag
Rio King,23RK71413153,04/20/2024,Sale,-85.0,8585.0,11,SWEET FAVORS,Bag
Rio King,23RK71413153,04/20/2024,Sale,-255.0,8330.0,11,SWEETCELEBRATION,Bag
Rio King,23RK71413153,04/20/2024,Sale,-340.0,7990.0,11,SWEETCELEBRATION,Bag
Rio King,23RK71413153,04/20/2024,Sale,-510.0,7480.0,11,SWEETCELEBRATION,Bag
Rio King,23RK71413153,04/23/2024,Sale,-85.0,7395.0,14,CANDY HEARTS,Bag
Rio King,23RK71413153,04/23/2024,Sale,-85.0,7310.0,14,CANDY HEARTS,Bag
Rio King,23RK71413153,04/24/2024,Sale,-425.0,6885.0,15,CANDY HEARTS,Bag
Rio King,23RK71413153,04/24/2024,Sale,-170.0,6715.0,15,CANDY HEARTS,Bag
Rio King,23RK71413153,04/24/2024,Sale,-508.0,6207.0,15,SWEETCELEBRATION,Bag
Rio King,23RK71413153,04/24/2024,Sale,-170.0,6037.0,15,SWEETCELEBRATION,Bag
Rio King,23RK71413153,04/25/2024,Sale,-85.0,5952.0,16,CANDY HEARTS,Bag
Rio King,23RK71413153,04/25/2024,Sale,-170.0,5782.0,16,CANDY HEARTS,Bag
Rio King,23RK71413153,04/25/2024,Sale,-85.0,5697.0,16,CANDY HEARTS,Bag
Rio King,23RK71413153,04/25/2024,Sale,-425.0,5272.0,16,CANDY HEARTS,Bag
Rio King,23RK71413153,04/25/2024,Sale,-160.0,5112.0,16,COTTON CANDY,Bag
Rio King,23RK71413153,04/25/2024,Sale,-320.0,4792.0,16,COTTON CANDY,Bag
Rio King,23RK71413153,04/25/2024,Sale,-25.0,4767.0,16,COTTON CANDY,Bag
Rio King,23RK71413153,04/25/2024,Sale,-480.0,4287.0,16,COTTON CANDY,Bag
Rio King,23RK71413153,04/25/2024,Sale,-85.0,4202.0,16,SWEET FAVORS,Bag
Rio King,23RK71413153,04/25/2024,Sale,-255.0,3947.0,16,SWEETCELEBRATION,Bag
Rio King,23RK71413153,04/26/2024,Sale,-170.0,3777.0,17,CANDY HEARTS,Bag
Rio King,23RK71413153,04/26/2024,Sale,-80.0,3697.0,17,COTTON CANDY,Bag
Rio King,23RK71413153,04/30/2024,Sale,-160.0,3537.0,21,COTTON CANDY,Bag
Rio King,23RK71413153,04/30/2024,Sale,-85.0,3452.0,21,SWEET FAVORS,Bag
Rio King,23RK71413153,04/30/2024,Sale,-425.0,3027.0,21,SWEET FAVORS,Bag
Rio King,23RK71413153,05/01/2024,Sale,-85.0,2942.0,22,CANDY HEARTS,Bag
Rio King,23RK71413153,05/02/2024,Sale,-255.0,2687.0,23,SWEET FAVORS,Bag
Rio King,23RK71413153,05/02/2024,Sale,-1190.0,1497.0,23,SWEET FAVORS,Bag
Rio King,23RK71413153,05/04/2024,Sale,-510.0,987.0,25,SWEET FAVORS,Bag
Rio King,23RK71413153,05/07/2024,Sale,-85.0,902.0,28,CANDY HEARTS,Bag
Rio King,23RK71413153,05/09/2024,Sale,-170.0,732.0,30,CANDY HEARTS,Bag
Rio King,23RK71413153,05/09/2024,Sale,-116.0,616.0,30,CANDY HEARTS,Bag
Rio King,23RK71413153,05/09/2024,Sale,-85.0,531.0,30,COTTON CANDY,Bag
Rio King,23RK71413153,05/20/2024,Sale,-67.0,464.0,41,COTTON CANDY,Bag
Rio King,23RK71413153,06/07/2024,Sale,-2.0,462.0,59,SWEETCELEBRATION,Bag
Rio King,23RK71413154,04/09/2024,Entry,80.0,80.0,0,COTTON CANDY,Bag
Rio King,23RK71413154,04/23/2024,Sale,-80.0,0.0,14,COTTON CANDY,Bag
Rio King,23RK83841112,04/01/2024,Entry,300.0,300.0,0,SWEET FAVORS,Bag
Rio King,23RK83841112,04/01/2024,Entry,340.0,640.0,0,SWEET FAVORS,Bag
Rio King,23RK83841112,04/01/2024,Entry,910.0,1550.0,0,SWEET FAVORS,Bag
Rio King,23RK83841112,04/15/2024,Sale,-300.0,1250.0,14,SWEET FAVORS,Bag
Rio King,23RK83841112,04/15/2024,Sale,-170.0,1080.0,14,SWEET FAVORS,Bag
Rio King,23RK83841112,04/18/2024,Sale,-85.0,995.0,17,SWEET FAVORS,Bag
Rio King,23RK83841112,04/30/2024,Sale,-85.0,910.0,29,SWEET FAVORS,Bag
Rio King,23RK83841112,05/02/2024,Sale,-910.0,0.0,31,SWEET FAVORS,Bag
Rio King,23RKU9181500,03/22/2024,Entry,1900.0,1900.0,0,SWEET FAVORS,Bag
Rio King,23RKU9181500,03/27/2024,Sale,-285.0,1615.0,5,SWEET FAVORS,Bag
Rio King,23RKU9181500,03/28/2024,Sale,-285.0,1330.0,6,SWEET FAVORS,Bag
Rio King,23RKU9181500,03/28/2024,Sale,-475.0,855.0,6,SWEET FAVORS,Bag
Rio King,23RKU9181500,03/29/2024,Sale,-475.0,380.0,7,SWEET FAVORS,Bag
Rio King,23RKU9181500,03/29/2024,Sale,-285.0,95.0,7,SWEET FAVORS,Bag
Rio King,23RKU9181500,04/02/2024,Sale,-95.0,0.0,11,SWEET FAVORS,Bag
Rio King,APRU6137018,03/21/2024,Entry,1235.0,1235.0,0,TIMPSON,Bag
Rio King,APRU6137018,03/21/2024,Entry,570.0,1805.0,0,TIMPSON,Bag
Rio King,APRU6137018,03/21/2024,Entry,95.0,1900.0,0,TIMPSON,Bag
Rio King,APRU6137018,03/27/2024,Sale,-95.0,1805.0,6,TIMPSON,Bag
Rio King,APRU6137018,03/27/2024,Sale,-950.0,855.0,6,TIMPSON,Bag
Rio King,APRU6137018,03/28/2024,Sale,-95.0,760.0,7,TIMPSON,Bag
Rio King,APRU6137018,03/29/2024,Sale,-285.0,475.0,8,TIMPSON,Bag
Rio King,APRU6137018,04/02/2024,Sale,-475.0,0.0,12,TIMPSON,Bag
Rio King,BMOU9248181,04/10/2024,Entry,595.0,595.0,0,SWEET GLOBE,Clam
Rio King,BMOU9248181,04/10/2024,Entry,255.0,850.0,0,SWEET GLOBE,Clam
Rio King,BMOU9248181,04/10/2024,Entry,425.0,1275.0,0,SWEET GLOBE,Clam
Rio King,BMOU9248181,04/10/2024,Entry,425.0,1700.0,0,SWEET GLOBE,Clam
Rio King,BMOU9248181,04/22/2024,Sale,-340.0,1360.0,12,SWEET GLOBE,Clam
Rio King,BMOU9248181,04/25/2024,Sale,-510.0,850.0,15,SWEET GLOBE,Clam
Rio King,BMOU9248181,05/08/2024,Sale,-170.0,680.0,28,SWEET GLOBE,Bag
Rio King,BMOU9248181,05/10/2024,Sale,-255.0,425.0,30,SWEET GLOBE,Bag
Rio King,BMOU9248181,05/13/2024,Sale,-85.0,340.0,33,SWEET GLOBE,Bag
Rio King,BMOU9248181,05/14/2024,Sale,-170.0,170.0,34,SWEET GLOBE,Bag
Rio King,BMOU9248181,05/15/2024,Sale,-170.0,0.0,35,SWEET GLOBE,Bag
Rio King,BMOU9294736,03/22/2024,Entry,1140.0,1140.0,0,SWEETCELEBRATION,Bag
Rio King,BMOU9294736,03/22/2024,Entry,760.0,1900.0,0,SWEETCELEBRATION,Bag
Rio King,BMOU9294736,03/28/2024,Sale,-190.0,1710.0,6,SWEETCELEBRATION,Bag
Rio King,BMOU9294736,03/28/2024,Sale,-285.0,1425.0,6,SWEETCELEBRATION,Bag
Rio King,BMOU9294736,03/29/2024,Sale,-1045.0,380.0,7,SWEETCELEBRATION,Bag
Rio King,BMOU9294736,03/29/2024,Sale,-95.0,285.0,7,SWEETCELEBRATION,Bag
Rio King,BMOU9294736,03/31/2024,Sale,-285.0,0.0,9,SWEETCELEBRATION,Bag
Rio King,BMOU9336641,03/22/2024,Entry,1615.0,1615.0,0,SWEETCELEBRATION,Bag
Rio King,BMOU9336641,03/22/2024,Entry,285.0,1900.0,0,SWEETCELEBRATION,Bag
Rio King,BMOU9336641,03/28/2024,Sale,-285.0,1615.0,6,SWEETCELEBRATION,Bag
Rio King,BMOU9336641,03/28/2024,Sale,-570.0,1045.0,6,SWEETCELEBRATION,Bag
Rio King,BMOU9336641,03/29/2024,Sale,-190.0,855.0,7,SWEETCELEBRATION,Bag
Rio King,BMOU9336641,03/29/2024,Sale,-95.0,760.0,7,SWEETCELEBRATION,Bag
Rio King,BMOU9336641,03/31/2024,Sale,-665.0,95.0,9,SWEETCELEBRATION,Bag
Rio King,BMOU9336641,04/02/2024,Sale,-95.0,0.0,11,SWEETCELEBRATION,Bag
Rio King,BMOU9612360,03/13/2024,Entry,190.0,190.0,0,SWEET GLOBE,Bag
Rio King,BMOU9612360,03/13/2024,Entry,380.0,570.0,0,SWEET GLOBE,Bag
Rio King,BMOU9612360,03/13/2024,Entry,864.0,1434.0,0,SWEET GLOBE,Bag
Rio King,BMOU9612360,03/13/2024,Entry,95.0,1529.0,0,TIMPSON,Bag
Rio King,BMOU9612360,03/13/2024,Entry,475.0,2004.0,0,TIMPSON,Bag
Rio King,BMOU9612360,03/16/2024,Sale,-190.0,1814.0,3,SWEET GLOBE,Bag
Rio King,BMOU9612360,03/18/2024,Sale,-216.0,1598.0,5,SWEET GLOBE,Bag
Rio King,BMOU9612360,03/18/2024,Sale,-285.0,1313.0,5,TIMPSON,Bag
Rio King,BMOU9612360,03/18/2024,Sale,-95.0,1218.0,5,TIMPSON,Bag
Rio King,BMOU9612360,03/20/2024,Sale,-380.0,838.0,7,SWEET GLOBE,Bag
Rio King,BMOU9612360,03/21/2024,Sale,-648.0,190.0,8,SWEET GLOBE,Bag
Rio King,BMOU9612360,03/22/2024,Sale,-190.0,0.0,9,TIMPSON,Bag
Rio King,BMOU9657214,03/22/2024,Entry,790.0,790.0,0,TIMPSON,Clam
Rio King,BMOU9657214,03/22/2024,Entry,830.0,1620.0,0,TIMPSON,Clam
Rio King,BMOU9657214,03/27/2024,Sale,-830.0,790.0,5,TIMPSON,Clam
Rio King,BMOU9657214,03/27/2024,Sale,-8.0,782.0,5,TIMPSON,Clam
Rio King,BMOU9657214,03/27/2024,Sale,-782.0,0.0,5,TIMPSON,Clam
Rio King,CRSU6136449,03/13/2024,Sale,-1235.0,-1235.0,0,TIMPSON,Bag
Rio King,CRSU6136449,03/13/2024,Sale,-285.0,-1520.0,0,TIMPSON,Bag
Rio King,CRSU6136449,03/13/2024,Sale,-285.0,-1805.0,0,TIMPSON,Bag
Rio King,CRSU6136449,03/14/2024,Entry,380.0,-1425.0,1,TIMPSON,Bag
Rio King,CRSU6136449,03/14/2024,Entry,1235.0,-190.0,1,TIMPSON,Bag
Rio King,CRSU6136449,03/14/2024,Entry,285.0,95.0,1,TIMPSON,Bag
Rio King,CRSU6136449,03/15/2024,Sale,-95.0,0.0,2,TIMPSON,Bag
Rio King,CXRU1073820,03/22/2024,Entry,1330.0,1330.0,0,TIMPSON,Bag
Rio King,CXRU1073820,03/22/2024,Entry,570.0,1900.0,0,TIMPSON,Bag
Rio King,CXRU1073820,03/27/2024,Sale,-95.0,1805.0,5,TIMPSON,Bag
Rio King,CXRU1073820,03/28/2024,Sale,-95.0,1710.0,6,TIMPSON,Bag
Rio King,CXRU1073820,03/29/2024,Sale,-285.0,1425.0,7,TIMPSON,Bag
Rio King,CXRU1073820,03/29/2024,Sale,-285.0,1140.0,7,TIMPSON,Bag
Rio King,CXRU1073820,03/30/2024,Sale,-950.0,190.0,8,TIMPSON,Bag
Rio King,CXRU1073820,04/02/2024,Sale,-190.0,0.0,11,TIMPSON,Bag
Rio King,CXRU1431991,03/20/2024,Entry,1900.0,1900.0,0,ALLISON,Bag
Rio King,CXRU1431991,03/27/2024,Sale,-950.0,950.0,7,ALLISON,Bag
Rio King,CXRU1431991,03/30/2024,Sale,-950.0,0.0,10,ALLISON,Bag
Rio King,CXRU1452314,03/15/2024,Entry,95.0,95.0,0,ALLISON,Bag
Rio King,CXRU1452314,03/15/2024,Entry,1805.0,1900.0,0,ALLISON,Bag
Rio King,CXRU1452314,03/16/2024,Sale,-760.0,1140.0,1,ALLISON,Bag
Rio King,CXRU1452314,03/22/2024,Sale,-95.0,1045.0,7,ALLISON,Bag
Rio King,CXRU1452314,03/23/2024,Sale,-1045.0,0.0,8,ALLISON,Bag
Rio King,CXRU1581292,03/23/2024,Entry,1520.0,1520.0,0,SWEET FAVORS,Bag
Rio King,CXRU1581292,03/23/2024,Entry,380.0,1900.0,0,SWEET FAVORS,Bag
Rio King,CXRU1581292,04/05/2024,Sale,-285.0,1615.0,13,SWEET FAVORS,Bag
Rio King,CXRU1581292,04/15/2024,Sale,-285.0,1330.0,23,SWEET FAVORS,Bag
Rio King,CXRU1581292,04/20/2024,Sale,-95.0,1235.0,28,SWEET FAVORS,Bag
Rio King,CXRU1581292,04/20/2024,Sale,-285.0,950.0,28,SWEET FAVORS,Bag
Rio King,CXRU1581292,04/22/2024,Sale,-95.0,855.0,30,SWEET FAVORS,Bag
Rio King,CXRU1581292,04/23/2024,Sale,-380.0,475.0,31,SWEET FAVORS,Bag
Rio King,CXRU1581292,04/25/2024,Sale,-380.0,95.0,33,SWEET FAVORS,Bag
Rio King,CXRU1581292,04/25/2024,Sale,-95.0,0.0,33,SWEET FAVORS,Bag
Rio King,FSCU5771313,03/24/2024,Entry,1900.0,1900.0,0,SWEET FAVORS,Bag
Rio King,FSCU5771313,04/12/2024,Sale,-665.0,1235.0,19,SWEET FAVORS,Bag
Rio King,FSCU5771313,04/29/2024,Sale,-95.0,1140.0,36,SWEET FAVORS,Bag
Rio King,FSCU5771313,05/02/2024,Sale,-1140.0,0.0,39,SWEET FAVORS,Bag
Rio King,GESU9430840,04/10/2024,Entry,475.0,475.0,0,SWEETCELEBRATION,Bag
Rio King,GESU9430840,04/10/2024,Entry,1275.0,1750.0,0,SWEETCELEBRATION,Bag
Rio King,GESU9430840,04/19/2024,Sale,-95.0,1655.0,9,SWEETCELEBRATION,Bag
Rio King,GESU9430840,04/22/2024,Sale,-1020.0,635.0,12,SWEETCELEBRATION,Clam
Rio King,GESU9430840,04/23/2024,Sale,-380.0,255.0,13,SWEETCELEBRATION,Bag
Rio King,GESU9430840,04/25/2024,Sale,-255.0,0.0,15,SWEETCELEBRATION,Clam
Rio King,GESU9543030,03/08/2024,Entry,380.0,380.0,0,TIMPSON,Bag
Rio King,GESU9543030,03/08/2024,Entry,1235.0,1615.0,0,TIMPSON,Bag
Rio King,GESU9543030,03/08/2024,Entry,285.0,1900.0,0,TIMPSON,Bag
Rio King,GESU9543030,03/09/2024,Sale,-380.0,1520.0,1,TIMPSON,Bag
Rio King,GESU9543030,03/09/2024,Sale,-950.0,570.0,1,TIMPSON,Bag
Rio King,GESU9543030,03/09/2024,Sale,-95.0,475.0,1,TIMPSON,Bag
Rio King,GESU9543030,03/09/2024,Sale,-190.0,285.0,1,TIMPSON,Bag
Rio King,GESU9543030,03/09/2024,Sale,-285.0,0.0,1,TIMPSON,Bag
Rio King,MEDU9713371,03/13/2024,Entry,765.0,765.0,0,JACK SALUTE,Clam
Rio King,MEDU9713371,03/13/2024,Entry,935.0,1700.0,0,JACK SALUTE,Clam
Rio King,MEDU9713371,03/21/2024,Sale,-255.0,1445.0,8,JACK SALUTE,Clam
Rio King,MEDU9713371,03/21/2024,Sale,-510.0,935.0,8,JACK SALUTE,Clam
Rio King,MEDU9713371,03/21/2024,Sale,-850.0,85.0,8,JACK SALUTE,Clam
Rio King,MEDU9713371,03/21/2024,Sale,-85.0,0.0,8,JACK SALUTE,Clam
Rio King,MEDU9729315,03/13/2024,Entry,2160.0,2160.0,0,SWEET GLOBE,Bag
Rio King,MEDU9729315,03/21/2024,Sale,-1512.0,648.0,8,SWEET GLOBE,Bag
Rio King,MEDU9729315,03/23/2024,Sale,-648.0,0.0,10,SWEET GLOBE,Bag
Rio King,MEDU9817904,03/24/2024,Entry,1900.0,1900.0,0,ALLISON,Bag
Rio King,MEDU9817904,04/01/2024,Sale,-950.0,950.0,8,ALLISON,Bag
Rio King,MEDU9817904,04/01/2024,Sale,-285.0,665.0,8,ALLISON,Bag
Rio King,MEDU9817904,04/03/2024,Sale,-475.0,190.0,10,ALLISON,Bag
Rio King,MEDU9817904,04/03/2024,Sale,-190.0,0.0,10,ALLISON,Bag
Rio King,MSDU9018253,03/24/2024,Entry,1900.0,1900.0,0,SWEET FAVORS,Bag
Rio King,MSDU9018253,04/13/2024,Sale,-855.0,1045.0,20,SWEET FAVORS,Bag
Rio King,MSDU9018253,04/15/2024,Sale,-95.0,950.0,22,SWEET FAVORS,Bag
Rio King,MSDU9018253,04/20/2024,Sale,-285.0,665.0,27,SWEET FAVORS,Bag
Rio King,MSDU9018253,04/25/2024,Sale,-285.0,380.0,32,SWEET FAVORS,Bag
Rio King,MSDU9018253,04/25/2024,Sale,-285.0,95.0,32,SWEET FAVORS,Bag
Rio King,MSDU9018253,04/25/2024,Sale,-95.0,0.0,32,SWEET FAVORS,Bag
Rio King,MSDU9029772,03/18/2024,Entry,1700.0,1700.0,0,COTTON CANDY,Bag
Rio King,MSDU9029772,03/28/2024,Sale,-85.0,1615.0,10,COTTON CANDY,Bag
Rio King,MSDU9029772,03/30/2024,Sale,-85.0,1530.0,12,COTTON CANDY,Bag
Rio King,MSDU9029772,04/04/2024,Sale,-170.0,1360.0,17,COTTON CANDY,Bag
Rio King,MSDU9029772,04/05/2024,Sale,-559.0,801.0,18,GREEN SEEDLESS,Clam
Rio King,MSDU9029772,04/06/2024,Sale,-85.0,716.0,19,COTTON CANDY,Bag
Rio King,MSDU9029772,04/12/2024,Sale,-160.0,556.0,25,GREEN SEEDLESS,Clam
Rio King,MSDU9029772,04/23/2024,Sale,-23.0,533.0,36,GREEN SEEDLESS,Clam
Rio King,MSDU9029772,05/20/2024,Sale,-2.0,531.0,63,GREEN SEEDLESS,Clam
Rio King,MSDU9823247,03/15/2024,Entry,380.0,380.0,0,ALLISON,Bag
Rio King,MSDU9823247,03/15/2024,Entry,95.0,475.0,0,SWEET FAVORS,Bag
Rio King,MSDU9823247,03/15/2024,Entry,380.0,855.0,0,SWEET FAVORS,Bag
Rio King,MSDU9823247,03/15/2024,Entry,190.0,1045.0,0,SWEET FAVORS,Bag
Rio King,MSDU9823247,03/15/2024,Entry,380.0,1425.0,0,SWEETCELEBRATION,Bag
Rio King,MSDU9823247,03/15/2024,Entry,190.0,1615.0,0,SWEETCELEBRATION,Bag
Rio King,MSDU9823247,03/15/2024,Entry,285.0,1900.0,0,SWEETCELEBRATION,Bag
Rio King,MSDU9823247,03/16/2024,Sale,-190.0,1710.0,1,ALLISON,Bag
Rio King,MSDU9823247,03/16/2024,Sale,-95.0,1615.0,1,SWEETCELEBRATION,Bag
Rio King,MSDU9823247,03/18/2024,Sale,-95.0,1520.0,3,SWEET FAVORS,Bag
Rio King,MSDU9823247,03/19/2024,Sale,-85.0,1435.0,4,SWEET FAVORS,Bag
Rio King,MSDU9823247,03/20/2024,Sale,-95.0,1340.0,5,SWEET FAVORS,Bag
Rio King,MSDU9823247,03/20/2024,Sale,-95.0,1245.0,5,SWEET FAVORS,Bag
Rio King,MSDU9823247,03/21/2024,Sale,-95.0,1150.0,6,SWEETCELEBRATION,Bag
Rio King,MSDU9823247,03/21/2024,Sale,-285.0,865.0,6,SWEETCELEBRATION,Bag
Rio King,MSDU9823247,03/21/2024,Sale,-95.0,770.0,6,SWEETCELEBRATION,Bag
Rio King,MSDU9823247,03/22/2024,Sale,-190.0,580.0,7,SWEET FAVORS,Bag
Rio King,MSDU9823247,03/22/2024,Sale,-285.0,295.0,7,SWEETCELEBRATION,Bag
Rio King,MSDU9823247,03/23/2024,Sale,-190.0,105.0,8,ALLISON,Bag
Rio King,MSDU9823247,03/23/2024,Sale,-95.0,10.0,8,SWEET FAVORS,Bag
Rio King,MSDU9823247,05/15/2024,Sale,-10.0,0.0,61,SWEET FAVORS,Bag
Rio King,OTPU6374396,03/30/2024,Entry,1615.0,1615.0,0,JACK SALUTE,Bag
Rio King,OTPU6374396,03/30/2024,Entry,285.0,1900.0,0,JACK SALUTE,Bag
Rio King,OTPU6374396,04/09/2024,Sale,-570.0,1330.0,10,JACK SALUTE,Bag
Rio King,OTPU6374396,04/09/2024,Sale,-570.0,760.0,10,JACK SALUTE,Bag
Rio King,OTPU6374396,04/09/2024,Sale,-190.0,570.0,10,JACK SALUTE,Bag
Rio King,OTPU6374396,04/09/2024,Sale,-95.0,475.0,10,JACK SALUTE,Bag
Rio King,OTPU6374396,04/12/2024,Sale,-190.0,285.0,13,JACK SALUTE,Bag
Rio King,OTPU6374396,04/12/2024,Sale,-190.0,95.0,13,JACK SALUTE,Bag
Rio King,OTPU6374396,04/18/2024,Sale,-95.0,0.0,19,JACK SALUTE,Bag
Rio King,OTPU6375284,03/17/2024,Entry,285.0,285.0,0,SWEETCELEBRATION,Bag
Rio King,OTPU6375284,03/17/2024,Entry,1615.0,1900.0,0,SWEETCELEBRATION,Bag
Rio King,OTPU6375284,03/19/2024,Sale,-380.0,1520.0,2,SWEETCELEBRATION,Bag
Rio King,OTPU6375284,03/19/2024,Sale,-570.0,950.0,2,SWEETCELEBRATION,Bag
Rio King,OTPU6375284,03/20/2024,Sale,-95.0,855.0,3,SWEETCELEBRATION,Bag
Rio King,OTPU6375284,03/21/2024,Sale,-95.0,760.0,4,SWEETCELEBRATION,Bag
Rio King,OTPU6375284,03/21/2024,Sale,-475.0,285.0,4,SWEETCELEBRATION,Bag
Rio King,OTPU6375284,03/21/2024,Sale,-95.0,190.0,4,SWEETCELEBRATION,Bag
Rio King,OTPU6375284,03/22/2024,Sale,-95.0,95.0,5,SWEETCELEBRATION,Bag
Rio King,OTPU6375284,03/22/2024,Sale,-95.0,0.0,5,SWEETCELEBRATION,Bag
Rio King,OTPU6378004,02/23/2024,Entry,1900.0,1900.0,0,SWEETCELEBRATION,Bag
Rio King,OTPU6378004,02/26/2024,Sale,-855.0,1045.0,3,SWEETCELEBRATION,Bag
Rio King,OTPU6378004,02/26/2024,Sale,-855.0,190.0,3,SWEETCELEBRATION,Bag
Rio King,OTPU6378004,02/26/2024,Sale,-190.0,0.0,3,SWEETCELEBRATION,Bag
Rio King,OTPU6514380,03/24/2024,Entry,90.0,90.0,0,ALLISON,Bag
Rio King,OTPU6514380,03/24/2024,Entry,540.0,630.0,0,ALLISON,Bag
Rio King,OTPU6514380,03/24/2024,Entry,1235.0,1865.0,0,JACK SALUTE,Bag
Rio King,OTPU6514380,04/06/2024,Sale,-270.0,1595.0,13,ALLISON,Bag
Rio King,OTPU6514380,04/08/2024,Sale,-190.0,1405.0,15,JACK SALUTE,Bag
Rio King,OTPU6514380,04/09/2024,Sale,-285.0,1120.0,16,JACK SALUTE,Bag
Rio King,OTPU6514380,04/10/2024,Sale,-475.0,645.0,17,JACK SALUTE,Bag
Rio King,OTPU6514380,04/11/2024,Sale,-285.0,360.0,18,JACK SALUTE,Bag
Rio King,OTPU6514380,04/12/2024,Sale,-90.0,270.0,19,ALLISON,Bag
Rio King,OTPU6514380,04/12/2024,Sale,-180.0,90.0,19,ALLISON,Bag
Rio King,OTPU6514380,04/13/2024,Sale,-90.0,0.0,20,ALLISON,Bag
Rio King,SEGU9088732,03/22/2024,Entry,255.0,255.0,0,SWEETCELEBRATION,Clam
Rio King,SEGU9088732,03/22/2024,Entry,1445.0,1700.0,0,SWEETCELEBRATION,Clam
Rio King,SEGU9088732,03/27/2024,Sale,-765.0,935.0,5,SWEETCELEBRATION,Clam
Rio King,SEGU9088732,03/28/2024,Sale,-595.0,340.0,6,SWEETCELEBRATION,Clam
Rio King,SEGU9088732,03/29/2024,Sale,-85.0,255.0,7,SWEETCELEBRATION,Clam
Rio King,SEGU9088732,03/29/2024,Sale,-255.0,0.0,7,SWEETCELEBRATION,Clam
Rio King,SEGU9122272,03/20/2024,Entry,1900.0,1900.0,0,JACK SALUTE,Bag
Rio King,SEGU9122272,03/25/2024,Sale,-950.0,950.0,5,JACK SALUTE,Bag
Rio King,SEGU9122272,03/26/2024,Sale,-190.0,760.0,6,JACK SALUTE,Bag
Rio King,SEGU9122272,03/27/2024,Sale,-760.0,0.0,7,JACK SALUTE,Bag
Rio King,SEGU9283430,03/18/2024,Entry,1235.0,1235.0,0,ALLISON,Bag
Rio King,SEGU9283430,03/18/2024,Entry,665.0,1900.0,0,JACK SALUTE,Bag
Rio King,SEGU9283430,03/20/2024,Sale,-380.0,1520.0,2,ALLISON,Bag
Rio King,SEGU9283430,03/20/2024,Sale,-190.0,1330.0,2,ALLISON,Bag
Rio King,SEGU9283430,03/21/2024,Sale,-190.0,1140.0,3,ALLISON,Bag
Rio King,SEGU9283430,03/21/2024,Sale,-380.0,760.0,3,ALLISON,Bag
Rio King,SEGU9283430,03/21/2024,Sale,-95.0,665.0,3,ALLISON,Bag
Rio King,SEGU9283430,03/21/2024,Sale,-190.0,475.0,3,JACK SALUTE,Bag
Rio King,SEGU9283430,03/22/2024,Sale,-285.0,190.0,4,JACK SALUTE,Bag
Rio King,SEGU9283430,03/23/2024,Sale,-190.0,0.0,5,JACK SALUTE,Bag
Rio King,SEGU9296438,03/15/2024,Entry,95.0,95.0,0,ALLISON,Bag
Rio King,SEGU9296438,03/15/2024,Entry,570.0,665.0,0,ALLISON,Bag
Rio King,SEGU9296438,03/15/2024,Entry,475.0,1140.0,0,SWEET FAVORS,Bag
Rio King,SEGU9296438,03/15/2024,Entry,190.0,1330.0,0,SWEET FAVORS,Bag
Rio King,SEGU9296438,03/15/2024,Entry,570.0,1900.0,0,SWEET FAVORS,Bag
Rio King,SEGU9296438,03/18/2024,Sale,-95.0,1805.0,3,SWEET FAVORS,Bag
Rio King,SEGU9296438,03/20/2024,Sale,-380.0,1425.0,5,SWEET FAVORS,Bag
Rio King,SEGU9296438,03/20/2024,Sale,-190.0,1235.0,5,SWEET FAVORS,Bag
Rio King,SEGU9296438,03/22/2024,Sale,-95.0,1140.0,7,ALLISON,Bag
Rio King,SEGU9296438,03/23/2024,Sale,-570.0,570.0,8,ALLISON,Bag
Rio King,SEGU9296438,03/25/2024,Sale,-285.0,285.0,10,SWEET FAVORS,Bag
Rio King,SEGU9296438,03/29/2024,Sale,-95.0,190.0,14,SWEET FAVORS,Bag
Rio King,SEGU9296438,04/02/2024,Sale,-190.0,0.0,18,SWEET FAVORS,Bag
Rio King,SEGU9302119,03/22/2024,Entry,665.0,665.0,0,TIMPSON,Bag
Rio King,SEGU9302119,03/22/2024,Entry,1140.0,1805.0,0,TIMPSON,Bag
Rio King,SEGU9302119,03/22/2024,Entry,95.0,1900.0,0,TIMPSON,Bag
Rio King,SEGU9302119,03/27/2024,Sale,-475.0,1425.0,5,TIMPSON,Bag
Rio King,SEGU9302119,03/28/2024,Sale,-95.0,1330.0,6,TIMPSON,Bag
Rio King,SEGU9302119,03/28/2024,Sale,-665.0,665.0,6,TIMPSON,Bag
Rio King,SEGU9302119,03/29/2024,Sale,-475.0,190.0,7,TIMPSON,Bag
Rio King,SEGU9302119,04/02/2024,Sale,-190.0,0.0,11,TIMPSON,Bag
Rio King,SEGU9434244,03/20/2024,Entry,950.0,950.0,0,SWEET FAVORS,Bag
Rio King,SEGU9434244,03/20/2024,Entry,950.0,1900.0,0,SWEET FAVORS,Bag
Rio King,SEGU9434244,03/23/2024,Sale,-95.0,1805.0,3,SWEET FAVORS,Bag
Rio King,SEGU9434244,03/25/2024,Sale,-285.0,1520.0,5,SWEET FAVORS,Bag
Rio King,SEGU9434244,03/28/2024,Sale,-475.0,1045.0,8,SWEET FAVORS,Bag
Rio King,SEGU9434244,03/28/2024,Sale,-285.0,760.0,8,SWEET FAVORS,Bag
Rio King,SEGU9434244,03/28/2024,Sale,-95.0,665.0,8,SWEET FAVORS,Bag
Rio King,SEGU9434244,04/02/2024,Sale,-190.0,475.0,13,SWEET FAVORS,Bag
Rio King,SEGU9434244,04/09/2024,Sale,-190.0,285.0,20,SWEET FAVORS,Bag
Rio King,SEGU9434244,04/12/2024,Sale,-95.0,190.0,23,SWEET FAVORS,Bag
Rio King,SEGU9434244,04/18/2024,Sale,-95.0,95.0,29,SWEET FAVORS,Bag
Rio King,SEGU9434244,04/29/2024,Sale,-95.0,0.0,40,SWEET FAVORS,Bag
Rio King,SEGU9468922,03/30/2024,Entry,380.0,380.0,0,JACK SALUTE,Bag
Rio King,SEGU9468922,03/30/2024,Entry,1520.0,1900.0,0,JACK SALUTE,Bag
Rio King,SEGU9468922,04/09/2024,Sale,-380.0,1520.0,10,JACK SALUTE,Bag
Rio King,SEGU9468922,04/09/2024,Sale,-950.0,570.0,10,JACK SALUTE,Bag
Rio King,SEGU9468922,04/09/2024,Sale,-190.0,380.0,10,JACK SALUTE,Bag
Rio King,SEGU9468922,04/09/2024,Sale,-380.0,0.0,10,JACK SALUTE,Bag
Rio King,SEGU9476342,03/30/2024,Entry,425.0,425.0,0,SWEET GLOBE,Bag
Rio King,SEGU9476342,03/30/2024,Entry,190.0,615.0,0,SWEETCELEBRATION,Bag
Rio King,SEGU9476342,03/30/2024,Entry,85.0,700.0,0,SWEETCELEBRATION,Bag
Rio King,SEGU9476342,03/30/2024,Entry,255.0,955.0,0,SWEETCELEBRATION,Bag
Rio King,SEGU9476342,03/30/2024,Entry,665.0,1620.0,0,TIMPSON,Bag
Rio King,SEGU9476342,03/30/2024,Entry,95.0,1715.0,0,TIMPSON,Bag
Rio King,SEGU9476342,03/30/2024,Entry,95.0,1810.0,0,TIMPSON,Bag
Rio King,SEGU9476342,04/09/2024,Sale,-340.0,1470.0,10,SWEET GLOBE,Bag
Rio King,SEGU9476342,04/09/2024,Sale,-190.0,1280.0,10,SWEETCELEBRATION,Bag
Rio King,SEGU9476342,04/09/2024,Sale,-95.0,1185.0,10,TIMPSON,Bag
Rio King,SEGU9476342,04/09/2024,Sale,-95.0,1090.0,10,TIMPSON,Bag
Rio King,SEGU9476342,04/09/2024,Sale,-190.0,900.0,10,TIMPSON,Bag
Rio King,SEGU9476342,04/11/2024,Sale,-85.0,815.0,12,SWEET GLOBE,Bag
Rio King,SEGU9476342,04/15/2024,Sale,-95.0,720.0,16,TIMPSON,Bag
Rio King,SEGU9476342,04/22/2024,Sale,-255.0,465.0,23,SWEETCELEBRATION,Clam
Rio King,SEGU9476342,04/22/2024,Sale,-85.0,380.0,23,SWEETCELEBRATION,Clam
Rio King,SEGU9476342,04/22/2024,Sale,-285.0,95.0,23,TIMPSON,Bag
Rio King,SEGU9476342,04/22/2024,Sale,-95.0,0.0,23,TIMPSON,Bag
Rio King,SEGU9622637,03/30/2024,Entry,1020.0,1020.0,0,CANDY HEARTS,Bag
Rio King,SEGU9622637,03/30/2024,Entry,85.0,1105.0,0,CANDY HEARTS,Bag
Rio King,SEGU9622637,03/30/2024,Entry,595.0,1700.0,0,CANDY HEARTS,Bag
Rio King,SEGU9622637,04/01/2024,Sale,-170.0,1530.0,2,CANDY HEARTS,Bag
Rio King,SEGU9622637,04/04/2024,Sale,-85.0,1445.0,5,CANDY HEARTS,Bag
Rio King,SEGU9622637,04/04/2024,Sale,-170.0,1275.0,5,CANDY HEARTS,Bag
Rio King,SEGU9622637,04/04/2024,Sale,-85.0,1190.0,5,CANDY HEARTS,Bag
Rio King,SEGU9622637,04/10/2024,Sale,-255.0,935.0,11,CANDY HEARTS,Bag
Rio King,SEGU9622637,04/11/2024,Sale,-96.0,839.0,12,CANDY HEARTS,Bag
Rio King,SEGU9622637,04/12/2024,Sale,-510.0,329.0,13,CANDY HEARTS,Bag
Rio King,SEGU9622637,04/12/2024,Sale,-85.0,244.0,13,CANDY HEARTS,Bag
Rio King,SEGU9622637,04/12/2024,Sale,-170.0,74.0,13,CANDY HEARTS,Bag
Rio King,SEGU9623211,02/24/2024,Sale,-1045.0,-1045.0,0,SWEETCELEBRATION,Bag
Rio King,SEGU9623211,02/24/2024,Sale,-855.0,-1900.0,0,SWEETCELEBRATION,Bag
Rio King,SEGU9623211,03/04/2024,Entry,1045.0,-855.0,9,SWEETCELEBRATION,Bag
Rio King,SEGU9623211,03/04/2024,Entry,855.0,0.0,9,SWEETCELEBRATION,Bag
Rio King,SEGU9630550,03/30/2024,Entry,765.0,765.0,0,CANDY HEARTS,Bag
Rio King,SEGU9630550,03/30/2024,Entry,510.0,1275.0,0,CANDY HEARTS,Bag
Rio King,SEGU9630550,03/30/2024,Entry,425.0,1700.0,0,CANDY HEARTS,Bag
Rio King,SEGU9630550,04/01/2024,Sale,-170.0,1530.0,2,CANDY HEARTS,Bag
Rio King,SEGU9630550,04/03/2024,Sale,-170.0,1360.0,4,CANDY HEARTS,Bag
Rio King,SEGU9630550,04/03/2024,Sale,-595.0,765.0,4,CANDY HEARTS,Bag
Rio King,SEGU9630550,04/04/2024,Sale,-85.0,680.0,5,CANDY HEARTS,Bag
Rio King,SEGU9630550,04/04/2024,Sale,-425.0,255.0,5,CANDY HEARTS,Bag
Rio King,SEGU9630550,04/04/2024,Sale,-170.0,85.0,5,CANDY HEARTS,Bag
Rio King,SEGU9630550,04/11/2024,Sale,-85.0,0.0,12,CANDY HEARTS,Bag
Rio King,SZLU9006506,03/08/2024,Entry,170.0,170.0,0,SWEETCELEBRATION,Unknown
Rio King,SZLU9006506,03/08/2024,Entry,380.0,550.0,0,SWEETCELEBRATION,Unknown
Rio King,SZLU9006506,03/08/2024,Entry,1320.0,1870.0,0,SWEETCELEBRATION,Unknown
Rio King,SZLU9006506,03/09/2024,Sale,-285.0,1585.0,1,SWEETCELEBRATION,Unknown
Rio King,SZLU9006506,03/09/2024,Sale,-170.0,1415.0,1,SWEETCELEBRATION,Unknown
Rio King,SZLU9006506,03/09/2024,Sale,-285.0,1130.0,1,SWEETCELEBRATION,Unknown
Rio King,SZLU9006506,03/10/2024,Sale,-190.0,940.0,2,SWEETCELEBRATION,Unknown
Rio King,SZLU9006506,03/11/2024,Sale,-190.0,750.0,3,SWEETCELEBRATION,Unknown
Rio King,SZLU9006506,03/11/2024,Sale,-190.0,560.0,3,SWEETCELEBRATION,Unknown
Rio King,SZLU9006506,03/13/2024,Sale,-180.0,380.0,5,SWEETCELEBRATION,Unknown
Rio King,SZLU9006506,03/13/2024,Sale,-95.0,285.0,5,SWEETCELEBRATION,Unknown
Rio King,SZLU9006506,03/19/2024,Sale,-95.0,190.0,11,SWEETCELEBRATION,Unknown
Rio King,SZLU9006506,03/19/2024,Sale,-190.0,0.0,11,SWEETCELEBRATION,Unknown
Rio King,SZLU9266421,03/24/2024,Entry,1530.0,1530.0,0,CANDY HEARTS,Unknown
Rio King,SZLU9266421,03/24/2024,Entry,170.0,1700.0,0,CANDY HEARTS,Unknown
Rio King,SZLU9266421,03/30/2024,Sale,-850.0,850.0,6,CANDY HEARTS,Unknown
Rio King,SZLU9266421,03/30/2024,Sale,-255.0,595.0,6,CANDY HEARTS,Unknown
Rio King,SZLU9266421,03/30/2024,Sale,-255.0,340.0,6,CANDY HEARTS,Unknown
Rio King,SZLU9266421,04/01/2024,Sale,-170.0,170.0,8,CANDY HEARTS,Unknown
Rio King,SZLU9266421,04/03/2024,Sale,-85.0,85.0,10,CANDY HEARTS,Unknown
Rio King,SZLU9266421,04/12/2024,Sale,-85.0,0.0,19,CANDY HEARTS,Unknown
Rio King,SZLU9332267,03/18/2024,Entry,1425.0,1425.0,0,ALLISON,Unknown
Rio King,SZLU9332267,03/18/2024,Entry,190.0,1615.0,0,SWEET FAVORS,Unknown
Rio King,SZLU9332267,03/18/2024,Entry,285.0,1900.0,0,SWEET FAVORS,Unknown
Rio King,SZLU9332267,03/22/2024,Sale,-570.0,1330.0,4,ALLISON,Unknown
Rio King,SZLU9332267,03/23/2024,Sale,-475.0,855.0,5,ALLISON,Unknown
Rio King,SZLU9332267,03/25/2024,Sale,-285.0,570.0,7,ALLISON,Unknown
Rio King,SZLU9332267,03/26/2024,Sale,-95.0,475.0,8,ALLISON,Unknown
Rio King,SZLU9332267,04/03/2024,Sale,-95.0,380.0,16,SWEET FAVORS,Unknown
Rio King,SZLU9332267,04/12/2024,Sale,-95.0,285.0,25,SWEET FAVORS,Unknown
Rio King,SZLU9332267,04/13/2024,Sale,-95.0,190.0,26,SWEET FAVORS,Unknown
Rio King,SZLU9332267,04/15/2024,Sale,-95.0,95.0,28,SWEET FAVORS,Unknown
Rio King,SZLU9332267,04/23/2024,Sale,-95.0,0.0,36,SWEET FAVORS,Unknown
Rio King,SZLU9517131,03/20/2024,Entry,1900.0,1900.0,0,SWEET FAVORS,Unknown
Rio King,SZLU9517131,04/03/2024,Sale,-190.0,1710.0,14,SWEET FAVORS,Unknown
Rio King,SZLU9517131,04/04/2024,Sale,-950.0,760.0,15,SWEET FAVORS,Unknown
Rio King,SZLU9517131,04/05/2024,Sale,-380.0,380.0,16,SWEET FAVORS,Unknown
Rio King,SZLU9517131,04/09/2024,Sale,-285.0,95.0,20,SWEET FAVORS,Unknown
Rio King,SZLU9517131,04/19/2024,Sale,-95.0,0.0,30,SWEET FAVORS,Unknown
Rio King,TEMU9225343,03/21/2024,Entry,665.0,665.0,0,TIMPSON,Unknown
Rio King,TEMU9225343,03/21/2024,Entry,1140.0,1805.0,0,TIMPSON,Unknown
Rio King,TEMU9225343,03/21/2024,Entry,95.0,1900.0,0,TIMPSON,Unknown
Rio King,TEMU9225343,03/26/2024,Sale,-1140.0,760.0,5,TIMPSON,Unknown
Rio King,TEMU9225343,03/26/2024,Sale,-665.0,95.0,5,TIMPSON,Unknown
Rio King,TEMU9225343,04/02/2024,Sale,-95.0,0.0,12,TIMPSON,Unknown
Rio King,TEMU9388382,03/18/2024,Entry,95.0,95.0,0,ALLISON,Unknown
Rio King,TEMU9388382,03/18/2024,Entry,95.0,190.0,0,JACK SALUTE,Unknown
Rio King,TEMU9388382,03/18/2024,Entry,285.0,475.0,0,JACK SALUTE,Unknown
Rio King,TEMU9388382,03/18/2024,Entry,475.0,950.0,0,SWEET FAVORS,Unknown
Rio King,TEMU9388382,03/18/2024,Entry,285.0,1235.0,0,SWEET FAVORS,Unknown
Rio King,TEMU9388382,03/18/2024,Entry,665.0,1900.0,0,SWEET FAVORS,Unknown
Rio King,TEMU9388382,03/25/2024,Sale,-95.0,1805.0,7,ALLISON,Unknown
Rio King,TEMU9388382,03/25/2024,Sale,-95.0,1710.0,7,JACK SALUTE,Unknown
Rio King,TEMU9388382,03/26/2024,Sale,-95.0,1615.0,8,SWEET FAVORS,Unknown
Rio King,TEMU9388382,03/26/2024,Sale,-95.0,1520.0,8,SWEET FAVORS,Unknown
Rio King,TEMU9388382,03/27/2024,Sale,-285.0,1235.0,9,JACK SALUTE,Unknown
Rio King,TEMU9388382,03/28/2024,Sale,-95.0,1140.0,10,SWEET FAVORS,Unknown
Rio King,TEMU9388382,03/28/2024,Sale,-95.0,1045.0,10,SWEET FAVORS,Unknown
Rio King,TEMU9388382,04/08/2024,Sale,-95.0,950.0,21,SWEET FAVORS,Unknown
Rio King,TEMU9388382,04/10/2024,Sale,-95.0,855.0,23,SWEET FAVORS,Unknown
Rio King,TEMU9388382,04/12/2024,Sale,-190.0,665.0,25,SWEET FAVORS,Unknown
Rio King,TEMU9388382,04/12/2024,Sale,-285.0,380.0,25,SWEET FAVORS,Unknown
Rio King,TEMU9388382,04/13/2024,Sale,-95.0,285.0,26,SWEET FAVORS,Unknown
Rio King,TEMU9388382,04/13/2024,Sale,-190.0,95.0,26,SWEET FAVORS,Unknown
Rio King,TEMU9388382,04/15/2024,Sale,-95.0,0.0,28,SWEET FAVORS,Unknown
Rio King,TRIU8020897,03/08/2024,Entry,108.0,108.0,0,TIMPSON,Unknown
Rio King,TRIU8020897,03/08/2024,Entry,1805.0,1913.0,0,TIMPSON,Unknown
Rio King,TRIU8020897,03/09/2024,Sale,-1520.0,393.0,1,TIMPSON,Unknown
Rio King,TRIU8020897,03/10/2024,Sale,-285.0,108.0,2,TIMPSON,Unknown
Rio King,TRIU8020897,03/11/2024,Sale,-108.0,0.0,3,TIMPSON,Unknown
Rio King,TRIU8756445,03/16/2024,Entry,2160.0,2160.0,0,SWEET GLOBE,Unknown
Rio King,TRIU8756445,03/20/2024,Sale,-648.0,1512.0,4,SWEET GLOBE,Unknown
Rio King,TRIU8756445,03/21/2024,Sale,-108.0,1404.0,5,SWEET GLOBE,Unknown
Rio King,TRIU8756445,03/22/2024,Sale,-864.0,540.0,6,SWEET GLOBE,Unknown
Rio King,TRIU8756445,03/26/2024,Sale,-108.0,432.0,10,SWEET GLOBE,Unknown
Rio King,TRIU8756445,03/27/2024,Sale,-216.0,216.0,11,SWEET GLOBE,Unknown
Rio King,TRIU8756445,03/27/2024,Sale,-108.0,108.0,11,SWEET GLOBE,Unknown
Rio King,TRIU8756445,03/28/2024,Sale,-108.0,0.0,12,SWEET GLOBE,Unknown
Rio King,TRIU8758725,03/08/2024,Entry,1425.0,1425.0,0,SWEETCELEBRATION,Unknown
Rio King,TRIU8758725,03/08/2024,Entry,380.0,1805.0,0,SWEETCELEBRATION,Unknown
Rio King,TRIU8758725,03/08/2024,Entry,95.0,1900.0,0,SWEETCELEBRATION,Unknown
Rio King,TRIU8758725,03/09/2024,Sale,-95.0,1805.0,1,SWEETCELEBRATION,Unknown
Rio King,TRIU8758725,03/09/2024,Sale,-190.0,1615.0,1,SWEETCELEBRATION,Unknown
Rio King,TRIU8758725,03/10/2024,Sale,-285.0,1330.0,2,SWEETCELEBRATION,Unknown
Rio King,TRIU8758725,03/11/2024,Sale,-760.0,570.0,3,SWEETCELEBRATION,Unknown
Rio King,TRIU8758725,03/11/2024,Sale,-95.0,475.0,3,SWEETCELEBRATION,Unknown
Rio King,TRIU8758725,03/12/2024,Sale,-95.0,380.0,4,SWEETCELEBRATION,Unknown
Rio King,TRIU8758725,03/13/2024,Sale,-190.0,190.0,5,SWEETCELEBRATION,Unknown
Rio King,TRIU8758725,03/19/2024,Sale,-95.0,95.0,11,SWEETCELEBRATION,Unknown
Rio King,TRIU8758725,03/19/2024,Sale,-95.0,0.0,11,SWEETCELEBRATION,Unknown
Rio King,TTNU8499086,03/18/2024,Entry,590.0,590.0,0,CANDY HEARTS,Unknown
Rio King,TTNU8499086,03/18/2024,Entry,1100.0,1690.0,0,CANDY HEARTS,Unknown
Rio King,TTNU8499086,03/21/2024,Sale,-170.0,1520.0,3,CANDY HEARTS,Unknown
Rio King,TTNU8499086,03/22/2024,Sale,-335.0,1185.0,4,CANDY HEARTS,Unknown
Rio King,TTNU8499086,03/23/2024,Sale,-850.0,335.0,5,CANDY HEARTS,Unknown
Rio King,TTNU8499086,03/26/2024,Sale,-255.0,80.0,8,CANDY HEARTS,Unknown
Rio King,TTNU8499086,04/11/2024,Sale,-80.0,0.0,24,CANDY HEARTS,Unknown
SAFCO PERU,BMOU9016062,02/29/2024,Entry,475.0,475.0,0,SUGAR CRISP,Bag
SAFCO PERU,BMOU9016062,02/29/2024,Entry,1425.0,1900.0,0,SUGAR CRISP,Bag
SAFCO PERU,BMOU9016062,03/05/2024,Sale,-95.0,1805.0,5,SUGAR CRISP,Bag
SAFCO PERU,BMOU9016062,03/06/2024,Sale,-380.0,1425.0,6,SUGAR CRISP,Bag
SAFCO PERU,BMOU9016062,03/06/2024,Sale,-1425.0,0.0,6,SUGAR CRISP,Bag
SAFCO PERU,CRSU6127241,02/28/2024,Sale,-190.0,-190.0,0,SUGAR CRISP,Bag
SAFCO PERU,CRSU6127241,02/29/2024,Entry,760.0,570.0,1,SUGAR CRISP,Bag
SAFCO PERU,CRSU6127241,02/29/2024,Entry,95.0,665.0,1,SUGAR CRISP,Bag
SAFCO PERU,CRSU6127241,02/29/2024,Entry,95.0,760.0,1,SWEET GLOBE,Bag
SAFCO PERU,CRSU6127241,02/29/2024,Entry,665.0,1425.0,1,TIMCO,Bag
SAFCO PERU,CRSU6127241,02/29/2024,Entry,285.0,1710.0,1,TIMCO,Bag
SAFCO PERU,CRSU6127241,02/29/2024,Sale,-570.0,1140.0,1,SUGAR CRISP,Bag
SAFCO PERU,CRSU6127241,02/29/2024,Sale,-95.0,1045.0,1,SWEET GLOBE,Bag
SAFCO PERU,CRSU6127241,02/29/2024,Sale,-665.0,380.0,1,TIMCO,Bag
SAFCO PERU,CRSU6127241,02/29/2024,Sale,-285.0,95.0,1,TIMCO,Bag
SAFCO PERU,CRSU6127241,03/02/2024,Sale,-95.0,0.0,3,SUGAR CRISP,Bag
SAFCO PERU,OTPU6406826,02/29/2024,Entry,570.0,570.0,0,SWEET GLOBE,Bag
SAFCO PERU,OTPU6406826,02/29/2024,Entry,380.0,950.0,0,SWEET GLOBE,Bag
SAFCO PERU,OTPU6406826,02/29/2024,Entry,380.0,1330.0,0,TIMCO,Bag
SAFCO PERU,OTPU6406826,02/29/2024,Entry,570.0,1900.0,0,TIMCO,Bag
SAFCO PERU,OTPU6406826,03/08/2024,Sale,-380.0,1520.0,8,SWEET GLOBE,Bag
SAFCO PERU,OTPU6406826,03/08/2024,Sale,-570.0,950.0,8,SWEET GLOBE,Bag
SAFCO PERU,OTPU6406826,03/08/2024,Sale,-380.0,570.0,8,TIMCO,Bag
SAFCO PERU,OTPU6406826,03/08/2024,Sale,-570.0,0.0,8,TIMCO,Bag
SAFCO PERU,TRIU8085305,02/29/2024,Entry,1045.0,1045.0,0,SUGAR CRISP,Unknown
SAFCO PERU,TRIU8085305,02/29/2024,Entry,855.0,1900.0,0,SUGAR CRISP,Unknown
SAFCO PERU,TRIU8085305,03/02/2024,Sale,-855.0,1045.0,2,SUGAR CRISP,Unknown
SAFCO PERU,TRIU8085305,03/02/2024,Sale,-1045.0,0.0,2,SUGAR CRISP,Unknown
Unknown Exporter,24E4405,06/06/2024,Sale,-74.0,-74.0,0,BI-COLOR,Clam
Unknown Exporter,24E4405,06/10/2024,Sale,-37.0,-111.0,4,BI-COLOR,Clam
Unknown Exporter,24E4405,06/11/2024,Sale,-37.0,-148.0,5,BI-COLOR,Clam
Unknown Exporter,24E4405,06/11/2024,Sale,-74.0,-222.0,5,BI-COLOR,Clam
Unknown Exporter,24EE04798,07/01/2024,Sale,-225.0,-225.0,0,FLAME,Clam
Unknown Exporter,24TRA101667,06/14/2024,Entry,750.0,750.0,0,BI-COLOR,Clam
Unknown Exporter,24TRA101667,06/14/2024,Entry,750.0,1500.0,0,FLAME,Clam
Unknown Exporter,24TRA101667,06/17/2024,Sale,-225.0,1275.0,3,FLAME,Clam
Unknown Exporter,24TRA101667,06/20/2024,Sale,-750.0,525.0,6,BI-COLOR,Clam
Unknown Exporter,24TRA101667,06/21/2024,Sale,-525.0,0.0,7,FLAME,Clam
Unknown Exporter,24TRA101838,06/15/2024,Sale,-1050.0,-1050.0,0,BI-COLOR,Clam
Unknown Exporter,E04563,06/19/2024,Sale,-150.0,-150.0,0,BI-COLOR,Clam
Unknown Exporter,E04563,06/20/2024,Sale,-75.0,-225.0,1,BI-COLOR,Clam
Unknown Exporter,E04563,06/21/2024,Sale,-75.0,-300.0,2,BI-COLOR,Clam
Unknown Exporter,E14057,06/15/2024,Sale,-750.0,-750.0,0,BI-COLOR,Clam
Unknown Exporter,E14057,06/18/2024,Sale,-71.0,-821.0,3,BI-COLOR,Clam
Unknown Exporter,E14057,06/20/2024,Sale,-975.0,-1796.0,5,BI-COLOR,Clam
Unknown Exporter,E14057,06/21/2024,Sale,-150.0,-1946.0,6,BI-COLOR,Clam
Unknown Exporter,E14057,07/02/2024,Sale,-225.0,-2171.0,17,BI-COLOR,Clam
Unknown Exporter,E14057,07/20/2024,Sale,-52.0,-2223.0,35,BI-COLOR,Clam
Unknown Exporter,HLBU9006489,01/23/2024,Entry,1600.0,1600.0,0,CANDY DREAMS,Clam
Unknown Exporter,HLBU9006489,02/10/2024,Sale,-720.0,880.0,18,CANDY DREAMS,Clam
Unknown Exporter,HLBU9006489,02/10/2024,Sale,-880.0,0.0,18,CANDY DREAMS,Clam
Unknown Exporter,MMAU1267681,01/23/2024,Entry,1600.0,1600.0,0,TIMCO,Clam
Unknown Exporter,MMAU1267681,01/27/2024,Sale,-640.0,960.0,4,TIMCO,Clam
Unknown Exporter,MMAU1267681,01/29/2024,Sale,-960.0,0.0,6,TIMCO,Clam
Unknown Exporter,MNBU0561495,01/22/2024,Entry,1600.0,1600.0,0,SWEET GLOBE,Clam
Unknown Exporter,MNBU0561495,01/31/2024,Sale,-400.0,1200.0,9,SWEET GLOBE,Clam
Unknown Exporter,MNBU0561495,02/01/2024,Sale,-1200.0,0.0,10,SWEET GLOBE,Clam
VIDEXPORT,24E04178,05/21/2024,Entry,2080.0,2080.0,0,EARLY SWEET,Clam
VIDEXPORT,24E04178,05/21/2024,Sale,-720.0,1360.0,0,EARLY SWEET,Clam
VIDEXPORT,24E04178,05/23/2024,Sale,-1360.0,0.0,2,EARLY SWEET,Clam
VIDEXPORT,24E04179,05/21/2024,Entry,2080.0,2080.0,0,EARLY SWEET,Clam
VIDEXPORT,24E04179,05/22/2024,Sale,-1840.0,240.0,1,EARLY SWEET,Clam
VIDEXPORT,24E04179,05/23/2024,Sale,-240.0,0.0,2,EARLY SWEET,Clam
VIDEXPORT,24E04196,05/22/2024,Entry,90.0,90.0,0,EARLY SWEET,Clam
VIDEXPORT,24E04196,05/22/2024,Entry,2080.0,2170.0,0,EARLY SWEET,Clam
VIDEXPORT,24E04196,05/23/2024,Sale,-160.0,2010.0,1,EARLY SWEET,Clam
VIDEXPORT,24E04196,05/23/2024,Sale,-1920.0,90.0,1,EARLY SWEET,Clam
VIDEXPORT,24E04204,05/22/2024,Entry,1980.0,1980.0,0,EARLY SWEET,Bag
VIDEXPORT,24E04204,05/23/2024,Sale,-630.0,1350.0,1,EARLY SWEET,Bag
VIDEXPORT,24E04204,05/23/2024,Sale,-720.0,630.0,1,EARLY SWEET,Bag
VIDEXPORT,24E04204,05/24/2024,Sale,-630.0,0.0,2,EARLY SWEET,Bag
VIDEXPORT,24E04205,05/22/2024,Entry,1920.0,1920.0,0,EARLY SWEET,Clam
VIDEXPORT,24E04205,05/23/2024,Sale,-160.0,1760.0,1,EARLY SWEET,Clam
VIDEXPORT,24E04205,05/24/2024,Sale,-1680.0,80.0,2,EARLY SWEET,Clam
VIDEXPORT,24E04205,05/27/2024,Sale,-80.0,0.0,5,EARLY SWEET,Clam
VIDEXPORT,24E04206,05/22/2024,Entry,1920.0,1920.0,0,EARLY SWEET,Clam
VIDEXPORT,24E04206,05/24/2024,Sale,-1600.0,320.0,2,EARLY SWEET,Clam
VIDEXPORT,24E04206,05/24/2024,Sale,-240.0,80.0,2,EARLY SWEET,Clam
VIDEXPORT,24E04206,05/31/2024,Sale,-80.0,0.0,9,EARLY SWEET,Clam
VIDEXPORT,24E04207,05/22/2024,Entry,1760.0,1760.0,0,EARLY SWEET,Clam
VIDEXPORT,24E04207,05/24/2024,Sale,-240.0,1520.0,2,EARLY SWEET,Clam
VIDEXPORT,24E04207,05/24/2024,Sale,-1520.0,0.0,2,EARLY SWEET,Clam
VIDEXPORT,24E04209,05/22/2024,Entry,2340.0,2340.0,0,EARLY SWEET,Bag
VIDEXPORT,24E04209,05/24/2024,Sale,-1080.0,1260.0,2,EARLY SWEET,Bag
VIDEXPORT,24E04209,05/24/2024,Sale,-1080.0,180.0,2,EARLY SWEET,Bag
VIDEXPORT,24E04209,05/24/2024,Sale,-180.0,0.0,2,EARLY SWEET,Bag
VIDEXPORT,24E04210,05/22/2024,Entry,2070.0,2070.0,0,EARLY SWEET,Bag
VIDEXPORT,24E04210,05/24/2024,Sale,-1350.0,720.0,2,EARLY SWEET,Bag
VIDEXPORT,24E04210,06/03/2024,Sale,-720.0,0.0,12,EARLY SWEET,Bag
VIDEXPORT,24E04225,05/23/2024,Entry,2080.0,2080.0,0,EARLY SWEET,Clam
VIDEXPORT,24E04225,05/24/2024,Sale,-400.0,1680.0,1,EARLY SWEET,Clam
VIDEXPORT,24E04225,05/25/2024,Sale,-1680.0,0.0,2,EARLY SWEET,Clam
VIDEXPORT,24E04236,05/23/2024,Entry,1920.0,1920.0,0,EARLY SWEET,Clam
VIDEXPORT,24E04236,05/28/2024,Sale,-1920.0,0.0,5,EARLY SWEET,Clam
VIDEXPORT,24E04237,05/23/2024,Entry,1680.0,1680.0,0,EARLY SWEET,Clam
VIDEXPORT,24E04237,05/27/2024,Sale,-240.0,1440.0,4,EARLY SWEET,Clam
VIDEXPORT,24E04237,05/28/2024,Sale,-960.0,480.0,5,EARLY SWEET,Clam
VIDEXPORT,24E04237,05/28/2024,Sale,-480.0,0.0,5,EARLY SWEET,Clam
VIDEXPORT,24E04238,05/23/2024,Entry,1800.0,1800.0,0,EARLY SWEET,Bag
VIDEXPORT,24E04238,05/24/2024,Sale,-1800.0,0.0,1,EARLY SWEET,Bag
VIDEXPORT,24E04239,05/24/2024,Entry,2340.0,2340.0,0,EARLY SWEET,Bag
VIDEXPORT,24E04239,05/30/2024,Sale,-90.0,2250.0,6,EARLY SWEET,Bag
VIDEXPORT,24E04239,05/31/2024,Sale,-630.0,1620.0,7,EARLY SWEET,Bag
VIDEXPORT,24E04239,06/01/2024,Sale,-360.0,1260.0,8,EARLY SWEET,Bag
VIDEXPORT,24E04239,06/03/2024,Sale,-1260.0,0.0,10,EARLY SWEET,Bag
VIDEXPORT,24E04240,05/23/2024,Entry,1680.0,1680.0,0,EARLY SWEET,Clam
VIDEXPORT,24E04240,05/25/2024,Sale,-80.0,1600.0,2,EARLY SWEET,Clam
VIDEXPORT,24E04240,05/27/2024,Sale,-1600.0,0.0,4,EARLY SWEET,Clam
VIDEXPORT,24E04242,05/23/2024,Entry,1710.0,1710.0,0,EARLY SWEET,Bag
VIDEXPORT,24E04242,05/24/2024,Sale,-900.0,810.0,1,EARLY SWEET,Bag
VIDEXPORT,24E04242,05/30/2024,Sale,-810.0,0.0,7,EARLY SWEET,Bag
VIDEXPORT,24E04243,05/23/2024,Entry,540.0,540.0,0,EARLY SWEET,Bag
VIDEXPORT,24E04243,05/23/2024,Entry,1350.0,1890.0,0,EARLY SWEET,Bag
VIDEXPORT,24E04243,05/24/2024,Sale,-270.0,1620.0,1,EARLY SWEET,Bag
VIDEXPORT,24E04243,05/24/2024,Sale,-450.0,1170.0,1,EARLY SWEET,Bag
VIDEXPORT,24E04243,05/24/2024,Sale,-180.0,990.0,1,EARLY SWEET,Bag
VIDEXPORT,24E04243,05/25/2024,Sale,-270.0,720.0,2,EARLY SWEET,Bag
VIDEXPORT,24E04243,05/25/2024,Sale,-180.0,540.0,2,EARLY SWEET,Bag
VIDEXPORT,24E04243,05/30/2024,Sale,-270.0,270.0,7,EARLY SWEET,Bag
VIDEXPORT,24E04243,05/30/2024,Sale,-90.0,180.0,7,EARLY SWEET,Bag
VIDEXPORT,24E04243,05/31/2024,Sale,-180.0,0.0,8,EARLY SWEET,Bag
VIDEXPORT,24E04244,05/23/2024,Entry,1120.0,1120.0,0,EARLY SWEET,Bag
VIDEXPORT,24E04244,05/23/2024,Entry,540.0,1660.0,0,SUMMER ROYAL,Bag
VIDEXPORT,24E04244,05/24/2024,Sale,-180.0,1480.0,1,SUMMER ROYAL,Bag
VIDEXPORT,24E04244,05/24/2024,Sale,-90.0,1390.0,1,SUMMER ROYAL,Bag
VIDEXPORT,24E04244,05/25/2024,Sale,-400.0,990.0,2,EARLY SWEET,Clam
VIDEXPORT,24E04244,05/25/2024,Sale,-160.0,830.0,2,EARLY SWEET,Clam
VIDEXPORT,24E04244,05/25/2024,Sale,-160.0,670.0,2,EARLY SWEET,Clam
VIDEXPORT,24E04244,05/25/2024,Sale,-80.0,590.0,2,EARLY SWEET,Clam
VIDEXPORT,24E04244,05/25/2024,Sale,-90.0,500.0,2,SUMMER ROYAL,Bag
VIDEXPORT,24E04244,05/25/2024,Sale,-180.0,320.0,2,SUMMER ROYAL,Bag
VIDEXPORT,24E04244,05/29/2024,Sale,-160.0,160.0,6,EARLY SWEET,Clam
VIDEXPORT,24E04244,06/15/2024,Sale,-80.0,80.0,23,EARLY SWEET,Clam
VIDEXPORT,24E04244,07/17/2024,Sale,-80.0,0.0,55,EARLY SWEET,Clam
VIDEXPORT,24E04268,05/24/2024,Entry,2080.0,2080.0,0,EARLY SWEET,Clam
VIDEXPORT,24E04268,05/28/2024,Sale,-160.0,1920.0,4,EARLY SWEET,Clam
VIDEXPORT,24E04268,05/28/2024,Sale,-1920.0,0.0,4,EARLY SWEET,Clam
VIDEXPORT,24E04269,05/24/2024,Entry,2080.0,2080.0,0,EARLY SWEET,Clam
VIDEXPORT,24E04269,05/28/2024,Sale,-1760.0,320.0,4,EARLY SWEET,Clam
VIDEXPORT,24E04269,05/31/2024,Sale,-320.0,0.0,7,EARLY SWEET,Clam
VIDEXPORT,24E04270,05/24/2024,Entry,2340.0,2340.0,0,EARLY SWEET,Bag
VIDEXPORT,24E04270,05/25/2024,Sale,-1710.0,630.0,1,EARLY SWEET,Bag
VIDEXPORT,24E04270,05/25/2024,Sale,-630.0,0.0,1,EARLY SWEET,Bag
VIDEXPORT,24E04271,05/24/2024,Entry,2080.0,2080.0,0,EARLY SWEET,Clam
VIDEXPORT,24E04271,05/25/2024,Sale,-1920.0,160.0,1,EARLY SWEET,Clam
VIDEXPORT,24E04271,05/27/2024,Sale,-80.0,80.0,3,EARLY SWEET,Clam
VIDEXPORT,24E04271,05/28/2024,Sale,-80.0,0.0,4,EARLY SWEET,Clam
VIDEXPORT,24E04272,05/24/2024,Entry,2160.0,2160.0,0,EARLY SWEET,Bag
VIDEXPORT,24E04272,05/24/2024,Sale,-1620.0,540.0,0,EARLY SWEET,Bag
VIDEXPORT,24E04272,05/24/2024,Sale,-540.0,0.0,0,EARLY SWEET,Bag
VIDEXPORT,24E04273,05/24/2024,Entry,1280.0,1280.0,0,EARLY SWEET,Clam
VIDEXPORT,24E04273,05/24/2024,Entry,800.0,2080.0,0,EARLY SWEET,Clam
VIDEXPORT,24E04273,05/27/2024,Sale,-320.0,1760.0,3,EARLY SWEET,Clam
VIDEXPORT,24E04273,05/28/2024,Sale,-320.0,1440.0,4,EARLY SWEET,Clam
VIDEXPORT,24E04273,05/28/2024,Sale,-480.0,960.0,4,EARLY SWEET,Clam
VIDEXPORT,24E04273,05/31/2024,Sale,-960.0,0.0,7,EARLY SWEET,Clam
VIDEXPORT,24E04274,05/25/2024,Entry,90.0,90.0,0,EARLY SWEET,Bag
VIDEXPORT,24E04274,05/25/2024,Entry,90.0,180.0,0,EARLY SWEET,Bag
VIDEXPORT,24E04274,05/25/2024,Entry,2070.0,2250.0,0,EARLY SWEET,Bag
VIDEXPORT,24E04274,05/25/2024,Sale,-1530.0,720.0,0,EARLY SWEET,Bag
VIDEXPORT,24E04274,05/27/2024,Sale,-540.0,180.0,2,EARLY SWEET,Bag
VIDEXPORT,24E04274,05/30/2024,Sale,-90.0,90.0,5,EARLY SWEET,Bag
VIDEXPORT,24E04274,06/03/2024,Sale,-90.0,0.0,9,EARLY SWEET,Bag
VIDEXPORT,24E04275,05/25/2024,Entry,900.0,900.0,0,EARLY SWEET,Bag
VIDEXPORT,24E04275,05/25/2024,Entry,450.0,1350.0,0,SUMMER ROYAL,Bag
VIDEXPORT,24E04275,05/25/2024,Entry,630.0,1980.0,0,SUMMER ROYAL,Bag
VIDEXPORT,24E04275,05/25/2024,Sale,-180.0,1800.0,0,SUMMER ROYAL,Bag
VIDEXPORT,24E04275,05/25/2024,Sale,-180.0,1620.0,0,SUMMER ROYAL,Bag
VIDEXPORT,24E04275,05/25/2024,Sale,-180.0,1440.0,0,SUMMER ROYAL,Bag
VIDEXPORT,24E04275,05/25/2024,Sale,-90.0,1350.0,0,SUMMER ROYAL,Bag
VIDEXPORT,24E04275,05/27/2024,Sale,-900.0,450.0,2,EARLY SWEET,Bag
VIDEXPORT,24E04275,05/27/2024,Sale,-90.0,360.0,2,SUMMER ROYAL,Bag
VIDEXPORT,24E04275,05/27/2024,Sale,-90.0,270.0,2,SUMMER ROYAL,Bag
VIDEXPORT,24E04275,05/27/2024,Sale,-90.0,180.0,2,SUMMER ROYAL,Bag
VIDEXPORT,24E04275,05/28/2024,Sale,-180.0,0.0,3,SUMMER ROYAL,Bag
VIDEXPORT,24E04276,05/24/2024,Entry,240.0,240.0,0,EARLY SWEET,Clam
VIDEXPORT,24E04276,05/24/2024,Entry,1840.0,2080.0,0,EARLY SWEET,Clam
VIDEXPORT,24E04276,05/28/2024,Sale,-160.0,1920.0,4,EARLY SWEET,Clam
VIDEXPORT,24E04276,05/28/2024,Sale,-400.0,1520.0,4,EARLY SWEET,Clam
VIDEXPORT,24E04276,05/28/2024,Sale,-1440.0,80.0,4,EARLY SWEET,Clam
VIDEXPORT,24E04276,05/31/2024,Sale,-34.0,46.0,7,EARLY SWEET,Clam
VIDEXPORT,24E04276,05/31/2024,Sale,-46.0,0.0,7,EARLY SWEET,Clam
VIDEXPORT,24E04277,05/25/2024,Entry,1980.0,1980.0,0,EARLY SWEET,Bag
VIDEXPORT,24E04277,05/25/2024,Sale,-1620.0,360.0,0,EARLY SWEET,Bag
VIDEXPORT,24E04277,05/25/2024,Sale,-90.0,270.0,0,EARLY SWEET,Bag
VIDEXPORT,24E04277,05/25/2024,Sale,-90.0,180.0,0,EARLY SWEET,Bag
VIDEXPORT,24E04277,05/25/2024,Sale,-180.0,0.0,0,EARLY SWEET,Bag
VIDEXPORT,24E04278,05/25/2024,Entry,400.0,400.0,0,EARLY SWEET,Clam
VIDEXPORT,24E04278,05/25/2024,Entry,1280.0,1680.0,0,EARLY SWEET,Clam
VIDEXPORT,24E04278,05/27/2024,Sale,-160.0,1520.0,2,EARLY SWEET,Clam
VIDEXPORT,24E04278,05/27/2024,Sale,-1280.0,240.0,2,EARLY SWEET,Clam
VIDEXPORT,24E04278,06/06/2024,Sale,-160.0,80.0,12,EARLY SWEET,Clam
VIDEXPORT,24E04278,06/07/2024,Sale,-80.0,0.0,13,EARLY SWEET,Clam
VIDEXPORT,24E04294,05/25/2024,Entry,2160.0,2160.0,0,EARLY SWEET,Bag
VIDEXPORT,24E04294,05/25/2024,Sale,-1530.0,630.0,0,EARLY SWEET,Bag
VIDEXPORT,24E04294,05/27/2024,Sale,-540.0,90.0,2,EARLY SWEET,Bag
VIDEXPORT,24E04294,05/28/2024,Sale,-90.0,0.0,3,EARLY SWEET,Bag
VIDEXPORT,24E04301,05/25/2024,Entry,2080.0,2080.0,0,EARLY SWEET,Clam
VIDEXPORT,24E04301,05/30/2024,Sale,-1200.0,880.0,5,EARLY SWEET,Clam
VIDEXPORT,24E04301,05/31/2024,Sale,-80.0,800.0,6,EARLY SWEET,Clam
VIDEXPORT,24E04301,05/31/2024,Sale,-800.0,0.0,6,EARLY SWEET,Clam
VIDEXPORT,24E04302,05/25/2024,Entry,2340.0,2340.0,0,EARLY SWEET,Bag
VIDEXPORT,24E04302,05/25/2024,Sale,-180.0,2160.0,0,EARLY SWEET,Bag
VIDEXPORT,24E04302,05/27/2024,Sale,-270.0,1890.0,2,EARLY SWEET,Bag
VIDEXPORT,24E04302,05/28/2024,Sale,-90.0,1800.0,3,EARLY SWEET,Bag
VIDEXPORT,24E04302,05/28/2024,Sale,-1800.0,0.0,3,EARLY SWEET,Bag
VIDEXPORT,24E04304,05/25/2024,Entry,2240.0,2240.0,0,EARLY SWEET,Clam
VIDEXPORT,24E04304,05/28/2024,Sale,-640.0,1600.0,3,EARLY SWEET,Clam
VIDEXPORT,24E04304,05/30/2024,Sale,-80.0,1520.0,5,EARLY SWEET,Clam
VIDEXPORT,24E04304,05/30/2024,Sale,-960.0,560.0,5,EARLY SWEET,Clam
VIDEXPORT,24E04304,05/30/2024,Sale,-560.0,0.0,5,EARLY SWEET,Clam
VIDEXPORT,24E04306,05/25/2024,Entry,2520.0,2520.0,0,EARLY SWEET,Bag
VIDEXPORT,24E04306,05/27/2024,Sale,-270.0,2250.0,2,EARLY SWEET,Bag
VIDEXPORT,24E04306,05/27/2024,Sale,-90.0,2160.0,2,EARLY SWEET,Bag
VIDEXPORT,24E04306,05/27/2024,Sale,-540.0,1620.0,2,EARLY SWEET,Bag
VIDEXPORT,24E04306,05/27/2024,Sale,-90.0,1530.0,2,EARLY SWEET,Bag
VIDEXPORT,24E04306,05/27/2024,Sale,-360.0,1170.0,2,EARLY SWEET,Bag
VIDEXPORT,24E04306,05/27/2024,Sale,-270.0,900.0,2,EARLY SWEET,Bag
VIDEXPORT,24E04306,05/27/2024,Sale,-90.0,810.0,2,EARLY SWEET,Bag
VIDEXPORT,24E04306,05/27/2024,Sale,-180.0,630.0,2,EARLY SWEET,Bag
VIDEXPORT,24E04306,05/28/2024,Sale,-180.0,450.0,3,EARLY SWEET,Bag
VIDEXPORT,24E04306,05/28/2024,Sale,-450.0,0.0,3,EARLY SWEET,Bag
VIDEXPORT,24E04307,05/25/2024,Entry,2240.0,2240.0,0,EARLY SWEET,Clam
VIDEXPORT,24E04307,05/31/2024,Sale,-800.0,1440.0,6,EARLY SWEET,Clam
VIDEXPORT,24E04307,05/31/2024,Sale,-320.0,1120.0,6,EARLY SWEET,Clam
VIDEXPORT,24E04307,05/31/2024,Sale,-1040.0,80.0,6,EARLY SWEET,Clam
VIDEXPORT,24E04307,06/03/2024,Sale,-80.0,0.0,9,EARLY SWEET,Clam
VIDEXPORT,24E04308,05/25/2024,Entry,2000.0,2000.0,0,EARLY SWEET,Clam
VIDEXPORT,24E04308,05/27/2024,Sale,-560.0,1440.0,2,EARLY SWEET,Clam
VIDEXPORT,24E04308,05/28/2024,Sale,-1440.0,0.0,3,EARLY SWEET,Clam
VIDEXPORT,24E04309,05/25/2024,Entry,1040.0,1040.0,0,EARLY SWEET,Clam
VIDEXPORT,24E04309,05/25/2024,Entry,1120.0,2160.0,0,EARLY SWEET,Clam
VIDEXPORT,24E04309,05/30/2024,Sale,-1120.0,1040.0,5,EARLY SWEET,Clam
VIDEXPORT,24E04309,05/31/2024,Sale,-320.0,720.0,6,EARLY SWEET,Clam
VIDEXPORT,24E04309,06/03/2024,Sale,-720.0,0.0,9,EARLY SWEET,Clam
VIDEXPORT,24E04310,05/25/2024,Entry,540.0,540.0,0,EARLY SWEET,Clam
VIDEXPORT,24E04310,05/25/2024,Entry,1350.0,1890.0,0,EARLY SWEET,Clam
VIDEXPORT,24E04310,05/27/2024,Sale,-150.0,1740.0,2,EARLY SWEET,Clam
VIDEXPORT,24E04310,05/28/2024,Sale,-300.0,1440.0,3,EARLY SWEET,Clam
VIDEXPORT,24E04310,05/28/2024,Sale,-150.0,1290.0,3,EARLY SWEET,Clam
VIDEXPORT,24E04310,05/29/2024,Sale,-540.0,750.0,4,EARLY SWEET,Bag
VIDEXPORT,24E04310,05/29/2024,Sale,-600.0,150.0,4,EARLY SWEET,Clam
VIDEXPORT,24E04310,05/29/2024,Sale,-75.0,75.0,4,EARLY SWEET,Clam
VIDEXPORT,24E04310,05/31/2024,Sale,-75.0,0.0,6,EARLY SWEET,Clam
VIDEXPORT,24E04312,05/25/2024,Entry,2520.0,2520.0,0,EARLY SWEET,Bag
VIDEXPORT,24E04312,05/27/2024,Sale,-360.0,2160.0,2,EARLY SWEET,Bag
VIDEXPORT,24E04312,05/27/2024,Sale,-450.0,1710.0,2,EARLY SWEET,Bag
VIDEXPORT,24E04312,05/27/2024,Sale,-630.0,1080.0,2,EARLY SWEET,Bag
VIDEXPORT,24E04312,05/28/2024,Sale,-990.0,90.0,3,EARLY SWEET,Bag
VIDEXPORT,24E04312,06/03/2024,Sale,-90.0,0.0,9,EARLY SWEET,Bag
VIDEXPORT,24E04325,05/26/2024,Entry,2340.0,2340.0,0,EARLY SWEET,Bag
VIDEXPORT,24E04325,05/27/2024,Sale,-270.0,2070.0,1,EARLY SWEET,Bag
VIDEXPORT,24E04325,05/27/2024,Sale,-90.0,1980.0,1,EARLY SWEET,Bag
VIDEXPORT,24E04325,05/27/2024,Sale,-1980.0,0.0,1,EARLY SWEET,Bag
VIDEXPORT,24E04326,05/26/2024,Entry,2080.0,2080.0,0,EARLY SWEET,Clam
VIDEXPORT,24E04326,06/01/2024,Sale,-1920.0,160.0,6,EARLY SWEET,Clam
VIDEXPORT,24E04326,06/03/2024,Sale,-160.0,0.0,8,EARLY SWEET,Clam
VIDEXPORT,24E04333,05/26/2024,Entry,2340.0,2340.0,0,EARLY SWEET,Bag
VIDEXPORT,24E04333,05/27/2024,Sale,-1710.0,630.0,1,EARLY SWEET,Bag
VIDEXPORT,24E04333,05/27/2024,Sale,-630.0,0.0,1,EARLY SWEET,Bag
VIDEXPORT,24E04334,05/26/2024,Entry,2080.0,2080.0,0,EARLY SWEET,Clam
VIDEXPORT,24E04334,05/31/2024,Sale,-1600.0,480.0,5,EARLY SWEET,Clam
VIDEXPORT,24E04334,05/31/2024,Sale,-480.0,0.0,5,EARLY SWEET,Clam
VIDEXPORT,24E04335,05/27/2024,Entry,2520.0,2520.0,0,EARLY SWEET,Bag
VIDEXPORT,24E04335,05/28/2024,Sale,-270.0,2250.0,1,EARLY SWEET,Bag
VIDEXPORT,24E04335,05/28/2024,Sale,-1710.0,540.0,1,EARLY SWEET,Bag
VIDEXPORT,24E04335,05/28/2024,Sale,-540.0,0.0,1,EARLY SWEET,Bag
VIDEXPORT,24E04337,05/27/2024,Entry,1800.0,1800.0,0,EARLY SWEET,Clam
VIDEXPORT,24E04337,06/07/2024,Sale,-1800.0,0.0,11,EARLY SWEET,Clam
VIDEXPORT,24E04338,05/27/2024,Entry,2240.0,2240.0,0,EARLY SWEET,Clam
VIDEXPORT,24E04338,06/04/2024,Sale,-960.0,1280.0,8,EARLY SWEET,Clam
VIDEXPORT,24E04338,06/04/2024,Sale,-400.0,880.0,8,EARLY SWEET,Clam
VIDEXPORT,24E04338,06/05/2024,Sale,-640.0,240.0,9,EARLY SWEET,Clam
VIDEXPORT,24E04338,06/08/2024,Sale,-240.0,0.0,12,EARLY SWEET,Clam
VIDEXPORT,24E04339,05/28/2024,Entry,2240.0,2240.0,0,EARLY SWEET,Clam
VIDEXPORT,24E04339,06/10/2024,Sale,-1520.0,720.0,13,EARLY SWEET,Clam
VIDEXPORT,24E04339,06/14/2024,Sale,-320.0,400.0,17,EARLY SWEET,Clam
VIDEXPORT,24E04339,06/14/2024,Sale,-240.0,160.0,17,EARLY SWEET,Clam
VIDEXPORT,24E04339,06/15/2024,Sale,-160.0,0.0,18,EARLY SWEET,Clam
VIDEXPORT,24E04340,05/26/2024,Entry,2520.0,2520.0,0,EARLY SWEET,Bag
VIDEXPORT,24E04340,05/28/2024,Sale,-540.0,1980.0,2,EARLY SWEET,Bag
VIDEXPORT,24E04340,05/28/2024,Sale,-90.0,1890.0,2,EARLY SWEET,Bag
VIDEXPORT,24E04340,05/28/2024,Sale,-180.0,1710.0,2,EARLY SWEET,Bag
VIDEXPORT,24E04340,05/28/2024,Sale,-1620.0,90.0,2,EARLY SWEET,Bag
VIDEXPORT,24E04340,05/28/2024,Sale,-90.0,0.0,2,EARLY SWEET,Bag
VIDEXPORT,24E04341,05/27/2024,Entry,2100.0,2100.0,0,EARLY SWEET,Clam
VIDEXPORT,24E04341,05/28/2024,Sale,-150.0,1950.0,1,EARLY SWEET,Clam
VIDEXPORT,24E04341,05/29/2024,Sale,-675.0,1275.0,2,EARLY SWEET,Clam
VIDEXPORT,24E04341,05/30/2024,Sale,-150.0,1125.0,3,EARLY SWEET,Clam
VIDEXPORT,24E04341,06/04/2024,Sale,-150.0,975.0,8,EARLY SWEET,Clam
VIDEXPORT,24E04341,06/05/2024,Sale,-750.0,225.0,9,EARLY SWEET,Clam
VIDEXPORT,24E04341,06/05/2024,Sale,-150.0,75.0,9,EARLY SWEET,Clam
VIDEXPORT,24E04341,06/10/2024,Sale,-75.0,0.0,14,EARLY SWEET,Clam
VIDEXPORT,24E04342,05/27/2024,Entry,2240.0,2240.0,0,EARLY SWEET,Clam
VIDEXPORT,24E04342,06/10/2024,Sale,-1280.0,960.0,14,EARLY SWEET,Clam
VIDEXPORT,24E04342,06/10/2024,Sale,-640.0,320.0,14,EARLY SWEET,Clam
VIDEXPORT,24E04342,06/11/2024,Sale,-80.0,240.0,15,EARLY SWEET,Clam
VIDEXPORT,24E04342,06/15/2024,Sale,-160.0,80.0,19,EARLY SWEET,Clam
VIDEXPORT,24E04342,06/18/2024,Sale,-80.0,0.0,22,EARLY SWEET,Clam
VIDEXPORT,24E04343,05/27/2024,Entry,2250.0,2250.0,0,EARLY SWEET,Bag
VIDEXPORT,24E04343,05/28/2024,Sale,-1440.0,810.0,1,EARLY SWEET,Bag
VIDEXPORT,24E04343,05/28/2024,Sale,-720.0,90.0,1,EARLY SWEET,Bag
VIDEXPORT,24E04343,05/29/2024,Sale,-90.0,0.0,2,EARLY SWEET,Bag
VIDEXPORT,24E04348,05/28/2024,Entry,2160.0,2160.0,0,EARLY SWEET,Bag
VIDEXPORT,24E04348,05/29/2024,Sale,-360.0,1800.0,1,EARLY SWEET,Bag
VIDEXPORT,24E04348,05/29/2024,Sale,-1800.0,0.0,1,EARLY SWEET,Bag
VIDEXPORT,24E04349,05/27/2024,Entry,2080.0,2080.0,0,EARLY SWEET,Clam
VIDEXPORT,24E04349,06/08/2024,Sale,-1422.0,658.0,12,EARLY SWEET,Clam
VIDEXPORT,24E04349,06/08/2024,Sale,-18.0,640.0,12,EARLY SWEET,Clam
VIDEXPORT,24E04349,06/10/2024,Sale,-640.0,0.0,14,EARLY SWEET,Clam
VIDEXPORT,24E04350,05/27/2024,Entry,2340.0,2340.0,0,EARLY SWEET,Bag
VIDEXPORT,24E04350,05/28/2024,Sale,-90.0,2250.0,1,EARLY SWEET,Bag
VIDEXPORT,24E04350,05/28/2024,Sale,-90.0,2160.0,1,EARLY SWEET,Bag
VIDEXPORT,24E04350,05/29/2024,Sale,-1170.0,990.0,2,EARLY SWEET,Bag
VIDEXPORT,24E04350,05/29/2024,Sale,-900.0,90.0,2,EARLY SWEET,Bag
VIDEXPORT,24E04350,05/29/2024,Sale,-90.0,0.0,2,EARLY SWEET,Bag
VIDEXPORT,24E04351,05/27/2024,Entry,2157.0,2157.0,0,FLAME,Bag
VIDEXPORT,24E04351,05/28/2024,Sale,-720.0,1437.0,1,FLAME,Bag
VIDEXPORT,24E04351,05/28/2024,Sale,-990.0,447.0,1,FLAME,Bag
VIDEXPORT,24E04351,05/28/2024,Sale,-360.0,87.0,1,FLAME,Bag
VIDEXPORT,24E04351,06/11/2024,Sale,-87.0,0.0,15,FLAME,Bag
VIDEXPORT,24E04352,05/28/2024,Entry,2160.0,2160.0,0,EARLY SWEET,Bag
VIDEXPORT,24E04352,05/28/2024,Sale,-450.0,1710.0,0,EARLY SWEET,Bag
VIDEXPORT,24E04352,05/28/2024,Sale,-270.0,1440.0,0,EARLY SWEET,Bag
VIDEXPORT,24E04352,05/29/2024,Sale,-1260.0,180.0,1,EARLY SWEET,Bag
VIDEXPORT,24E04352,05/29/2024,Sale,-180.0,0.0,1,EARLY SWEET,Bag
VIDEXPORT,24E04353,05/27/2024,Entry,2100.0,2100.0,0,EARLY SWEET,Clam
VIDEXPORT,24E04353,05/28/2024,Sale,-150.0,1950.0,1,EARLY SWEET,Clam
VIDEXPORT,24E04353,05/28/2024,Sale,-225.0,1725.0,1,EARLY SWEET,Clam
VIDEXPORT,24E04353,05/30/2024,Sale,-150.0,1575.0,3,EARLY SWEET,Clam
VIDEXPORT,24E04353,05/31/2024,Sale,-225.0,1350.0,4,EARLY SWEET,Clam
VIDEXPORT,24E04353,06/01/2024,Sale,-750.0,600.0,5,EARLY SWEET,Clam
VIDEXPORT,24E04353,06/05/2024,Sale,-150.0,450.0,9,EARLY SWEET,Clam
VIDEXPORT,24E04353,06/05/2024,Sale,-450.0,0.0,9,EARLY SWEET,Clam
VIDEXPORT,24E04354,05/27/2024,Entry,2080.0,2080.0,0,EARLY SWEET,Clam
VIDEXPORT,24E04354,06/05/2024,Sale,-400.0,1680.0,9,EARLY SWEET,Clam
VIDEXPORT,24E04354,06/08/2024,Sale,-1680.0,0.0,12,EARLY SWEET,Clam
VIDEXPORT,24E04355,05/28/2024,Entry,1980.0,1980.0,0,EARLY SWEET,Bag
VIDEXPORT,24E04355,05/28/2024,Sale,-1260.0,720.0,0,EARLY SWEET,Bag
VIDEXPORT,24E04355,05/28/2024,Sale,-90.0,630.0,0,EARLY SWEET,Bag
VIDEXPORT,24E04355,05/28/2024,Sale,-630.0,0.0,0,EARLY SWEET,Bag
VIDEXPORT,24E04356,05/28/2024,Entry,2080.0,2080.0,0,EARLY SWEET,Clam
VIDEXPORT,24E04356,06/14/2024,Sale,-80.0,2000.0,17,EARLY SWEET,Clam
VIDEXPORT,24E04356,06/14/2024,Sale,-160.0,1840.0,17,EARLY SWEET,Clam
VIDEXPORT,24E04356,06/14/2024,Sale,-1440.0,400.0,17,EARLY SWEET,Clam
VIDEXPORT,24E04356,06/15/2024,Sale,-160.0,240.0,18,EARLY SWEET,Clam
VIDEXPORT,24E04356,06/15/2024,Sale,-160.0,80.0,18,EARLY SWEET,Clam
VIDEXPORT,24E04356,06/18/2024,Sale,-80.0,0.0,21,EARLY SWEET,Clam
VIDEXPORT,24E04357,05/27/2024,Entry,2080.0,2080.0,0,EARLY SWEET,Clam
VIDEXPORT,24E04357,06/10/2024,Sale,-1280.0,800.0,14,EARLY SWEET,Clam
VIDEXPORT,24E04357,06/10/2024,Sale,-400.0,400.0,14,EARLY SWEET,Clam
VIDEXPORT,24E04357,06/15/2024,Sale,-240.0,160.0,19,EARLY SWEET,Clam
VIDEXPORT,24E04357,06/18/2024,Sale,-160.0,0.0,22,EARLY SWEET,Clam
VIDEXPORT,24E04358,05/28/2024,Entry,2156.0,2156.0,0,FLAME,Bag
VIDEXPORT,24E04358,05/28/2024,Sale,-270.0,1886.0,0,FLAME,Bag
VIDEXPORT,24E04358,05/28/2024,Sale,-540.0,1346.0,0,FLAME,Bag
VIDEXPORT,24E04358,05/30/2024,Sale,-360.0,986.0,2,FLAME,Bag
VIDEXPORT,24E04358,05/31/2024,Sale,-80.0,906.0,3,BI-COLOR,Clam
VIDEXPORT,24E04358,05/31/2024,Sale,-160.0,746.0,3,FLAME,Clam
VIDEXPORT,24E04358,06/03/2024,Sale,-180.0,566.0,6,FLAME,Bag
VIDEXPORT,24E04358,06/07/2024,Sale,-86.0,480.0,10,FLAME,Bag
VIDEXPORT,24E04358,06/26/2024,Sale,-30.0,450.0,29,FLAME,Bag
VIDEXPORT,24E04359,05/27/2024,Entry,2100.0,2100.0,0,EARLY SWEET,Clam
VIDEXPORT,24E04359,05/31/2024,Sale,-75.0,2025.0,4,EARLY SWEET,Clam
VIDEXPORT,24E04359,06/03/2024,Sale,-450.0,1575.0,7,EARLY SWEET,Clam
VIDEXPORT,24E04359,06/03/2024,Sale,-375.0,1200.0,7,EARLY SWEET,Clam
VIDEXPORT,24E04359,06/03/2024,Sale,-900.0,300.0,7,EARLY SWEET,Clam
VIDEXPORT,24E04359,06/05/2024,Sale,-300.0,0.0,9,EARLY SWEET,Clam
VIDEXPORT,24E04360,05/28/2024,Entry,1760.0,1760.0,0,EARLY SWEET,Clam
VIDEXPORT,24E04360,06/14/2024,Sale,-1760.0,0.0,17,EARLY SWEET,Clam
VIDEXPORT,24E04361,05/28/2024,Entry,2340.0,2340.0,0,EARLY SWEET,Bag
VIDEXPORT,24E04361,05/29/2024,Sale,-1890.0,450.0,1,EARLY SWEET,Bag
VIDEXPORT,24E04361,05/29/2024,Sale,-360.0,90.0,1,EARLY SWEET,Bag
VIDEXPORT,24E04361,05/29/2024,Sale,-90.0,0.0,1,EARLY SWEET,Bag
VIDEXPORT,24E04362,05/28/2024,Entry,1440.0,1440.0,0,EARLY SWEET,Bag
VIDEXPORT,24E04362,05/28/2024,Entry,675.0,2115.0,0,EARLY SWEET,Bag
VIDEXPORT,24E04362,05/29/2024,Sale,-1260.0,855.0,1,EARLY SWEET,Bag
VIDEXPORT,24E04362,05/29/2024,Sale,-75.0,780.0,1,EARLY SWEET,Clam
VIDEXPORT,24E04362,05/31/2024,Sale,-180.0,600.0,3,EARLY SWEET,Bag
VIDEXPORT,24E04362,05/31/2024,Sale,-75.0,525.0,3,EARLY SWEET,Clam
VIDEXPORT,24E04362,06/03/2024,Sale,-525.0,0.0,6,EARLY SWEET,Clam
VIDEXPORT,24E04363,05/28/2024,Entry,180.0,180.0,0,FLAME,Bag
VIDEXPORT,24E04363,05/28/2024,Entry,900.0,1080.0,0,FLAME,Bag
VIDEXPORT,24E04363,05/28/2024,Entry,720.0,1800.0,0,FLAME,Bag
VIDEXPORT,24E04363,05/28/2024,Sale,-360.0,1440.0,0,FLAME,Bag
VIDEXPORT,24E04363,05/30/2024,Sale,-360.0,1080.0,2,FLAME,Bag
VIDEXPORT,24E04363,05/30/2024,Sale,-540.0,540.0,2,FLAME,Bag
VIDEXPORT,24E04363,05/30/2024,Sale,-180.0,360.0,2,FLAME,Bag
VIDEXPORT,24E04363,06/03/2024,Sale,-90.0,270.0,6,FLAME,Bag
VIDEXPORT,24E04363,06/11/2024,Sale,-90.0,180.0,14,FLAME,Bag
VIDEXPORT,24E04363,06/26/2024,Sale,-180.0,0.0,29,FLAME,Bag
VIDEXPORT,24E04371,05/29/2024,Entry,1600.0,1600.0,0,EARLY SWEET,Clam
VIDEXPORT,24E04371,05/29/2024,Sale,-160.0,1440.0,0,EARLY SWEET,Clam
VIDEXPORT,24E04371,06/01/2024,Sale,-1120.0,320.0,3,EARLY SWEET,Clam
VIDEXPORT,24E04371,06/08/2024,Sale,-320.0,0.0,10,EARLY SWEET,Clam
VIDEXPORT,24E04376,05/29/2024,Entry,2160.0,2160.0,0,EARLY SWEET,Bag
VIDEXPORT,24E04376,05/30/2024,Sale,-180.0,1980.0,1,EARLY SWEET,Bag
VIDEXPORT,24E04376,05/31/2024,Sale,-360.0,1620.0,2,EARLY SWEET,Bag
VIDEXPORT,24E04376,05/31/2024,Sale,-900.0,720.0,2,EARLY SWEET,Bag
VIDEXPORT,24E04376,05/31/2024,Sale,-720.0,0.0,2,EARLY SWEET,Bag
VIDEXPORT,24E04389,05/28/2024,Entry,2099.0,2099.0,0,EARLY SWEET,Clam
VIDEXPORT,24E04389,05/28/2024,Sale,-675.0,1424.0,0,EARLY SWEET,Clam
VIDEXPORT,24E04389,05/29/2024,Sale,-1424.0,0.0,1,EARLY SWEET,Clam
VIDEXPORT,24E04390,05/28/2024,Entry,1920.0,1920.0,0,EARLY SWEET,Clam
VIDEXPORT,24E04390,05/28/2024,Sale,-1840.0,80.0,0,EARLY SWEET,Clam
VIDEXPORT,24E04390,05/29/2024,Sale,-80.0,0.0,1,EARLY SWEET,Clam
VIDEXPORT,24E04391,05/28/2024,Entry,2100.0,2100.0,0,EARLY SWEET,Clam
VIDEXPORT,24E04391,05/29/2024,Sale,-1725.0,375.0,1,EARLY SWEET,Clam
VIDEXPORT,24E04391,05/30/2024,Sale,-300.0,75.0,2,EARLY SWEET,Clam
VIDEXPORT,24E04391,06/03/2024,Sale,-75.0,0.0,6,EARLY SWEET,Clam
VIDEXPORT,24E04392,05/29/2024,Entry,2340.0,2340.0,0,EARLY SWEET,Bag
VIDEXPORT,24E04392,05/30/2024,Sale,-810.0,1530.0,1,EARLY SWEET,Bag
VIDEXPORT,24E04392,05/30/2024,Sale,-90.0,1440.0,1,EARLY SWEET,Bag
VIDEXPORT,24E04392,05/30/2024,Sale,-1170.0,270.0,1,EARLY SWEET,Bag
VIDEXPORT,24E04392,05/30/2024,Sale,-270.0,0.0,1,EARLY SWEET,Bag
VIDEXPORT,24E04393,05/29/2024,Entry,2520.0,2520.0,0,FLAME,Bag
VIDEXPORT,24E04393,06/01/2024,Sale,-990.0,1530.0,3,FLAME,Bag
VIDEXPORT,24E04393,06/01/2024,Sale,-450.0,1080.0,3,FLAME,Bag
VIDEXPORT,24E04393,06/01/2024,Sale,-900.0,180.0,3,FLAME,Bag
VIDEXPORT,24E04394,05/29/2024,Entry,1950.0,1950.0,0,EARLY SWEET,Clam
VIDEXPORT,24E04394,05/29/2024,Sale,-375.0,1575.0,0,EARLY SWEET,Clam
VIDEXPORT,24E04394,05/29/2024,Sale,-75.0,1500.0,0,EARLY SWEET,Clam
VIDEXPORT,24E04394,06/03/2024,Sale,-1350.0,150.0,5,EARLY SWEET,Clam
VIDEXPORT,24E04394,06/07/2024,Sale,-150.0,0.0,9,EARLY SWEET,Clam
VIDEXPORT,24E04395,05/30/2024,Entry,2340.0,2340.0,0,EARLY SWEET,Bag
VIDEXPORT,24E04395,05/30/2024,Sale,-990.0,1350.0,0,EARLY SWEET,Bag
VIDEXPORT,24E04395,05/30/2024,Sale,-1170.0,180.0,0,EARLY SWEET,Bag
VIDEXPORT,24E04395,05/31/2024,Sale,-180.0,0.0,1,EARLY SWEET,Bag
VIDEXPORT,24E04396,05/29/2024,Entry,2520.0,2520.0,0,EARLY SWEET,Bag
VIDEXPORT,24E04396,05/29/2024,Sale,-180.0,2340.0,0,EARLY SWEET,Bag
VIDEXPORT,24E04396,05/30/2024,Sale,-630.0,1710.0,1,EARLY SWEET,Bag
VIDEXPORT,24E04396,05/30/2024,Sale,-1710.0,0.0,1,EARLY SWEET,Bag
VIDEXPORT,24E04397,05/28/2024,Entry,2160.0,2160.0,0,EARLY SWEET,Clam
VIDEXPORT,24E04397,06/01/2024,Sale,-400.0,1760.0,4,EARLY SWEET,Clam
VIDEXPORT,24E04397,06/01/2024,Sale,-1760.0,0.0,4,EARLY SWEET,Clam
VIDEXPORT,24E04400,05/29/2024,Entry,2070.0,2070.0,0,EARLY SWEET,Bag
VIDEXPORT,24E04400,05/30/2024,Sale,-270.0,1800.0,1,EARLY SWEET,Bag
VIDEXPORT,24E04400,05/30/2024,Sale,-180.0,1620.0,1,EARLY SWEET,Bag
VIDEXPORT,24E04400,05/30/2024,Sale,-1080.0,540.0,1,EARLY SWEET,Bag
VIDEXPORT,24E04400,05/30/2024,Sale,-270.0,270.0,1,EARLY SWEET,Bag
VIDEXPORT,24E04400,05/31/2024,Sale,-270.0,0.0,2,EARLY SWEET,Bag
VIDEXPORT,24E04404,05/29/2024,Entry,2160.0,2160.0,0,FLAME,Bag
VIDEXPORT,24E04404,05/31/2024,Sale,-450.0,1710.0,2,FLAME,Bag
VIDEXPORT,24E04404,06/06/2024,Sale,-990.0,720.0,8,FLAME,Bag
VIDEXPORT,24E04404,06/06/2024,Sale,-360.0,360.0,8,FLAME,Bag
VIDEXPORT,24E04404,06/14/2024,Sale,-360.0,0.0,16,FLAME,Bag
VIDEXPORT,24E04405,05/29/2024,Entry,1530.0,1530.0,0,FLAME,Bag
VIDEXPORT,24E04405,05/29/2024,Entry,810.0,2340.0,0,FLAME,Bag
VIDEXPORT,24E04405,06/03/2024,Sale,-810.0,1530.0,5,FLAME,Bag
VIDEXPORT,24E04405,06/04/2024,Sale,-360.0,1170.0,6,FLAME,Bag
VIDEXPORT,24E04405,06/07/2024,Sale,-40.0,1130.0,9,BI-COLOR,Clam
VIDEXPORT,24E04405,06/07/2024,Sale,-40.0,1090.0,9,BI-COLOR,Clam
VIDEXPORT,24E04405,06/07/2024,Sale,-270.0,820.0,9,FLAME,Bag
VIDEXPORT,24E04405,06/07/2024,Sale,-160.0,660.0,9,FLAME,Clam
VIDEXPORT,24E04405,06/08/2024,Sale,-38.0,622.0,10,BI-COLOR,Clam
VIDEXPORT,24E04405,06/26/2024,Sale,-360.0,262.0,28,FLAME,Bag
VIDEXPORT,24E04406,05/29/2024,Entry,1440.0,1440.0,0,FLAME,Bag
VIDEXPORT,24E04406,05/29/2024,Entry,720.0,2160.0,0,SUMMER ROYAL,Bag
VIDEXPORT,24E04406,05/30/2024,Sale,-450.0,1710.0,1,FLAME,Bag
VIDEXPORT,24E04406,05/30/2024,Sale,-180.0,1530.0,1,SUMMER ROYAL,Bag
VIDEXPORT,24E04406,05/31/2024,Sale,-990.0,540.0,2,FLAME,Bag
VIDEXPORT,24E04406,05/31/2024,Sale,-270.0,270.0,2,SUMMER ROYAL,Bag
VIDEXPORT,24E04406,06/03/2024,Sale,-90.0,180.0,5,SUMMER ROYAL,Bag
VIDEXPORT,24E04406,06/07/2024,Sale,-180.0,0.0,9,SUMMER ROYAL,Bag
VIDEXPORT,24E04408,05/29/2024,Entry,1440.0,1440.0,0,EARLY SWEET,Clam
VIDEXPORT,24E04408,05/29/2024,Entry,270.0,1710.0,0,SUMMER ROYAL,Clam
VIDEXPORT,24E04408,05/29/2024,Sale,-1440.0,270.0,0,EARLY SWEET,Clam
VIDEXPORT,24E04408,05/31/2024,Sale,-90.0,180.0,2,SUMMER ROYAL,Bag
VIDEXPORT,24E04408,06/04/2024,Sale,-180.0,0.0,6,SUMMER ROYAL,Bag
VIDEXPORT,24E04419,05/29/2024,Entry,1950.0,1950.0,0,EARLY SWEET,Clam
VIDEXPORT,24E04419,06/03/2024,Sale,-1800.0,150.0,5,EARLY SWEET,Clam
VIDEXPORT,24E04419,06/07/2024,Sale,-150.0,0.0,9,EARLY SWEET,Clam
VIDEXPORT,24E04428,05/29/2024,Entry,1920.0,1920.0,0,EARLY SWEET,Clam
VIDEXPORT,24E04428,05/31/2024,Sale,-160.0,1760.0,2,EARLY SWEET,Clam
VIDEXPORT,24E04428,06/01/2024,Sale,-1520.0,240.0,3,EARLY SWEET,Clam
VIDEXPORT,24E04428,06/03/2024,Sale,-80.0,160.0,5,EARLY SWEET,Clam
VIDEXPORT,24E04428,06/03/2024,Sale,-160.0,0.0,5,EARLY SWEET,Clam
VIDEXPORT,24E04430,05/29/2024,Entry,2340.0,2340.0,0,EARLY SWEET,Bag
VIDEXPORT,24E04430,05/30/2024,Sale,-1800.0,540.0,1,EARLY SWEET,Bag
VIDEXPORT,24E04430,05/30/2024,Sale,-360.0,180.0,1,EARLY SWEET,Bag
VIDEXPORT,24E04430,05/30/2024,Sale,-180.0,0.0,1,EARLY SWEET,Bag
VIDEXPORT,24E04431,05/29/2024,Entry,1920.0,1920.0,0,EARLY SWEET,Clam
VIDEXPORT,24E04431,06/13/2024,Sale,-1520.0,400.0,15,EARLY SWEET,Clam
VIDEXPORT,24E04431,06/13/2024,Sale,-160.0,240.0,15,EARLY SWEET,Clam
VIDEXPORT,24E04431,06/15/2024,Sale,-80.0,160.0,17,EARLY SWEET,Clam
VIDEXPORT,24E04431,06/15/2024,Sale,-80.0,80.0,17,EARLY SWEET,Clam
VIDEXPORT,24E04431,06/18/2024,Sale,-80.0,0.0,20,EARLY SWEET,Clam
VIDEXPORT,24E04432,05/29/2024,Entry,1920.0,1920.0,0,EARLY SWEET,Clam
VIDEXPORT,24E04432,06/13/2024,Sale,-400.0,1520.0,15,EARLY SWEET,Clam
VIDEXPORT,24E04432,06/13/2024,Sale,-160.0,1360.0,15,EARLY SWEET,Clam
VIDEXPORT,24E04432,06/14/2024,Sale,-560.0,800.0,16,EARLY SWEET,Clam
VIDEXPORT,24E04432,06/15/2024,Sale,-160.0,640.0,17,EARLY SWEET,Clam
VIDEXPORT,24E04432,06/15/2024,Sale,-80.0,560.0,17,EARLY SWEET,Clam
VIDEXPORT,24E04432,06/15/2024,Sale,-320.0,240.0,17,EARLY SWEET,Clam
VIDEXPORT,24E04432,06/18/2024,Sale,-240.0,0.0,20,EARLY SWEET,Clam
VIDEXPORT,24E04434,05/29/2024,Entry,2340.0,2340.0,0,EARLY SWEET,Bag
VIDEXPORT,24E04434,05/29/2024,Sale,-180.0,2160.0,0,EARLY SWEET,Bag
VIDEXPORT,24E04434,05/30/2024,Sale,-180.0,1980.0,1,EARLY SWEET,Bag
VIDEXPORT,24E04434,05/30/2024,Sale,-1620.0,360.0,1,EARLY SWEET,Bag
VIDEXPORT,24E04434,05/30/2024,Sale,-90.0,270.0,1,EARLY SWEET,Bag
VIDEXPORT,24E04434,05/31/2024,Sale,-270.0,0.0,2,EARLY SWEET,Bag
VIDEXPORT,24E04435,05/29/2024,Entry,2080.0,2080.0,0,EARLY SWEET,Clam
VIDEXPORT,24E04435,06/08/2024,Sale,-1920.0,160.0,10,EARLY SWEET,Clam
VIDEXPORT,24E04435,06/15/2024,Sale,-160.0,0.0,17,EARLY SWEET,Clam
VIDEXPORT,24E04436,05/30/2024,Entry,1800.0,1800.0,0,FLAME,Bag
VIDEXPORT,24E04436,06/13/2024,Sale,-810.0,990.0,14,FLAME,Bag
VIDEXPORT,24E04436,06/14/2024,Sale,-990.0,0.0,15,FLAME,Bag
VIDEXPORT,24E04437,05/29/2024,Entry,2240.0,2240.0,0,EARLY SWEET,Clam
VIDEXPORT,24E04437,06/13/2024,Sale,-960.0,1280.0,15,EARLY SWEET,Clam
VIDEXPORT,24E04437,06/14/2024,Sale,-720.0,560.0,16,EARLY SWEET,Clam
VIDEXPORT,24E04437,06/14/2024,Sale,-240.0,320.0,16,EARLY SWEET,Clam
VIDEXPORT,24E04437,06/15/2024,Sale,-240.0,80.0,17,EARLY SWEET,Clam
VIDEXPORT,24E04437,06/15/2024,Sale,-80.0,0.0,17,EARLY SWEET,Clam
VIDEXPORT,24E04438,05/30/2024,Entry,2340.0,2340.0,0,EARLY SWEET,Bag
VIDEXPORT,24E04438,05/30/2024,Sale,-1170.0,1170.0,0,EARLY SWEET,Bag
VIDEXPORT,24E04438,05/30/2024,Sale,-1170.0,0.0,0,EARLY SWEET,Bag
VIDEXPORT,24E04439,05/29/2024,Entry,2340.0,2340.0,0,EARLY SWEET,Bag
VIDEXPORT,24E04439,05/30/2024,Sale,-900.0,1440.0,1,EARLY SWEET,Bag
VIDEXPORT,24E04439,05/30/2024,Sale,-900.0,540.0,1,EARLY SWEET,Bag
VIDEXPORT,24E04439,05/30/2024,Sale,-450.0,90.0,1,EARLY SWEET,Bag
VIDEXPORT,24E04439,06/06/2024,Sale,-85.0,5.0,8,EARLY SWEET,Bag
VIDEXPORT,24E04440,05/30/2024,Entry,2520.0,2520.0,0,EARLY SWEET,Bag
VIDEXPORT,24E04440,06/06/2024,Sale,-1980.0,540.0,7,EARLY SWEET,Bag
VIDEXPORT,24E04440,06/12/2024,Sale,-360.0,180.0,13,EARLY SWEET,Bag
VIDEXPORT,24E04440,06/12/2024,Sale,-180.0,0.0,13,EARLY SWEET,Bag
VIDEXPORT,24E04442,05/29/2024,Entry,1280.0,1280.0,0,EARLY SWEET,Clam
VIDEXPORT,24E04442,05/29/2024,Entry,900.0,2180.0,0,EARLY SWEET,Clam
VIDEXPORT,24E04442,05/31/2024,Sale,-900.0,1280.0,2,EARLY SWEET,Clam
VIDEXPORT,24E04442,06/03/2024,Sale,-800.0,480.0,5,EARLY SWEET,Clam
VIDEXPORT,24E04442,06/03/2024,Sale,-400.0,80.0,5,EARLY SWEET,Clam
VIDEXPORT,24E04442,07/15/2024,Sale,-80.0,0.0,47,EARLY SWEET,Clam
VIDEXPORT,24E04444,05/30/2024,Entry,2070.0,2070.0,0,FLAME,Bag
VIDEXPORT,24E04444,06/01/2024,Sale,-630.0,1440.0,2,FLAME,Bag
VIDEXPORT,24E04444,06/01/2024,Sale,-180.0,1260.0,2,FLAME,Bag
VIDEXPORT,24E04444,06/03/2024,Sale,-720.0,540.0,4,FLAME,Bag
VIDEXPORT,24E04444,06/05/2024,Sale,-180.0,360.0,6,FLAME,Bag
VIDEXPORT,24E04444,06/06/2024,Sale,-360.0,0.0,7,FLAME,Bag
VIDEXPORT,24E04445,05/31/2024,Entry,1530.0,1530.0,0,FLAME,Bag
VIDEXPORT,24E04445,05/31/2024,Entry,180.0,1710.0,0,SUMMER ROYAL,Bag
VIDEXPORT,24E04445,06/04/2024,Sale,-180.0,1530.0,4,SUMMER ROYAL,Bag
VIDEXPORT,24E04445,06/12/2024,Sale,-630.0,900.0,12,FLAME,Bag
VIDEXPORT,24E04445,06/17/2024,Sale,-540.0,360.0,17,FLAME,Bag
VIDEXPORT,24E04445,06/17/2024,Sale,-90.0,270.0,17,FLAME,Bag
VIDEXPORT,24E04445,06/18/2024,Sale,-270.0,0.0,18,FLAME,Bag
VIDEXPORT,24E04446,05/30/2024,Entry,1260.0,1260.0,0,FLAME,Bag
VIDEXPORT,24E04446,05/30/2024,Entry,360.0,1620.0,0,FLAME,Bag
VIDEXPORT,24E04446,05/30/2024,Entry,360.0,1980.0,0,SUMMER ROYAL,Bag
VIDEXPORT,24E04446,05/31/2024,Sale,-990.0,990.0,1,FLAME,Bag
VIDEXPORT,24E04446,05/31/2024,Sale,-90.0,900.0,1,SUMMER ROYAL,Bag
VIDEXPORT,24E04446,06/01/2024,Sale,-240.0,660.0,2,FLAME,Bag
VIDEXPORT,24E04446,06/01/2024,Sale,-30.0,630.0,2,FLAME,Bag
VIDEXPORT,24E04446,06/03/2024,Sale,-90.0,540.0,4,FLAME,Bag
VIDEXPORT,24E04446,06/05/2024,Sale,-270.0,270.0,6,SUMMER ROYAL,Bag
VIDEXPORT,24E04446,06/07/2024,Sale,-180.0,90.0,8,FLAME,Bag
VIDEXPORT,24E04446,06/08/2024,Sale,-42.0,48.0,9,BI-COLOR,Clam
VIDEXPORT,24E04454,05/30/2024,Entry,1920.0,1920.0,0,EARLY SWEET,Clam
VIDEXPORT,24E04454,06/04/2024,Sale,-640.0,1280.0,5,EARLY SWEET,Clam
VIDEXPORT,24E04454,06/05/2024,Sale,-560.0,720.0,6,EARLY SWEET,Clam
VIDEXPORT,24E04454,06/07/2024,Sale,-80.0,640.0,8,EARLY SWEET,Clam
VIDEXPORT,24E04454,06/11/2024,Sale,-638.0,2.0,12,EARLY SWEET,Clam
VIDEXPORT,24E04454,06/11/2024,Sale,-2.0,0.0,12,EARLY SWEET,Clam
VIDEXPORT,24E04456,05/30/2024,Entry,2080.0,2080.0,0,EARLY SWEET,Clam
VIDEXPORT,24E04456,06/11/2024,Sale,-1840.0,240.0,12,EARLY SWEET,Clam
VIDEXPORT,24E04456,06/15/2024,Sale,-160.0,80.0,16,EARLY SWEET,Clam
VIDEXPORT,24E04456,07/15/2024,Sale,-80.0,0.0,46,EARLY SWEET,Clam
VIDEXPORT,24E04460,05/30/2024,Entry,2520.0,2520.0,0,EARLY SWEET,Bag
VIDEXPORT,24E04460,05/31/2024,Sale,-360.0,2160.0,1,EARLY SWEET,Bag
VIDEXPORT,24E04460,05/31/2024,Sale,-1800.0,360.0,1,EARLY SWEET,Bag
VIDEXPORT,24E04460,05/31/2024,Sale,-180.0,180.0,1,EARLY SWEET,Bag
VIDEXPORT,24E04460,05/31/2024,Sale,-180.0,0.0,1,EARLY SWEET,Bag
VIDEXPORT,24E04463,05/30/2024,Entry,2520.0,2520.0,0,EARLY SWEET,Bag
VIDEXPORT,24E04463,05/31/2024,Sale,-1620.0,900.0,1,EARLY SWEET,Bag
VIDEXPORT,24E04463,05/31/2024,Sale,-360.0,540.0,1,EARLY SWEET,Bag
VIDEXPORT,24E04463,05/31/2024,Sale,-180.0,360.0,1,EARLY SWEET,Bag
VIDEXPORT,24E04463,05/31/2024,Sale,-180.0,180.0,1,EARLY SWEET,Bag
VIDEXPORT,24E04463,06/21/2024,Sale,-180.0,0.0,22,EARLY SWEET,Bag
VIDEXPORT,24E04464,05/30/2024,Entry,2080.0,2080.0,0,EARLY SWEET,Clam
VIDEXPORT,24E04464,06/13/2024,Sale,-640.0,1440.0,14,EARLY SWEET,Clam
VIDEXPORT,24E04464,06/15/2024,Sale,-320.0,1120.0,16,EARLY SWEET,Clam
VIDEXPORT,24E04464,06/15/2024,Sale,-960.0,160.0,16,EARLY SWEET,Clam
VIDEXPORT,24E04464,06/18/2024,Sale,-160.0,0.0,19,EARLY SWEET,Clam
VIDEXPORT,24E04465,05/30/2024,Entry,1920.0,1920.0,0,EARLY SWEET,Clam
VIDEXPORT,24E04465,06/03/2024,Sale,-1120.0,800.0,4,EARLY SWEET,Clam
VIDEXPORT,24E04465,06/04/2024,Sale,-640.0,160.0,5,EARLY SWEET,Clam
VIDEXPORT,24E04465,06/05/2024,Sale,-80.0,80.0,6,EARLY SWEET,Clam
VIDEXPORT,24E04465,06/11/2024,Sale,-80.0,0.0,12,EARLY SWEET,Clam
VIDEXPORT,24E04466,05/30/2024,Entry,2070.0,2070.0,0,FLAME,Bag
VIDEXPORT,24E04466,06/03/2024,Sale,-720.0,1350.0,4,FLAME,Bag
VIDEXPORT,24E04466,06/04/2024,Sale,-540.0,810.0,5,FLAME,Bag
VIDEXPORT,24E04466,06/11/2024,Sale,-180.0,630.0,12,FLAME,Bag
VIDEXPORT,24E04466,06/14/2024,Sale,-360.0,270.0,15,FLAME,Bag
VIDEXPORT,24E04466,06/15/2024,Sale,-270.0,0.0,16,FLAME,Bag
VIDEXPORT,24E04467,05/30/2024,Entry,2520.0,2520.0,0,EARLY SWEET,Bag
VIDEXPORT,24E04467,05/30/2024,Sale,-1800.0,720.0,0,EARLY SWEET,Bag
VIDEXPORT,24E04467,05/31/2024,Sale,-540.0,180.0,1,EARLY SWEET,Bag
VIDEXPORT,24E04467,05/31/2024,Sale,-90.0,90.0,1,EARLY SWEET,Bag
VIDEXPORT,24E04467,05/31/2024,Sale,-90.0,0.0,1,EARLY SWEET,Bag
VIDEXPORT,24E04468,05/30/2024,Entry,2340.0,2340.0,0,EARLY SWEET,Bag
VIDEXPORT,24E04468,05/31/2024,Sale,-990.0,1350.0,1,EARLY SWEET,Bag
VIDEXPORT,24E04468,05/31/2024,Sale,-1260.0,90.0,1,EARLY SWEET,Bag
VIDEXPORT,24E04468,05/31/2024,Sale,-90.0,0.0,1,EARLY SWEET,Bag
VIDEXPORT,24E04469,05/31/2024,Entry,1980.0,1980.0,0,FLAME,Bag
VIDEXPORT,24E04469,06/03/2024,Sale,-90.0,1890.0,3,FLAME,Bag
VIDEXPORT,24E04469,06/03/2024,Sale,-1890.0,0.0,3,FLAME,Bag
VIDEXPORT,24E04470,05/31/2024,Entry,810.0,810.0,0,EARLY SWEET,Bag
VIDEXPORT,24E04470,05/31/2024,Entry,1710.0,2520.0,0,FLAME,Bag
VIDEXPORT,24E04470,06/01/2024,Sale,-450.0,2070.0,1,EARLY SWEET,Bag
VIDEXPORT,24E04470,06/03/2024,Sale,-90.0,1980.0,3,EARLY SWEET,Bag
VIDEXPORT,24E04470,06/03/2024,Sale,-540.0,1440.0,3,FLAME,Bag
VIDEXPORT,24E04470,06/04/2024,Sale,-270.0,1170.0,4,EARLY SWEET,Bag
VIDEXPORT,24E04470,06/13/2024,Sale,-180.0,990.0,13,FLAME,Bag
VIDEXPORT,24E04470,06/14/2024,Sale,-540.0,450.0,14,FLAME,Bag
VIDEXPORT,24E04470,06/14/2024,Sale,-450.0,0.0,14,FLAME,Bag
VIDEXPORT,24E04472,05/31/2024,Entry,1600.0,1600.0,0,FLAME,Bag
VIDEXPORT,24E04472,05/31/2024,Entry,540.0,2140.0,0,SUMMER ROYAL,Bag
VIDEXPORT,24E04472,06/03/2024,Sale,-270.0,1870.0,3,SUMMER ROYAL,Bag
VIDEXPORT,24E04472,06/08/2024,Sale,-90.0,1780.0,8,SUMMER ROYAL,Bag
VIDEXPORT,24E04472,06/08/2024,Sale,-90.0,1690.0,8,SUMMER ROYAL,Bag
VIDEXPORT,24E04472,06/11/2024,Sale,-90.0,1600.0,11,SUMMER ROYAL,Bag
VIDEXPORT,24E04472,06/15/2024,Sale,-1600.0,0.0,15,FLAME,Clam
VIDEXPORT,24E04473,05/30/2024,Entry,2080.0,2080.0,0,EARLY SWEET,Clam
VIDEXPORT,24E04473,06/03/2024,Sale,-320.0,1760.0,4,EARLY SWEET,Clam
VIDEXPORT,24E04473,06/04/2024,Sale,-480.0,1280.0,5,EARLY SWEET,Clam
VIDEXPORT,24E04473,06/08/2024,Sale,-160.0,1120.0,9,EARLY SWEET,Clam
VIDEXPORT,24E04473,06/11/2024,Sale,-1120.0,0.0,12,EARLY SWEET,Clam
VIDEXPORT,24E04474,05/31/2024,Entry,2160.0,2160.0,0,EARLY SWEET,Clam
VIDEXPORT,24E04474,06/15/2024,Sale,-1360.0,800.0,15,EARLY SWEET,Clam
VIDEXPORT,24E04474,06/15/2024,Sale,-240.0,560.0,15,EARLY SWEET,Clam
VIDEXPORT,24E04474,06/18/2024,Sale,-480.0,80.0,18,EARLY SWEET,Clam
VIDEXPORT,24E04474,07/15/2024,Sale,-80.0,0.0,45,EARLY SWEET,Clam
VIDEXPORT,24E04475,05/31/2024,Entry,1170.0,1170.0,0,FLAME,Bag
VIDEXPORT,24E04475,05/31/2024,Entry,1170.0,2340.0,0,SUMMER ROYAL,Bag
VIDEXPORT,24E04475,06/01/2024,Sale,-90.0,2250.0,1,SUMMER ROYAL,Bag
VIDEXPORT,24E04475,06/01/2024,Sale,-270.0,1980.0,1,SUMMER ROYAL,Bag
VIDEXPORT,24E04475,06/01/2024,Sale,-180.0,1800.0,1,SUMMER ROYAL,Bag
VIDEXPORT,24E04475,06/01/2024,Sale,-270.0,1530.0,1,SUMMER ROYAL,Bag
VIDEXPORT,24E04475,06/01/2024,Sale,-90.0,1440.0,1,SUMMER ROYAL,Bag
VIDEXPORT,24E04475,06/01/2024,Sale,-180.0,1260.0,1,SUMMER ROYAL,Bag
VIDEXPORT,24E04475,06/01/2024,Sale,-90.0,1170.0,1,SUMMER ROYAL,Bag
VIDEXPORT,24E04475,06/15/2024,Sale,-540.0,630.0,15,FLAME,Bag
VIDEXPORT,24E04475,06/18/2024,Sale,-180.0,450.0,18,FLAME,Bag
VIDEXPORT,24E04475,06/26/2024,Sale,-450.0,0.0,26,FLAME,Bag
VIDEXPORT,24E04477,05/31/2024,Entry,2160.0,2160.0,0,EARLY SWEET,Bag
VIDEXPORT,24E04477,06/01/2024,Sale,-1980.0,180.0,1,EARLY SWEET,Bag
VIDEXPORT,24E04477,06/03/2024,Sale,-180.0,0.0,3,EARLY SWEET,Bag
VIDEXPORT,24E04485,06/01/2024,Entry,2160.0,2160.0,0,EARLY SWEET,Bag
VIDEXPORT,24E04485,06/01/2024,Sale,-990.0,1170.0,0,EARLY SWEET,Bag
VIDEXPORT,24E04485,06/01/2024,Sale,-1170.0,0.0,0,EARLY SWEET,Bag
VIDEXPORT,24E04491,05/31/2024,Entry,2520.0,2520.0,0,EARLY SWEET,Bag
VIDEXPORT,24E04491,05/31/2024,Sale,-1440.0,1080.0,0,EARLY SWEET,Bag
VIDEXPORT,24E04491,06/01/2024,Sale,-180.0,900.0,1,EARLY SWEET,Bag
VIDEXPORT,24E04491,06/01/2024,Sale,-900.0,0.0,1,EARLY SWEET,Bag
VIDEXPORT,24E04501,05/31/2024,Entry,2340.0,2340.0,0,FLAME,Clam
VIDEXPORT,24E04501,06/05/2024,Sale,-750.0,1590.0,5,BI-COLOR,Clam
VIDEXPORT,24E04501,06/06/2024,Sale,-150.0,1440.0,6,BI-COLOR,Clam
VIDEXPORT,24E04501,06/11/2024,Sale,-720.0,720.0,11,FLAME,Bag
VIDEXPORT,24E04501,06/13/2024,Sale,-270.0,450.0,13,FLAME,Bag
VIDEXPORT,24E04501,08/02/2024,Sale,-90.0,360.0,63,FLAME,Bag
VIDEXPORT,24E04502,06/01/2024,Entry,2160.0,2160.0,0,EARLY SWEET,Bag
VIDEXPORT,24E04502,06/01/2024,Sale,-450.0,1710.0,0,EARLY SWEET,Bag
VIDEXPORT,24E04502,06/01/2024,Sale,-180.0,1530.0,0,EARLY SWEET,Bag
VIDEXPORT,24E04502,06/01/2024,Sale,-540.0,990.0,0,EARLY SWEET,Bag
VIDEXPORT,24E04502,06/03/2024,Sale,-90.0,900.0,2,EARLY SWEET,Bag
VIDEXPORT,24E04502,06/03/2024,Sale,-270.0,630.0,2,EARLY SWEET,Bag
VIDEXPORT,24E04502,06/04/2024,Sale,-75.0,555.0,3,BI-COLOR,Clam
VIDEXPORT,24E04502,06/04/2024,Sale,-75.0,480.0,3,BI-COLOR,Clam
VIDEXPORT,24E04502,06/04/2024,Sale,-150.0,330.0,3,BI-COLOR,Clam
VIDEXPORT,24E04502,06/04/2024,Sale,-90.0,240.0,3,EARLY SWEET,Bag
VIDEXPORT,24E04502,06/04/2024,Sale,-270.0,-30.0,3,EARLY SWEET,Bag
VIDEXPORT,24E04502,06/05/2024,Sale,-150.0,-180.0,4,BI-COLOR,Clam
VIDEXPORT,24E04502,06/08/2024,Sale,-32.0,-212.0,7,BI-COLOR,Clam
VIDEXPORT,24E04503,06/01/2024,Entry,2070.0,2070.0,0,EARLY SWEET,Bag
VIDEXPORT,24E04503,06/04/2024,Sale,-630.0,1440.0,3,EARLY SWEET,Bag
VIDEXPORT,24E04503,06/05/2024,Sale,-1440.0,0.0,4,EARLY SWEET,Bag
VIDEXPORT,24E04504,06/01/2024,Entry,2160.0,2160.0,0,EARLY SWEET,Bag
VIDEXPORT,24E04504,06/01/2024,Entry,360.0,2520.0,0,EARLY SWEET,Bag
VIDEXPORT,24E04504,06/01/2024,Sale,-360.0,2160.0,0,EARLY SWEET,Bag
VIDEXPORT,24E04504,06/01/2024,Sale,-1980.0,180.0,0,EARLY SWEET,Bag
VIDEXPORT,24E04504,06/04/2024,Sale,-180.0,0.0,3,EARLY SWEET,Bag
VIDEXPORT,24E04505,05/31/2024,Entry,2160.0,2160.0,0,EARLY SWEET,Bag
VIDEXPORT,24E04505,05/31/2024,Sale,-360.0,1800.0,0,EARLY SWEET,Bag
VIDEXPORT,24E04505,06/01/2024,Sale,-540.0,1260.0,1,EARLY SWEET,Bag
VIDEXPORT,24E04505,06/01/2024,Sale,-990.0,270.0,1,EARLY SWEET,Bag
VIDEXPORT,24E04505,06/01/2024,Sale,-270.0,0.0,1,EARLY SWEET,Bag
VIDEXPORT,24E04506,06/01/2024,Entry,810.0,810.0,0,FLAME,Bag
VIDEXPORT,24E04506,06/01/2024,Entry,990.0,1800.0,0,SUMMER ROYAL,Bag
VIDEXPORT,24E04506,06/01/2024,Sale,-180.0,1620.0,0,SUMMER ROYAL,Bag
VIDEXPORT,24E04506,06/01/2024,Sale,-270.0,1350.0,0,SUMMER ROYAL,Bag
VIDEXPORT,24E04506,06/01/2024,Sale,-270.0,1080.0,0,SUMMER ROYAL,Bag
VIDEXPORT,24E04506,06/04/2024,Sale,-90.0,990.0,3,SUMMER ROYAL,Bag
VIDEXPORT,24E04506,06/04/2024,Sale,-180.0,810.0,3,SUMMER ROYAL,Bag
VIDEXPORT,24E04506,06/13/2024,Sale,-720.0,90.0,12,FLAME,Bag
VIDEXPORT,24E04506,06/14/2024,Sale,-90.0,0.0,13,FLAME,Bag
VIDEXPORT,24E04507,06/01/2024,Entry,2340.0,2340.0,0,FLAME,Bag
VIDEXPORT,24E04507,06/13/2024,Sale,-1980.0,360.0,12,FLAME,Bag
VIDEXPORT,24E04507,06/18/2024,Sale,-270.0,90.0,17,FLAME,Bag
VIDEXPORT,24E04507,06/26/2024,Sale,-90.0,0.0,25,FLAME,Bag
VIDEXPORT,24E04508,06/03/2024,Entry,2160.0,2160.0,0,EARLY SWEET,Bag
VIDEXPORT,24E04508,06/03/2024,Entry,360.0,2520.0,0,EARLY SWEET,Bag
VIDEXPORT,24E04508,06/03/2024,Sale,-450.0,2070.0,0,EARLY SWEET,Bag
VIDEXPORT,24E04508,06/03/2024,Sale,-1530.0,540.0,0,EARLY SWEET,Bag
VIDEXPORT,24E04508,06/03/2024,Sale,-540.0,0.0,0,EARLY SWEET,Bag
VIDEXPORT,24E04509,06/01/2024,Entry,2340.0,2340.0,0,FLAME,Bag
VIDEXPORT,24E04509,06/03/2024,Sale,-1980.0,360.0,2,FLAME,Bag
VIDEXPORT,24E04509,06/07/2024,Sale,-360.0,0.0,6,FLAME,Bag
VIDEXPORT,24E04510,05/31/2024,Entry,180.0,180.0,0,FLAME,Clam
VIDEXPORT,24E04510,05/31/2024,Entry,1680.0,1860.0,0,FLAME,Clam
VIDEXPORT,24E04510,06/06/2024,Sale,-1440.0,420.0,6,FLAME,Clam
VIDEXPORT,24E04510,06/06/2024,Sale,-240.0,180.0,6,FLAME,Clam
VIDEXPORT,24E04510,06/14/2024,Sale,-180.0,0.0,14,FLAME,Bag
VIDEXPORT,24E04513,06/01/2024,Entry,2160.0,2160.0,0,EARLY SWEET,Bag
VIDEXPORT,24E04513,06/01/2024,Entry,360.0,2520.0,0,EARLY SWEET,Bag
VIDEXPORT,24E04513,06/01/2024,Sale,-990.0,1530.0,0,EARLY SWEET,Bag
VIDEXPORT,24E04513,06/01/2024,Sale,-360.0,1170.0,0,EARLY SWEET,Bag
VIDEXPORT,24E04513,06/01/2024,Sale,-1170.0,0.0,0,EARLY SWEET,Bag
VIDEXPORT,24E04515,06/01/2024,Entry,1980.0,1980.0,0,EARLY SWEET,Bag
VIDEXPORT,24E04515,06/01/2024,Sale,-900.0,1080.0,0,EARLY SWEET,Bag
VIDEXPORT,24E04515,06/01/2024,Sale,-540.0,540.0,0,EARLY SWEET,Bag
VIDEXPORT,24E04515,06/03/2024,Sale,-450.0,90.0,2,EARLY SWEET,Bag
VIDEXPORT,24E04515,06/03/2024,Sale,-90.0,0.0,2,EARLY SWEET,Bag
VIDEXPORT,24E04516,06/03/2024,Entry,1700.0,1700.0,0,EARLY SWEET,Bag
VIDEXPORT,24E04516,06/03/2024,Entry,255.0,1955.0,0,SUMMER ROYAL,Bag
VIDEXPORT,24E04516,06/03/2024,Sale,-425.0,1530.0,0,EARLY SWEET,Bag
VIDEXPORT,24E04516,06/03/2024,Sale,-425.0,1105.0,0,EARLY SWEET,Bag
VIDEXPORT,24E04516,06/03/2024,Sale,-510.0,595.0,0,EARLY SWEET,Bag
VIDEXPORT,24E04516,06/05/2024,Sale,-340.0,255.0,2,EARLY SWEET,Bag
VIDEXPORT,24E04516,06/13/2024,Sale,-85.0,170.0,10,SUMMER ROYAL,Bag
VIDEXPORT,24E04516,06/14/2024,Sale,-85.0,85.0,11,SUMMER ROYAL,Bag
VIDEXPORT,24E04516,06/14/2024,Sale,-85.0,0.0,11,SUMMER ROYAL,Bag
VIDEXPORT,24E04523,06/07/2024,Entry,2520.0,2520.0,0,SUGAR DROP,Bag
VIDEXPORT,24E04523,06/07/2024,Sale,-540.0,1980.0,0,SUGAR DROP,Bag
VIDEXPORT,24E04523,06/07/2024,Sale,-1080.0,900.0,0,SUGAR DROP,Bag
VIDEXPORT,24E04523,06/07/2024,Sale,-450.0,450.0,0,SUGAR DROP,Bag
VIDEXPORT,24E04523,06/07/2024,Sale,-450.0,0.0,0,SUGAR DROP,Bag
VIDEXPORT,24E04530,06/06/2024,Entry,2520.0,2520.0,0,SUGAR DROP,Bag
VIDEXPORT,24E04530,06/07/2024,Sale,-540.0,1980.0,1,SUGAR DROP,Bag
VIDEXPORT,24E04530,06/07/2024,Sale,-1440.0,540.0,1,SUGAR DROP,Bag
VIDEXPORT,24E04530,06/07/2024,Sale,-270.0,270.0,1,SUGAR DROP,Bag
VIDEXPORT,24E04530,06/08/2024,Sale,-90.0,180.0,2,SUGAR DROP,Bag
VIDEXPORT,24E04530,06/08/2024,Sale,-180.0,0.0,2,SUGAR DROP,Bag
VIDEXPORT,24E04531,06/03/2024,Entry,2520.0,2520.0,0,FLAME,Bag
VIDEXPORT,24E04531,06/07/2024,Sale,-90.0,2430.0,4,FLAME,Bag
VIDEXPORT,24E04531,06/08/2024,Sale,-450.0,1980.0,5,FLAME,Bag
VIDEXPORT,24E04531,06/08/2024,Sale,-90.0,1890.0,5,FLAME,Bag
VIDEXPORT,24E04531,06/08/2024,Sale,-1620.0,270.0,5,FLAME,Bag
VIDEXPORT,24E04531,06/10/2024,Sale,-180.0,90.0,7,FLAME,Bag
VIDEXPORT,24E04531,06/13/2024,Sale,-90.0,0.0,10,FLAME,Bag
VIDEXPORT,24E04533,06/06/2024,Entry,2340.0,2340.0,0,SUGAR DROP,Bag
VIDEXPORT,24E04533,06/07/2024,Sale,-1980.0,360.0,1,SUGAR DROP,Bag
VIDEXPORT,24E04533,06/07/2024,Sale,-360.0,0.0,1,SUGAR DROP,Bag
VIDEXPORT,24E04534,06/01/2024,Entry,1360.0,1360.0,0,FLAME,Bag
VIDEXPORT,24E04534,06/01/2024,Entry,540.0,1900.0,0,SUMMER ROYAL,Bag
VIDEXPORT,24E04534,06/03/2024,Sale,-90.0,1810.0,2,SUMMER ROYAL,Bag
VIDEXPORT,24E04534,06/03/2024,Sale,-360.0,1450.0,2,SUMMER ROYAL,Bag
VIDEXPORT,24E04534,06/05/2024,Sale,-90.0,1360.0,4,SUMMER ROYAL,Bag
VIDEXPORT,24E04534,06/18/2024,Sale,-1190.0,170.0,17,FLAME,Bag
VIDEXPORT,24E04534,06/26/2024,Sale,-170.0,0.0,25,FLAME,Bag
VIDEXPORT,24E04539,06/01/2024,Entry,2080.0,2080.0,0,FLAME,Clam
VIDEXPORT,24E04539,06/13/2024,Sale,-1920.0,160.0,12,FLAME,Clam
VIDEXPORT,24E04539,07/19/2024,Sale,-160.0,0.0,48,FLAME,Clam
VIDEXPORT,24E04540,06/01/2024,Entry,90.0,90.0,0,FLAME,Bag
VIDEXPORT,24E04540,06/01/2024,Entry,1710.0,1800.0,0,FLAME,Bag
VIDEXPORT,24E04540,06/07/2024,Sale,-540.0,1260.0,6,FLAME,Bag
VIDEXPORT,24E04540,06/11/2024,Sale,-360.0,900.0,10,FLAME,Bag
VIDEXPORT,24E04540,06/11/2024,Sale,-90.0,810.0,10,FLAME,Bag
VIDEXPORT,24E04540,06/13/2024,Sale,-90.0,720.0,12,FLAME,Bag
VIDEXPORT,24E04540,06/13/2024,Sale,-630.0,90.0,12,FLAME,Bag
VIDEXPORT,24E04540,06/14/2024,Sale,-90.0,0.0,13,FLAME,Bag
VIDEXPORT,24E04546,06/06/2024,Entry,1260.0,1260.0,0,SUGAR DROP,Bag
VIDEXPORT,24E04546,06/07/2024,Sale,-180.0,1080.0,1,SUGAR DROP,Bag
VIDEXPORT,24E04546,06/07/2024,Sale,-540.0,540.0,1,SUGAR DROP,Bag
VIDEXPORT,24E04546,06/07/2024,Sale,-90.0,450.0,1,SUGAR DROP,Bag
VIDEXPORT,24E04546,06/07/2024,Sale,-450.0,0.0,1,SUGAR DROP,Bag
VIDEXPORT,24E04547,06/04/2024,Sale,-630.0,-630.0,0,EARLY SWEET,Bag
VIDEXPORT,24E04547,06/06/2024,Entry,720.0,90.0,2,EARLY SWEET,Bag
VIDEXPORT,24E04547,06/06/2024,Entry,180.0,270.0,2,FLAME,Bag
VIDEXPORT,24E04547,06/06/2024,Entry,630.0,900.0,2,SUGAR DROP,Bag
VIDEXPORT,24E04547,06/08/2024,Sale,-180.0,720.0,4,SUGAR DROP,Bag
VIDEXPORT,24E04547,06/08/2024,Sale,-450.0,270.0,4,SUGAR DROP,Bag
VIDEXPORT,24E04547,06/13/2024,Sale,-90.0,180.0,9,EARLY SWEET,Bag
VIDEXPORT,24E04547,06/15/2024,Sale,-180.0,0.0,11,FLAME,Bag
VIDEXPORT,24E04548,06/03/2024,Entry,2160.0,2160.0,0,SUGAR DROP,Bag
VIDEXPORT,24E04548,06/05/2024,Sale,-1980.0,180.0,2,SUGAR DROP,Bag
VIDEXPORT,24E04548,06/06/2024,Sale,-180.0,0.0,3,SUGAR DROP,Bag
VIDEXPORT,24E04549,06/03/2024,Entry,2160.0,2160.0,0,FLAME,Bag
VIDEXPORT,24E04549,06/04/2024,Sale,-810.0,1350.0,1,FLAME,Bag
VIDEXPORT,24E04549,06/05/2024,Sale,-450.0,900.0,2,FLAME,Bag
VIDEXPORT,24E04549,06/05/2024,Sale,-900.0,0.0,2,FLAME,Bag
VIDEXPORT,24E04550,06/06/2024,Entry,2520.0,2520.0,0,SUGAR DROP,Bag
VIDEXPORT,24E04550,06/07/2024,Sale,-1980.0,540.0,1,SUGAR DROP,Bag
VIDEXPORT,24E04550,06/09/2024,Sale,-540.0,0.0,3,SUGAR DROP,Bag
VIDEXPORT,24E04551,06/03/2024,Entry,2520.0,2520.0,0,FLAME,Bag
VIDEXPORT,24E04551,06/06/2024,Sale,-360.0,2160.0,3,FLAME,Bag
VIDEXPORT,24E04551,06/06/2024,Sale,-720.0,1440.0,3,FLAME,Bag
VIDEXPORT,24E04551,06/06/2024,Sale,-450.0,990.0,3,FLAME,Bag
VIDEXPORT,24E04551,06/07/2024,Sale,-90.0,900.0,4,FLAME,Bag
VIDEXPORT,24E04551,06/07/2024,Sale,-900.0,0.0,4,FLAME,Bag
VIDEXPORT,24E04552,06/03/2024,Entry,2160.0,2160.0,0,SUGAR DROP,Bag
VIDEXPORT,24E04552,06/06/2024,Sale,-360.0,1800.0,3,SUGAR DROP,Bag
VIDEXPORT,24E04552,06/06/2024,Sale,-1800.0,0.0,3,SUGAR DROP,Bag
VIDEXPORT,24E04556,06/06/2024,Entry,2160.0,2160.0,0,SUGAR DROP,Bag
VIDEXPORT,24E04556,06/07/2024,Sale,-540.0,1620.0,1,SUGAR DROP,Bag
VIDEXPORT,24E04556,06/07/2024,Sale,-990.0,630.0,1,SUGAR DROP,Bag
VIDEXPORT,24E04556,06/07/2024,Sale,-180.0,450.0,1,SUGAR DROP,Bag
VIDEXPORT,24E04556,06/07/2024,Sale,-90.0,360.0,1,SUGAR DROP,Bag
VIDEXPORT,24E04556,06/08/2024,Sale,-360.0,0.0,2,SUGAR DROP,Bag
VIDEXPORT,24E04558,06/03/2024,Entry,2160.0,2160.0,0,EARLY SWEET,Bag
VIDEXPORT,24E04558,06/03/2024,Sale,-1350.0,810.0,0,EARLY SWEET,Bag
VIDEXPORT,24E04558,06/03/2024,Sale,-450.0,360.0,0,EARLY SWEET,Bag
VIDEXPORT,24E04558,06/03/2024,Sale,-180.0,180.0,0,EARLY SWEET,Bag
VIDEXPORT,24E04558,06/03/2024,Sale,-180.0,0.0,0,EARLY SWEET,Bag
VIDEXPORT,24E04561,06/06/2024,Entry,1800.0,1800.0,0,SUGAR DROP,Bag
VIDEXPORT,24E04561,06/07/2024,Sale,-900.0,900.0,1,SUGAR DROP,Bag
VIDEXPORT,24E04561,06/07/2024,Sale,-540.0,360.0,1,SUGAR DROP,Bag
VIDEXPORT,24E04561,06/08/2024,Sale,-270.0,90.0,2,SUGAR DROP,Bag
VIDEXPORT,24E04561,06/13/2024,Sale,-90.0,0.0,7,SUGAR DROP,Bag
VIDEXPORT,24E04562,06/06/2024,Entry,2340.0,2340.0,0,SUGAR DROP,Bag
VIDEXPORT,24E04562,06/08/2024,Sale,-1890.0,450.0,2,SUGAR DROP,Bag
VIDEXPORT,24E04562,06/08/2024,Sale,-179.0,271.0,2,SUGAR DROP,Bag
VIDEXPORT,24E04562,06/08/2024,Sale,-180.0,91.0,2,SUGAR DROP,Bag
VIDEXPORT,24E04562,06/08/2024,Sale,-90.0,1.0,2,SUGAR DROP,Bag
VIDEXPORT,24E04563,06/03/2024,Entry,2340.0,2340.0,0,FLAME,Bag
VIDEXPORT,24E04563,06/06/2024,Sale,-90.0,2250.0,3,FLAME,Bag
VIDEXPORT,24E04563,06/07/2024,Sale,-810.0,1440.0,4,FLAME,Bag
VIDEXPORT,24E04563,06/07/2024,Sale,-990.0,450.0,4,FLAME,Bag
VIDEXPORT,24E04563,06/08/2024,Sale,-180.0,270.0,5,FLAME,Bag
VIDEXPORT,24E04563,06/19/2024,Sale,-90.0,180.0,16,FLAME,Bag
VIDEXPORT,24E04564,06/06/2024,Entry,1800.0,1800.0,0,SUGAR DROP,Bag
VIDEXPORT,24E04564,06/07/2024,Sale,-90.0,1710.0,1,SUGAR DROP,Bag
VIDEXPORT,24E04564,06/08/2024,Sale,-1620.0,90.0,2,SUGAR DROP,Bag
VIDEXPORT,24E04564,06/08/2024,Sale,-90.0,0.0,2,SUGAR DROP,Bag
VIDEXPORT,24E04565,06/04/2024,Entry,1980.0,1980.0,0,EARLY SWEET,Bag
VIDEXPORT,24E04565,06/05/2024,Sale,-90.0,1890.0,1,EARLY SWEET,Bag
VIDEXPORT,24E04565,06/05/2024,Sale,-900.0,990.0,1,EARLY SWEET,Bag
VIDEXPORT,24E04565,06/07/2024,Sale,-990.0,0.0,3,EARLY SWEET,Bag
VIDEXPORT,24E04566,06/03/2024,Entry,1800.0,1800.0,0,SUGAR DROP,Bag
VIDEXPORT,24E04566,06/06/2024,Sale,-270.0,1530.0,3,SUGAR DROP,Bag
VIDEXPORT,24E04566,06/06/2024,Sale,-1440.0,90.0,3,SUGAR DROP,Bag
VIDEXPORT,24E04566,06/11/2024,Sale,-90.0,0.0,8,SUGAR DROP,Bag
VIDEXPORT,24E04569,06/03/2024,Entry,1710.0,1710.0,0,SUGAR DROP,Bag
VIDEXPORT,24E04569,06/05/2024,Sale,-360.0,1350.0,2,SUGAR DROP,Bag
VIDEXPORT,24E04569,06/06/2024,Sale,-1350.0,0.0,3,SUGAR DROP,Bag
VIDEXPORT,24E04570,06/04/2024,Entry,1170.0,1170.0,0,FLAME,Clam
VIDEXPORT,24E04570,06/04/2024,Entry,1040.0,2210.0,0,FLAME,Clam
VIDEXPORT,24E04570,06/20/2024,Sale,-960.0,1250.0,16,FLAME,Clam
VIDEXPORT,24E04570,06/21/2024,Sale,-180.0,1070.0,17,FLAME,Bag
VIDEXPORT,24E04570,06/22/2024,Sale,-180.0,890.0,18,FLAME,Bag
VIDEXPORT,24E04570,07/05/2024,Sale,-90.0,800.0,31,FLAME,Bag
VIDEXPORT,24E04570,07/10/2024,Sale,-720.0,80.0,36,FLAME,Bag
VIDEXPORT,24E04570,07/19/2024,Sale,-80.0,0.0,45,FLAME,Clam
VIDEXPORT,24E04571,06/03/2024,Entry,2340.0,2340.0,0,FLAME,Bag
VIDEXPORT,24E04571,06/07/2024,Sale,-1710.0,630.0,4,FLAME,Bag
VIDEXPORT,24E04571,07/10/2024,Sale,-90.0,540.0,37,FLAME,Bag
VIDEXPORT,24E04571,07/11/2024,Sale,-150.0,390.0,38,FLAME,Clam
VIDEXPORT,24E04571,07/12/2024,Sale,-90.0,300.0,39,FLAME,Bag
VIDEXPORT,24E04571,07/20/2024,Sale,-46.0,254.0,47,FLAME,Clam
VIDEXPORT,24E04574,06/03/2024,Entry,1800.0,1800.0,0,EARLY SWEET,Bag
VIDEXPORT,24E04574,06/03/2024,Sale,-1530.0,270.0,0,EARLY SWEET,Bag
VIDEXPORT,24E04574,06/03/2024,Sale,-180.0,90.0,0,EARLY SWEET,Bag
VIDEXPORT,24E04574,06/04/2024,Sale,-90.0,0.0,1,EARLY SWEET,Bag
VIDEXPORT,24E04577,06/03/2024,Entry,2340.0,2340.0,0,EARLY SWEET,Bag
VIDEXPORT,24E04577,06/03/2024,Sale,-810.0,1530.0,0,EARLY SWEET,Bag
VIDEXPORT,24E04577,06/03/2024,Sale,-900.0,630.0,0,EARLY SWEET,Bag
VIDEXPORT,24E04577,06/03/2024,Sale,-540.0,90.0,0,EARLY SWEET,Bag
VIDEXPORT,24E04577,06/04/2024,Sale,-90.0,0.0,1,EARLY SWEET,Bag
VIDEXPORT,24E04578,06/03/2024,Entry,2160.0,2160.0,0,EARLY SWEET,Bag
VIDEXPORT,24E04578,06/03/2024,Sale,-1440.0,720.0,0,EARLY SWEET,Bag
VIDEXPORT,24E04578,06/04/2024,Sale,-90.0,630.0,1,EARLY SWEET,Bag
VIDEXPORT,24E04578,06/04/2024,Sale,-630.0,0.0,1,EARLY SWEET,Bag
VIDEXPORT,24E04579,06/03/2024,Entry,180.0,180.0,0,FLAME,Bag
VIDEXPORT,24E04579,06/03/2024,Entry,1710.0,1890.0,0,FLAME,Bag
VIDEXPORT,24E04579,06/04/2024,Sale,-180.0,1710.0,1,FLAME,Bag
VIDEXPORT,24E04579,06/08/2024,Sale,-180.0,1530.0,5,FLAME,Bag
VIDEXPORT,24E04579,06/11/2024,Sale,-810.0,720.0,8,FLAME,Bag
VIDEXPORT,24E04579,06/11/2024,Sale,-630.0,90.0,8,FLAME,Bag
VIDEXPORT,24E04579,08/02/2024,Sale,-90.0,0.0,60,FLAME,Bag
VIDEXPORT,24E04580,06/03/2024,Entry,2160.0,2160.0,0,EARLY SWEET,Bag
VIDEXPORT,24E04580,06/03/2024,Sale,-1530.0,630.0,0,EARLY SWEET,Bag
VIDEXPORT,24E04580,06/03/2024,Sale,-450.0,180.0,0,EARLY SWEET,Bag
VIDEXPORT,24E04580,06/04/2024,Sale,-180.0,0.0,1,EARLY SWEET,Bag
VIDEXPORT,24E04581,06/04/2024,Entry,2160.0,2160.0,0,EARLY SWEET,Bag
VIDEXPORT,24E04581,06/04/2024,Sale,-450.0,1710.0,0,EARLY SWEET,Bag
VIDEXPORT,24E04581,06/04/2024,Sale,-900.0,810.0,0,EARLY SWEET,Bag
VIDEXPORT,24E04581,06/04/2024,Sale,-810.0,0.0,0,EARLY SWEET,Bag
VIDEXPORT,24E04582,06/04/2024,Entry,1080.0,1080.0,0,FLAME,Bag
VIDEXPORT,24E04582,06/04/2024,Entry,1080.0,2160.0,0,SUGAR DROP,Bag
VIDEXPORT,24E04582,06/05/2024,Sale,-450.0,1710.0,1,SUGAR DROP,Bag
VIDEXPORT,24E04582,06/06/2024,Sale,-360.0,1350.0,2,SUGAR DROP,Bag
VIDEXPORT,24E04582,06/06/2024,Sale,-270.0,1080.0,2,SUGAR DROP,Bag
VIDEXPORT,24E04582,06/13/2024,Sale,-90.0,990.0,9,FLAME,Bag
VIDEXPORT,24E04582,06/13/2024,Sale,-360.0,630.0,9,FLAME,Bag
VIDEXPORT,24E04582,06/13/2024,Sale,-450.0,180.0,9,FLAME,Bag
VIDEXPORT,24E04582,06/14/2024,Sale,-180.0,0.0,10,FLAME,Bag
VIDEXPORT,24E04583,06/04/2024,Entry,1080.0,1080.0,0,EARLY SWEET,Bag
VIDEXPORT,24E04583,06/04/2024,Entry,1080.0,2160.0,0,FLAME,Bag
VIDEXPORT,24E04583,06/06/2024,Sale,-900.0,1260.0,2,EARLY SWEET,Bag
VIDEXPORT,24E04583,06/06/2024,Sale,-90.0,1170.0,2,EARLY SWEET,Bag
VIDEXPORT,24E04583,06/11/2024,Sale,-270.0,900.0,7,FLAME,Bag
VIDEXPORT,24E04583,06/11/2024,Sale,-180.0,720.0,7,FLAME,Bag
VIDEXPORT,24E04583,06/13/2024,Sale,-90.0,630.0,9,EARLY SWEET,Bag
VIDEXPORT,24E04583,06/13/2024,Sale,-180.0,450.0,9,FLAME,Bag
VIDEXPORT,24E04583,06/13/2024,Sale,-270.0,180.0,9,FLAME,Bag
VIDEXPORT,24E04583,06/14/2024,Sale,-180.0,0.0,10,FLAME,Bag
VIDEXPORT,24E04584,06/03/2024,Entry,2520.0,2520.0,0,EARLY SWEET,Bag
VIDEXPORT,24E04584,06/03/2024,Sale,-1170.0,1350.0,0,EARLY SWEET,Bag
VIDEXPORT,24E04584,06/03/2024,Sale,-1170.0,180.0,0,EARLY SWEET,Bag
VIDEXPORT,24E04584,06/04/2024,Sale,-90.0,90.0,1,EARLY SWEET,Bag
VIDEXPORT,24E04584,06/04/2024,Sale,-90.0,0.0,1,EARLY SWEET,Bag
VIDEXPORT,24E04586,06/03/2024,Entry,1800.0,1800.0,0,SUGAR DROP,Bag
VIDEXPORT,24E04586,06/05/2024,Sale,-1530.0,270.0,2,SUGAR DROP,Bag
VIDEXPORT,24E04586,06/06/2024,Sale,-90.0,180.0,3,SUGAR DROP,Bag
VIDEXPORT,24E04586,06/06/2024,Sale,-180.0,0.0,3,SUGAR DROP,Bag
VIDEXPORT,24E04589,06/04/2024,Entry,2340.0,2340.0,0,FLAME,Bag
VIDEXPORT,24E04589,06/11/2024,Sale,-90.0,2250.0,7,FLAME,Bag
VIDEXPORT,24E04589,06/14/2024,Sale,-630.0,1620.0,10,FLAME,Bag
VIDEXPORT,24E04589,06/14/2024,Sale,-90.0,1530.0,10,FLAME,Bag
VIDEXPORT,24E04589,06/14/2024,Sale,-630.0,900.0,10,FLAME,Bag
VIDEXPORT,24E04589,06/14/2024,Sale,-720.0,180.0,10,FLAME,Bag
VIDEXPORT,24E04589,06/15/2024,Sale,-90.0,90.0,11,FLAME,Bag
VIDEXPORT,24E04589,06/15/2024,Sale,-90.0,0.0,11,FLAME,Bag
VIDEXPORT,24E04590,06/03/2024,Entry,2160.0,2160.0,0,EARLY SWEET,Bag
VIDEXPORT,24E04590,06/04/2024,Sale,-180.0,1980.0,1,EARLY SWEET,Bag
VIDEXPORT,24E04590,06/04/2024,Sale,-990.0,990.0,1,EARLY SWEET,Bag
VIDEXPORT,24E04590,06/04/2024,Sale,-990.0,0.0,1,EARLY SWEET,Bag
VIDEXPORT,24E04592,06/03/2024,Entry,2160.0,2160.0,0,SUGAR DROP,Bag
VIDEXPORT,24E04592,06/05/2024,Sale,-990.0,1170.0,2,SUGAR DROP,Bag
VIDEXPORT,24E04592,06/06/2024,Sale,-630.0,540.0,3,SUGAR DROP,Bag
VIDEXPORT,24E04592,06/06/2024,Sale,-540.0,0.0,3,SUGAR DROP,Bag
VIDEXPORT,24E04593,06/03/2024,Entry,2160.0,2160.0,0,EARLY SWEET,Bag
VIDEXPORT,24E04593,06/03/2024,Sale,-1955.0,205.0,0,EARLY SWEET,Bag
VIDEXPORT,24E04593,06/03/2024,Sale,-25.0,180.0,0,EARLY SWEET,Bag
VIDEXPORT,24E04593,06/04/2024,Sale,-90.0,90.0,1,EARLY SWEET,Bag
VIDEXPORT,24E04593,06/05/2024,Sale,-90.0,0.0,2,EARLY SWEET,Bag
VIDEXPORT,24E04594,06/03/2024,Entry,2160.0,2160.0,0,EARLY SWEET,Bag
VIDEXPORT,24E04594,06/05/2024,Sale,-1260.0,900.0,2,EARLY SWEET,Bag
VIDEXPORT,24E04594,06/07/2024,Sale,-180.0,720.0,4,EARLY SWEET,Bag
VIDEXPORT,24E04594,06/07/2024,Sale,-720.0,0.0,4,EARLY SWEET,Bag
VIDEXPORT,24E04597,06/04/2024,Entry,2340.0,2340.0,0,EARLY SWEET,Bag
VIDEXPORT,24E04597,06/06/2024,Sale,-1980.0,360.0,2,EARLY SWEET,Bag
VIDEXPORT,24E04597,06/07/2024,Sale,-360.0,0.0,3,EARLY SWEET,Bag
VIDEXPORT,24E04598,06/04/2024,Entry,1800.0,1800.0,0,EARLY SWEET,Bag
VIDEXPORT,24E04598,06/04/2024,Sale,-900.0,900.0,0,EARLY SWEET,Bag
VIDEXPORT,24E04598,06/04/2024,Sale,-180.0,720.0,0,EARLY SWEET,Bag
VIDEXPORT,24E04598,06/04/2024,Sale,-270.0,450.0,0,EARLY SWEET,Bag
VIDEXPORT,24E04598,06/05/2024,Sale,-90.0,360.0,1,EARLY SWEET,Bag
VIDEXPORT,24E04598,06/05/2024,Sale,-360.0,0.0,1,EARLY SWEET,Bag
VIDEXPORT,24E04599,06/04/2024,Entry,1980.0,1980.0,0,FLAME,Bag
VIDEXPORT,24E04599,06/06/2024,Sale,-1980.0,0.0,2,FLAME,Bag
VIDEXPORT,24E04601,06/04/2024,Entry,2160.0,2160.0,0,SUGAR DROP,Bag
VIDEXPORT,24E04601,06/05/2024,Sale,-1350.0,810.0,1,SUGAR DROP,Bag
VIDEXPORT,24E04601,06/06/2024,Sale,-180.0,630.0,2,SUGAR DROP,Bag
VIDEXPORT,24E04601,06/06/2024,Sale,-630.0,0.0,2,SUGAR DROP,Bag
VIDEXPORT,24E04605,06/04/2024,Entry,1890.0,1890.0,0,FLAME,Bag
VIDEXPORT,24E04605,06/04/2024,Entry,340.0,2230.0,0,HONEY POP,Bag
VIDEXPORT,24E04605,06/04/2024,Entry,90.0,2320.0,0,SUMMER ROYAL,Bag
VIDEXPORT,24E04605,06/04/2024,Entry,90.0,2410.0,0,SUMMER ROYAL,Bag
VIDEXPORT,24E04605,06/04/2024,Entry,90.0,2500.0,0,SUMMER ROYAL,Bag
VIDEXPORT,24E04605,06/04/2024,Sale,-90.0,2410.0,0,SUMMER ROYAL,Bag
VIDEXPORT,24E04605,06/04/2024,Sale,-90.0,2320.0,0,SUMMER ROYAL,Bag
VIDEXPORT,24E04605,06/06/2024,Sale,-90.0,2230.0,2,SUMMER ROYAL,Bag
VIDEXPORT,24E04605,06/12/2024,Sale,-360.0,1870.0,8,FLAME,Bag
VIDEXPORT,24E04605,06/12/2024,Sale,-540.0,1330.0,8,FLAME,Bag
VIDEXPORT,24E04605,06/13/2024,Sale,-810.0,520.0,9,FLAME,Bag
VIDEXPORT,24E04605,06/14/2024,Sale,-180.0,340.0,10,FLAME,Bag
VIDEXPORT,24E04606,06/04/2024,Entry,2520.0,2520.0,0,EARLY SWEET,Bag
VIDEXPORT,24E04606,06/04/2024,Sale,-180.0,2340.0,0,EARLY SWEET,Bag
VIDEXPORT,24E04606,06/04/2024,Sale,-90.0,2250.0,0,EARLY SWEET,Bag
VIDEXPORT,24E04606,06/04/2024,Sale,-1980.0,270.0,0,EARLY SWEET,Bag
VIDEXPORT,24E04606,06/05/2024,Sale,-270.0,0.0,1,EARLY SWEET,Bag
VIDEXPORT,24E04607,06/05/2024,Entry,2160.0,2160.0,0,EARLY SWEET,Bag
VIDEXPORT,24E04607,06/06/2024,Sale,-1710.0,450.0,1,EARLY SWEET,Bag
VIDEXPORT,24E04607,06/06/2024,Sale,-360.0,90.0,1,EARLY SWEET,Bag
VIDEXPORT,24E04607,06/07/2024,Sale,-90.0,0.0,2,EARLY SWEET,Bag
VIDEXPORT,24E04610,06/05/2024,Entry,2520.0,2520.0,0,EARLY SWEET,Bag
VIDEXPORT,24E04610,06/05/2024,Sale,-90.0,2430.0,0,EARLY SWEET,Bag
VIDEXPORT,24E04610,06/05/2024,Sale,-90.0,2340.0,0,EARLY SWEET,Bag
VIDEXPORT,24E04610,06/06/2024,Sale,-720.0,1620.0,1,EARLY SWEET,Bag
VIDEXPORT,24E04610,06/06/2024,Sale,-990.0,630.0,1,EARLY SWEET,Bag
VIDEXPORT,24E04610,06/06/2024,Sale,-630.0,0.0,1,EARLY SWEET,Bag
VIDEXPORT,24E04612,06/05/2024,Entry,1080.0,1080.0,0,EARLY SWEET,Bag
VIDEXPORT,24E04612,06/05/2024,Entry,1080.0,2160.0,0,FLAME,Bag
VIDEXPORT,24E04612,06/05/2024,Sale,-45.0,2115.0,0,EARLY SWEET,Bag
VIDEXPORT,24E04612,06/05/2024,Sale,-45.0,2070.0,0,EARLY SWEET,Bag
VIDEXPORT,24E04612,06/05/2024,Sale,-990.0,1080.0,0,EARLY SWEET,Bag
VIDEXPORT,24E04612,06/10/2024,Sale,-630.0,450.0,5,FLAME,Bag
VIDEXPORT,24E04612,06/10/2024,Sale,-270.0,180.0,5,FLAME,Bag
VIDEXPORT,24E04612,06/14/2024,Sale,-180.0,0.0,9,FLAME,Bag
VIDEXPORT,24E04614,06/04/2024,Entry,2520.0,2520.0,0,FLAME,Bag
VIDEXPORT,24E04614,06/08/2024,Sale,-810.0,1710.0,4,FLAME,Bag
VIDEXPORT,24E04614,06/08/2024,Sale,-1080.0,630.0,4,FLAME,Bag
VIDEXPORT,24E04614,06/12/2024,Sale,-540.0,90.0,8,FLAME,Bag
VIDEXPORT,24E04614,06/13/2024,Sale,-90.0,0.0,9,FLAME,Bag
VIDEXPORT,24E04615,06/05/2024,Entry,2160.0,2160.0,0,EARLY SWEET,Bag
VIDEXPORT,24E04615,06/06/2024,Sale,-1080.0,1080.0,1,EARLY SWEET,Bag
VIDEXPORT,24E04615,06/06/2024,Sale,-90.0,990.0,1,EARLY SWEET,Bag
VIDEXPORT,24E04615,06/06/2024,Sale,-720.0,270.0,1,EARLY SWEET,Bag
VIDEXPORT,24E04615,06/06/2024,Sale,-180.0,90.0,1,EARLY SWEET,Bag
VIDEXPORT,24E04615,06/07/2024,Sale,-90.0,0.0,2,EARLY SWEET,Bag
VIDEXPORT,24E04616,06/04/2024,Entry,2520.0,2520.0,0,FLAME,Bag
VIDEXPORT,24E04616,06/05/2024,Sale,-90.0,2430.0,1,FLAME,Bag
VIDEXPORT,24E04616,06/06/2024,Sale,-270.0,2160.0,2,FLAME,Bag
VIDEXPORT,24E04616,06/11/2024,Sale,-720.0,1440.0,7,FLAME,Bag
VIDEXPORT,24E04616,06/12/2024,Sale,-90.0,1350.0,8,FLAME,Bag
VIDEXPORT,24E04616,06/12/2024,Sale,-360.0,990.0,8,FLAME,Bag
VIDEXPORT,24E04616,06/12/2024,Sale,-810.0,180.0,8,FLAME,Bag
VIDEXPORT,24E04616,06/13/2024,Sale,-180.0,0.0,9,FLAME,Bag
VIDEXPORT,24E04617,06/04/2024,Entry,2340.0,2340.0,0,HONEY POP,Bag
VIDEXPORT,24E04617,06/06/2024,Sale,-180.0,2160.0,2,HONEY POP,Bag
VIDEXPORT,24E04617,06/07/2024,Sale,-180.0,1980.0,3,HONEY POP,Bag
VIDEXPORT,24E04617,06/07/2024,Sale,-180.0,1800.0,3,HONEY POP,Bag
VIDEXPORT,24E04617,06/07/2024,Sale,-1800.0,0.0,3,HONEY POP,Bag
VIDEXPORT,24E04618,06/04/2024,Entry,1800.0,1800.0,0,EARLY SWEET,Bag
VIDEXPORT,24E04618,06/04/2024,Sale,-540.0,1260.0,0,EARLY SWEET,Bag
VIDEXPORT,24E04618,06/05/2024,Sale,-810.0,450.0,1,EARLY SWEET,Bag
VIDEXPORT,24E04618,06/05/2024,Sale,-180.0,270.0,1,EARLY SWEET,Bag
VIDEXPORT,24E04618,06/05/2024,Sale,-180.0,90.0,1,EARLY SWEET,Bag
VIDEXPORT,24E04618,06/11/2024,Sale,-90.0,0.0,7,EARLY SWEET,Bag
VIDEXPORT,24E04619,06/04/2024,Entry,1800.0,1800.0,0,EARLY SWEET,Bag
VIDEXPORT,24E04619,06/05/2024,Sale,-270.0,1530.0,1,EARLY SWEET,Bag
VIDEXPORT,24E04619,06/05/2024,Sale,-90.0,1440.0,1,EARLY SWEET,Bag
VIDEXPORT,24E04619,06/06/2024,Sale,-1440.0,0.0,2,EARLY SWEET,Bag
VIDEXPORT,24E04624,06/04/2024,Entry,2340.0,2340.0,0,FLAME,Bag
VIDEXPORT,24E04624,06/06/2024,Sale,-1980.0,360.0,2,FLAME,Bag
VIDEXPORT,24E04624,06/07/2024,Sale,-180.0,180.0,3,FLAME,Bag
VIDEXPORT,24E04624,06/10/2024,Sale,-180.0,0.0,6,FLAME,Bag
VIDEXPORT,24E04625,06/05/2024,Entry,1080.0,1080.0,0,FLAME,Bag
VIDEXPORT,24E04625,06/05/2024,Entry,850.0,1930.0,0,HONEY POP,Bag
VIDEXPORT,24E04625,06/14/2024,Sale,-540.0,1390.0,9,FLAME,Bag
VIDEXPORT,24E04625,06/15/2024,Sale,-360.0,1030.0,10,FLAME,Bag
VIDEXPORT,24E04625,06/15/2024,Sale,-90.0,940.0,10,FLAME,Bag
VIDEXPORT,24E04625,06/15/2024,Sale,-90.0,850.0,10,FLAME,Bag
VIDEXPORT,24E04626,06/05/2024,Entry,1800.0,1800.0,0,HONEY POP,Bag
VIDEXPORT,24E04626,06/06/2024,Sale,-90.0,1710.0,1,HONEY POP,Bag
VIDEXPORT,24E04626,06/06/2024,Sale,-810.0,900.0,1,HONEY POP,Bag
VIDEXPORT,24E04626,06/07/2024,Sale,-270.0,630.0,2,HONEY POP,Bag
VIDEXPORT,24E04626,06/07/2024,Sale,-630.0,0.0,2,HONEY POP,Bag
VIDEXPORT,24E04628,06/06/2024,Entry,2520.0,2520.0,0,EARLY SWEET,Bag
VIDEXPORT,24E04628,06/07/2024,Sale,-1440.0,1080.0,1,EARLY SWEET,Bag
VIDEXPORT,24E04628,06/07/2024,Sale,-720.0,360.0,1,EARLY SWEET,Bag
VIDEXPORT,24E04628,06/08/2024,Sale,-360.0,0.0,2,EARLY SWEET,Bag
VIDEXPORT,24E04629,06/05/2024,Entry,2340.0,2340.0,0,EARLY SWEET,Bag
VIDEXPORT,24E04629,06/06/2024,Sale,-360.0,1980.0,1,EARLY SWEET,Bag
VIDEXPORT,24E04629,06/06/2024,Sale,-1980.0,0.0,1,EARLY SWEET,Bag
VIDEXPORT,24E04630,06/05/2024,Entry,2160.0,2160.0,0,EARLY SWEET,Bag
VIDEXPORT,24E04630,06/06/2024,Sale,-1620.0,540.0,1,EARLY SWEET,Bag
VIDEXPORT,24E04630,06/06/2024,Sale,-540.0,0.0,1,EARLY SWEET,Bag
VIDEXPORT,24E04631,06/05/2024,Entry,2340.0,2340.0,0,FLAME,Bag
VIDEXPORT,24E04631,06/08/2024,Sale,-990.0,1350.0,3,FLAME,Bag
VIDEXPORT,24E04631,06/08/2024,Sale,-90.0,1260.0,3,FLAME,Bag
VIDEXPORT,24E04631,06/12/2024,Sale,-900.0,360.0,7,FLAME,Bag
VIDEXPORT,24E04631,06/13/2024,Sale,-180.0,180.0,8,FLAME,Bag
VIDEXPORT,24E04631,06/13/2024,Sale,-180.0,0.0,8,FLAME,Bag
VIDEXPORT,24E04632,06/06/2024,Entry,2520.0,2520.0,0,SUGAR DROP,Bag
VIDEXPORT,24E04632,06/06/2024,Sale,-540.0,1980.0,0,SUGAR DROP,Bag
VIDEXPORT,24E04632,06/07/2024,Sale,-180.0,1800.0,1,SUGAR DROP,Bag
VIDEXPORT,24E04632,06/08/2024,Sale,-360.0,1440.0,2,SUGAR DROP,Bag
VIDEXPORT,24E04632,06/08/2024,Sale,-90.0,1350.0,2,SUGAR DROP,Bag
VIDEXPORT,24E04632,06/10/2024,Sale,-90.0,1260.0,4,SUGAR DROP,Bag
VIDEXPORT,24E04632,06/11/2024,Sale,-180.0,1080.0,5,SUGAR DROP,Bag
VIDEXPORT,24E04632,06/12/2024,Sale,-90.0,990.0,6,SUGAR DROP,Bag
VIDEXPORT,24E04632,06/12/2024,Sale,-180.0,810.0,6,SUGAR DROP,Bag
VIDEXPORT,24E04632,06/13/2024,Sale,-810.0,0.0,7,SUGAR DROP,Bag
VIDEXPORT,24E04634,06/06/2024,Entry,2160.0,2160.0,0,EARLY SWEET,Bag
VIDEXPORT,24E04634,06/06/2024,Sale,-630.0,1530.0,0,EARLY SWEET,Bag
VIDEXPORT,24E04634,06/06/2024,Sale,-360.0,1170.0,0,EARLY SWEET,Bag
VIDEXPORT,24E04634,06/06/2024,Sale,-1170.0,0.0,0,EARLY SWEET,Bag
VIDEXPORT,24E04635,06/05/2024,Entry,900.0,900.0,0,EARLY SWEET,Bag
VIDEXPORT,24E04635,06/05/2024,Entry,270.0,1170.0,0,SUGAR DROP,Bag
VIDEXPORT,24E04635,06/05/2024,Entry,630.0,1800.0,0,SUGAR DROP,Bag
VIDEXPORT,24E04635,06/05/2024,Sale,-270.0,1530.0,0,EARLY SWEET,Bag
VIDEXPORT,24E04635,06/06/2024,Sale,-90.0,1440.0,1,EARLY SWEET,Bag
VIDEXPORT,24E04635,06/06/2024,Sale,-90.0,1350.0,1,EARLY SWEET,Bag
VIDEXPORT,24E04635,06/06/2024,Sale,-270.0,1080.0,1,SUGAR DROP,Bag
VIDEXPORT,24E04635,06/07/2024,Sale,-450.0,630.0,2,EARLY SWEET,Bag
VIDEXPORT,24E04635,06/07/2024,Sale,-90.0,540.0,2,SUGAR DROP,Bag
VIDEXPORT,24E04635,06/08/2024,Sale,-270.0,270.0,3,SUGAR DROP,Bag
VIDEXPORT,24E04635,06/14/2024,Sale,-270.0,0.0,9,SUGAR DROP,Bag
VIDEXPORT,24E04636,06/06/2024,Entry,2520.0,2520.0,0,FLAME,Bag
VIDEXPORT,24E04636,06/12/2024,Sale,-720.0,1800.0,6,FLAME,Bag
VIDEXPORT,24E04636,06/12/2024,Sale,-720.0,1080.0,6,FLAME,Bag
VIDEXPORT,24E04636,06/12/2024,Sale,-450.0,630.0,6,FLAME,Bag
VIDEXPORT,24E04636,06/12/2024,Sale,-630.0,0.0,6,FLAME,Bag
VIDEXPORT,24E04639,06/06/2024,Entry,1800.0,1800.0,0,EARLY SWEET,Bag
VIDEXPORT,24E04639,06/07/2024,Sale,-1530.0,270.0,1,EARLY SWEET,Bag
VIDEXPORT,24E04639,06/08/2024,Sale,-270.0,0.0,2,EARLY SWEET,Bag
VIDEXPORT,24E04640,06/06/2024,Entry,2160.0,2160.0,0,EARLY SWEET,Bag
VIDEXPORT,24E04640,06/07/2024,Sale,-1350.0,810.0,1,EARLY SWEET,Bag
VIDEXPORT,24E04640,06/07/2024,Sale,-360.0,450.0,1,EARLY SWEET,Bag
VIDEXPORT,24E04640,06/07/2024,Sale,-270.0,180.0,1,EARLY SWEET,Bag
VIDEXPORT,24E04640,06/08/2024,Sale,-180.0,0.0,2,EARLY SWEET,Bag
VIDEXPORT,24E04641,06/06/2024,Entry,2160.0,2160.0,0,EARLY SWEET,Bag
VIDEXPORT,24E04641,06/07/2024,Sale,-270.0,1890.0,1,EARLY SWEET,Bag
VIDEXPORT,24E04641,06/08/2024,Sale,-360.0,1530.0,2,EARLY SWEET,Bag
VIDEXPORT,24E04641,06/08/2024,Sale,-540.0,990.0,2,EARLY SWEET,Bag
VIDEXPORT,24E04641,06/08/2024,Sale,-180.0,810.0,2,EARLY SWEET,Bag
VIDEXPORT,24E04641,06/08/2024,Sale,-450.0,360.0,2,EARLY SWEET,Bag
VIDEXPORT,24E04641,06/08/2024,Sale,-270.0,90.0,2,EARLY SWEET,Bag
VIDEXPORT,24E04641,06/08/2024,Sale,-90.0,0.0,2,EARLY SWEET,Bag
VIDEXPORT,24E04645,06/06/2024,Entry,2250.0,2250.0,0,EARLY SWEET,Bag
VIDEXPORT,24E04645,06/07/2024,Sale,-90.0,2160.0,1,EARLY SWEET,Bag
VIDEXPORT,24E04645,06/07/2024,Sale,-1530.0,630.0,1,EARLY SWEET,Bag
VIDEXPORT,24E04645,06/07/2024,Sale,-90.0,540.0,1,EARLY SWEET,Bag
VIDEXPORT,24E04645,06/08/2024,Sale,-90.0,450.0,2,EARLY SWEET,Bag
VIDEXPORT,24E04645,06/08/2024,Sale,-450.0,0.0,2,EARLY SWEET,Bag
VIDEXPORT,24E04646,06/05/2024,Entry,2520.0,2520.0,0,EARLY SWEET,Bag
VIDEXPORT,24E04646,06/06/2024,Sale,-1980.0,540.0,1,EARLY SWEET,Bag
VIDEXPORT,24E04646,06/06/2024,Sale,-360.0,180.0,1,EARLY SWEET,Bag
VIDEXPORT,24E04646,06/13/2024,Sale,-180.0,0.0,8,EARLY SWEET,Bag
VIDEXPORT,24E04647,06/06/2024,Entry,2340.0,2340.0,0,EARLY SWEET,Bag
VIDEXPORT,24E04647,06/07/2024,Sale,-90.0,2250.0,1,EARLY SWEET,Bag
VIDEXPORT,24E04647,06/07/2024,Sale,-1710.0,540.0,1,EARLY SWEET,Bag
VIDEXPORT,24E04647,06/07/2024,Sale,-450.0,90.0,1,EARLY SWEET,Bag
VIDEXPORT,24E04647,06/07/2024,Sale,-90.0,0.0,1,EARLY SWEET,Bag
VIDEXPORT,24E04650,06/06/2024,Entry,1800.0,1800.0,0,FLAME,Bag
VIDEXPORT,24E04650,06/12/2024,Sale,-900.0,900.0,6,FLAME,Bag
VIDEXPORT,24E04650,06/13/2024,Sale,-810.0,90.0,7,FLAME,Bag
VIDEXPORT,24E04650,06/15/2024,Sale,-90.0,0.0,9,FLAME,Bag
VIDEXPORT,24E04657,06/06/2024,Entry,2160.0,2160.0,0,EARLY SWEET,Bag
VIDEXPORT,24E04657,06/07/2024,Sale,-1980.0,180.0,1,EARLY SWEET,Bag
VIDEXPORT,24E04657,06/07/2024,Sale,-180.0,0.0,1,EARLY SWEET,Bag
VIDEXPORT,24E04658,06/06/2024,Entry,1260.0,1260.0,0,FLAME,Bag
VIDEXPORT,24E04658,06/06/2024,Entry,1170.0,2430.0,0,FLAME,Bag
VIDEXPORT,24E04658,06/07/2024,Sale,-1260.0,1170.0,1,FLAME,Bag
VIDEXPORT,24E04658,06/10/2024,Sale,-990.0,180.0,4,FLAME,Bag
VIDEXPORT,24E04658,06/13/2024,Sale,-90.0,90.0,7,FLAME,Bag
VIDEXPORT,24E04658,06/15/2024,Sale,-90.0,0.0,9,FLAME,Bag
VIDEXPORT,24E04659,06/06/2024,Entry,630.0,630.0,0,FLAME,Clam
VIDEXPORT,24E04659,06/06/2024,Entry,1360.0,1990.0,0,HONEY POP,Clam
VIDEXPORT,24E04659,06/06/2024,Entry,270.0,2260.0,0,SUMMER ROYAL,Clam
VIDEXPORT,24E04659,06/06/2024,Sale,-1359.0,901.0,0,HONEY POP,Clam
VIDEXPORT,24E04659,06/06/2024,Sale,-1.0,900.0,0,HONEY POP,Clam
VIDEXPORT,24E04659,06/06/2024,Sale,-90.0,810.0,0,SUMMER ROYAL,Bag
VIDEXPORT,24E04659,06/07/2024,Sale,-90.0,720.0,1,SUMMER ROYAL,Bag
VIDEXPORT,24E04659,06/07/2024,Sale,-90.0,630.0,1,SUMMER ROYAL,Bag
VIDEXPORT,24E04659,06/12/2024,Sale,-450.0,180.0,6,FLAME,Bag
VIDEXPORT,24E04659,06/12/2024,Sale,-90.0,90.0,6,FLAME,Bag
VIDEXPORT,24E04659,06/13/2024,Sale,-90.0,0.0,7,FLAME,Bag
VIDEXPORT,24E04660,06/06/2024,Entry,2160.0,2160.0,0,EARLY SWEET,Bag
VIDEXPORT,24E04660,06/07/2024,Sale,-1080.0,1080.0,1,EARLY SWEET,Bag
VIDEXPORT,24E04660,06/07/2024,Sale,-900.0,180.0,1,EARLY SWEET,Bag
VIDEXPORT,24E04660,06/07/2024,Sale,-180.0,0.0,1,EARLY SWEET,Bag
VIDEXPORT,24E04661,06/06/2024,Entry,2160.0,2160.0,0,EARLY SWEET,Bag
VIDEXPORT,24E04661,06/07/2024,Sale,-180.0,1980.0,1,EARLY SWEET,Bag
VIDEXPORT,24E04661,06/08/2024,Sale,-450.0,1530.0,2,EARLY SWEET,Bag
VIDEXPORT,24E04661,06/08/2024,Sale,-1260.0,270.0,2,EARLY SWEET,Bag
VIDEXPORT,24E04661,06/08/2024,Sale,-180.0,90.0,2,EARLY SWEET,Bag
VIDEXPORT,24E04661,06/08/2024,Sale,-90.0,0.0,2,EARLY SWEET,Bag
VIDEXPORT,24E04662,06/06/2024,Entry,1800.0,1800.0,0,EARLY SWEET,Bag
VIDEXPORT,24E04662,06/08/2024,Sale,-1080.0,720.0,2,EARLY SWEET,Bag
VIDEXPORT,24E04662,06/08/2024,Sale,-720.0,0.0,2,EARLY SWEET,Bag
VIDEXPORT,24E04663,06/07/2024,Entry,1800.0,1800.0,0,EARLY SWEET,Bag
VIDEXPORT,24E04663,06/07/2024,Sale,-360.0,1440.0,0,EARLY SWEET,Bag
VIDEXPORT,24E04663,06/07/2024,Sale,-180.0,1260.0,0,EARLY SWEET,Bag
VIDEXPORT,24E04663,06/07/2024,Sale,-810.0,450.0,0,EARLY SWEET,Bag
VIDEXPORT,24E04663,06/08/2024,Sale,-450.0,0.0,1,EARLY SWEET,Bag
VIDEXPORT,24E04664,06/06/2024,Entry,2160.0,2160.0,0,EARLY SWEET,Bag
VIDEXPORT,24E04664,06/07/2024,Sale,-720.0,1440.0,1,EARLY SWEET,Bag
VIDEXPORT,24E04664,06/07/2024,Sale,-630.0,810.0,1,EARLY SWEET,Bag
VIDEXPORT,24E04664,06/07/2024,Sale,-360.0,450.0,1,EARLY SWEET,Bag
VIDEXPORT,24E04664,06/08/2024,Sale,-360.0,90.0,2,EARLY SWEET,Bag
VIDEXPORT,24E04664,06/11/2024,Sale,-90.0,0.0,5,EARLY SWEET,Bag
VIDEXPORT,24E04665,06/08/2024,Entry,2160.0,2160.0,0,EARLY SWEET,Bag
VIDEXPORT,24E04665,06/08/2024,Sale,-990.0,1170.0,0,EARLY SWEET,Bag
VIDEXPORT,24E04665,06/10/2024,Sale,-90.0,1080.0,2,EARLY SWEET,Bag
VIDEXPORT,24E04665,06/10/2024,Sale,-630.0,450.0,2,EARLY SWEET,Bag
VIDEXPORT,24E04665,06/10/2024,Sale,-360.0,90.0,2,EARLY SWEET,Bag
VIDEXPORT,24E04665,06/13/2024,Sale,-90.0,0.0,5,EARLY SWEET,Bag
VIDEXPORT,24E04666,06/07/2024,Entry,2160.0,2160.0,0,FLAME,Bag
VIDEXPORT,24E04666,06/10/2024,Sale,-360.0,1800.0,3,FLAME,Bag
VIDEXPORT,24E04666,06/18/2024,Sale,-810.0,990.0,11,FLAME,Bag
VIDEXPORT,24E04666,06/18/2024,Sale,-990.0,0.0,11,FLAME,Bag
VIDEXPORT,24E04667,06/06/2024,Entry,1800.0,1800.0,0,FLAME,Bag
VIDEXPORT,24E04667,06/08/2024,Sale,-180.0,1620.0,2,FLAME,Bag
VIDEXPORT,24E04667,06/12/2024,Sale,-90.0,1530.0,6,FLAME,Bag
VIDEXPORT,24E04667,06/12/2024,Sale,-720.0,810.0,6,FLAME,Bag
VIDEXPORT,24E04667,06/12/2024,Sale,-810.0,0.0,6,FLAME,Bag
VIDEXPORT,24E04668,06/06/2024,Entry,2160.0,2160.0,0,FLAME,Bag
VIDEXPORT,24E04668,06/08/2024,Sale,-180.0,1980.0,2,FLAME,Bag
VIDEXPORT,24E04668,06/10/2024,Sale,-1440.0,540.0,4,FLAME,Bag
VIDEXPORT,24E04668,06/13/2024,Sale,-540.0,0.0,7,FLAME,Bag
VIDEXPORT,24E04669,06/06/2024,Entry,2520.0,2520.0,0,EARLY SWEET,Bag
VIDEXPORT,24E04669,06/07/2024,Sale,-1080.0,1440.0,1,EARLY SWEET,Bag
VIDEXPORT,24E04669,06/07/2024,Sale,-1440.0,0.0,1,EARLY SWEET,Bag
VIDEXPORT,24E04670,06/06/2024,Entry,2340.0,2340.0,0,EARLY SWEET,Bag
VIDEXPORT,24E04670,06/06/2024,Sale,-450.0,1890.0,0,EARLY SWEET,Bag
VIDEXPORT,24E04670,06/06/2024,Sale,-270.0,1620.0,0,EARLY SWEET,Bag
VIDEXPORT,24E04670,06/07/2024,Sale,-1260.0,360.0,1,EARLY SWEET,Bag
VIDEXPORT,24E04670,06/07/2024,Sale,-270.0,90.0,1,EARLY SWEET,Bag
VIDEXPORT,24E04670,06/08/2024,Sale,-90.0,0.0,2,EARLY SWEET,Bag
VIDEXPORT,24E04671,06/07/2024,Entry,2160.0,2160.0,0,EARLY SWEET,Bag
VIDEXPORT,24E04671,06/07/2024,Sale,-180.0,1980.0,0,EARLY SWEET,Bag
VIDEXPORT,24E04671,06/07/2024,Sale,-450.0,1530.0,0,EARLY SWEET,Bag
VIDEXPORT,24E04671,06/07/2024,Sale,-990.0,540.0,0,EARLY SWEET,Bag
VIDEXPORT,24E04671,06/07/2024,Sale,-450.0,90.0,0,EARLY SWEET,Bag
VIDEXPORT,24E04671,06/08/2024,Sale,-90.0,0.0,1,EARLY SWEET,Bag
VIDEXPORT,24E04672,06/06/2024,Entry,2160.0,2160.0,0,EARLY SWEET,Bag
VIDEXPORT,24E04672,06/07/2024,Sale,-720.0,1440.0,1,EARLY SWEET,Bag
VIDEXPORT,24E04672,06/07/2024,Sale,-1440.0,0.0,1,EARLY SWEET,Bag
VIDEXPORT,24E04674,06/07/2024,Entry,2160.0,2160.0,0,FLAME,Bag
VIDEXPORT,24E04674,06/12/2024,Sale,-270.0,1890.0,5,FLAME,Bag
VIDEXPORT,24E04674,06/13/2024,Sale,-90.0,1800.0,6,FLAME,Bag
VIDEXPORT,24E04674,06/13/2024,Sale,-180.0,1620.0,6,FLAME,Bag
VIDEXPORT,24E04674,06/13/2024,Sale,-90.0,1530.0,6,FLAME,Bag
VIDEXPORT,24E04674,06/14/2024,Sale,-540.0,990.0,7,FLAME,Bag
VIDEXPORT,24E04674,06/14/2024,Sale,-90.0,900.0,7,FLAME,Bag
VIDEXPORT,24E04674,06/14/2024,Sale,-180.0,720.0,7,FLAME,Bag
VIDEXPORT,24E04674,06/15/2024,Sale,-540.0,180.0,8,FLAME,Bag
VIDEXPORT,24E04674,06/17/2024,Sale,-180.0,0.0,10,FLAME,Bag
VIDEXPORT,24E04682,06/06/2024,Entry,1260.0,1260.0,0,EARLY SWEET,Bag
VIDEXPORT,24E04682,06/06/2024,Entry,1170.0,2430.0,0,FLAME,Bag
VIDEXPORT,24E04682,06/06/2024,Sale,-180.0,2250.0,0,EARLY SWEET,Bag
VIDEXPORT,24E04682,06/07/2024,Sale,-540.0,1710.0,1,EARLY SWEET,Bag
VIDEXPORT,24E04682,06/07/2024,Sale,-540.0,1170.0,1,EARLY SWEET,Bag
VIDEXPORT,24E04682,06/14/2024,Sale,-990.0,180.0,8,FLAME,Bag
VIDEXPORT,24E04682,06/18/2024,Sale,-90.0,90.0,12,FLAME,Bag
VIDEXPORT,24E04682,06/18/2024,Sale,-90.0,0.0,12,FLAME,Bag
VIDEXPORT,24E04686,06/07/2024,Entry,2250.0,2250.0,0,FLAME,Bag
VIDEXPORT,24E04686,06/08/2024,Sale,-90.0,2160.0,1,FLAME,Bag
VIDEXPORT,24E04686,06/12/2024,Sale,-540.0,1620.0,5,FLAME,Bag
VIDEXPORT,24E04686,06/13/2024,Sale,-990.0,630.0,6,FLAME,Bag
VIDEXPORT,24E04686,06/13/2024,Sale,-270.0,360.0,6,FLAME,Bag
VIDEXPORT,24E04686,06/18/2024,Sale,-90.0,270.0,11,FLAME,Bag
VIDEXPORT,24E04686,06/19/2024,Sale,-270.0,0.0,12,FLAME,Bag
VIDEXPORT,24E04690,06/07/2024,Entry,2250.0,2250.0,0,EARLY SWEET,Bag
VIDEXPORT,24E04690,06/07/2024,Sale,-1980.0,270.0,0,EARLY SWEET,Bag
VIDEXPORT,24E04690,06/10/2024,Sale,-270.0,0.0,3,EARLY SWEET,Bag
VIDEXPORT,24E04692,06/07/2024,Entry,2250.0,2250.0,0,EARLY SWEET,Bag
VIDEXPORT,24E04692,06/07/2024,Sale,-720.0,1530.0,0,EARLY SWEET,Bag
VIDEXPORT,24E04692,06/07/2024,Sale,-890.0,640.0,0,EARLY SWEET,Bag
VIDEXPORT,24E04692,06/07/2024,Sale,-10.0,630.0,0,EARLY SWEET,Bag
VIDEXPORT,24E04692,06/07/2024,Sale,-90.0,540.0,0,EARLY SWEET,Bag
VIDEXPORT,24E04692,06/08/2024,Sale,-540.0,0.0,1,EARLY SWEET,Bag
VIDEXPORT,24E04693,06/07/2024,Entry,2160.0,2160.0,0,FLAME,Bag
VIDEXPORT,24E04693,06/08/2024,Sale,-180.0,1980.0,1,FLAME,Bag
VIDEXPORT,24E04693,06/17/2024,Sale,-900.0,1080.0,10,FLAME,Bag
VIDEXPORT,24E04693,06/17/2024,Sale,-720.0,360.0,10,FLAME,Bag
VIDEXPORT,24E04693,06/17/2024,Sale,-270.0,90.0,10,FLAME,Bag
VIDEXPORT,24E04693,07/20/2024,Sale,-90.0,0.0,43,FLAME,Bag
VIDEXPORT,24E04694,06/08/2024,Entry,2160.0,2160.0,0,FLAME,Bag
VIDEXPORT,24E04694,06/13/2024,Sale,-180.0,1980.0,5,FLAME,Bag
VIDEXPORT,24E04694,06/13/2024,Sale,-630.0,1350.0,5,FLAME,Bag
VIDEXPORT,24E04694,06/13/2024,Sale,-540.0,810.0,5,FLAME,Bag
VIDEXPORT,24E04694,06/14/2024,Sale,-810.0,0.0,6,FLAME,Bag
VIDEXPORT,24E04695,06/07/2024,Entry,1980.0,1980.0,0,EARLY SWEET,Bag
VIDEXPORT,24E04695,06/07/2024,Sale,-1980.0,0.0,0,EARLY SWEET,Bag
VIDEXPORT,24E04696,06/07/2024,Entry,2160.0,2160.0,0,FLAME,Bag
VIDEXPORT,24E04696,06/13/2024,Sale,-360.0,1800.0,6,FLAME,Bag
VIDEXPORT,24E04696,06/14/2024,Sale,-180.0,1620.0,7,FLAME,Bag
VIDEXPORT,24E04696,06/14/2024,Sale,-180.0,1440.0,7,FLAME,Bag
VIDEXPORT,24E04696,06/14/2024,Sale,-810.0,630.0,7,FLAME,Bag
VIDEXPORT,24E04696,06/14/2024,Sale,-630.0,0.0,7,FLAME,Bag
VIDEXPORT,24E04698,06/07/2024,Entry,2340.0,2340.0,0,EARLY SWEET,Bag
VIDEXPORT,24E04698,06/08/2024,Sale,-630.0,1710.0,1,EARLY SWEET,Bag
VIDEXPORT,24E04698,06/08/2024,Sale,-90.0,1620.0,1,EARLY SWEET,Bag
VIDEXPORT,24E04698,06/08/2024,Sale,-450.0,1170.0,1,EARLY SWEET,Bag
VIDEXPORT,24E04698,06/08/2024,Sale,-720.0,450.0,1,EARLY SWEET,Bag
VIDEXPORT,24E04698,06/08/2024,Sale,-360.0,90.0,1,EARLY SWEET,Bag
VIDEXPORT,24E04698,06/11/2024,Sale,-88.0,2.0,4,EARLY SWEET,Bag
VIDEXPORT,24E04699,06/07/2024,Entry,2340.0,2340.0,0,EARLY SWEET,Bag
VIDEXPORT,24E04699,06/07/2024,Sale,-1440.0,900.0,0,EARLY SWEET,Bag
VIDEXPORT,24E04699,06/08/2024,Sale,-540.0,360.0,1,EARLY SWEET,Bag
VIDEXPORT,24E04699,06/08/2024,Sale,-270.0,90.0,1,EARLY SWEET,Bag
VIDEXPORT,24E04699,06/08/2024,Sale,-90.0,0.0,1,EARLY SWEET,Bag
VIDEXPORT,24E04702,06/07/2024,Entry,2160.0,2160.0,0,EARLY SWEET,Bag
VIDEXPORT,24E04702,06/07/2024,Sale,-450.0,1710.0,0,EARLY SWEET,Bag
VIDEXPORT,24E04702,06/08/2024,Sale,-90.0,1620.0,1,EARLY SWEET,Bag
VIDEXPORT,24E04702,06/08/2024,Sale,-1620.0,0.0,1,EARLY SWEET,Bag
VIDEXPORT,24E04703,06/07/2024,Entry,2160.0,2160.0,0,EARLY SWEET,Bag
VIDEXPORT,24E04703,06/07/2024,Sale,-270.0,1890.0,0,EARLY SWEET,Bag
VIDEXPORT,24E04703,06/07/2024,Sale,-180.0,1710.0,0,EARLY SWEET,Bag
VIDEXPORT,24E04703,06/08/2024,Sale,-720.0,990.0,1,EARLY SWEET,Bag
VIDEXPORT,24E04703,06/13/2024,Sale,-990.0,0.0,6,EARLY SWEET,Bag
VIDEXPORT,24E04708,06/07/2024,Entry,450.0,450.0,0,EARLY SWEET,Bag
VIDEXPORT,24E04708,06/07/2024,Entry,1980.0,2430.0,0,FLAME,Bag
VIDEXPORT,24E04708,06/13/2024,Sale,-450.0,1980.0,6,EARLY SWEET,Bag
VIDEXPORT,24E04708,06/13/2024,Sale,-360.0,1620.0,6,FLAME,Bag
VIDEXPORT,24E04708,06/17/2024,Sale,-270.0,1350.0,10,FLAME,Bag
VIDEXPORT,24E04708,06/17/2024,Sale,-720.0,630.0,10,FLAME,Bag
VIDEXPORT,24E04708,06/18/2024,Sale,-360.0,270.0,11,FLAME,Bag
VIDEXPORT,24E04708,06/24/2024,Sale,-180.0,90.0,17,FLAME,Bag
VIDEXPORT,24E04708,06/25/2024,Sale,-90.0,0.0,18,FLAME,Bag
VIDEXPORT,24E04709,06/07/2024,Entry,2340.0,2340.0,0,FLAME,Bag
VIDEXPORT,24E04709,06/08/2024,Sale,-270.0,2070.0,1,FLAME,Bag
VIDEXPORT,24E04709,06/12/2024,Sale,-900.0,1170.0,5,FLAME,Bag
VIDEXPORT,24E04709,06/12/2024,Sale,-270.0,900.0,5,FLAME,Bag
VIDEXPORT,24E04709,06/12/2024,Sale,-180.0,720.0,5,FLAME,Bag
VIDEXPORT,24E04709,06/13/2024,Sale,-270.0,450.0,6,FLAME,Bag
VIDEXPORT,24E04709,06/13/2024,Sale,-450.0,0.0,6,FLAME,Bag
VIDEXPORT,24E04710,06/07/2024,Entry,2340.0,2340.0,0,EARLY SWEET,Bag
VIDEXPORT,24E04710,06/08/2024,Sale,-180.0,2160.0,1,EARLY SWEET,Bag
VIDEXPORT,24E04710,06/11/2024,Sale,-270.0,1890.0,4,EARLY SWEET,Bag
VIDEXPORT,24E04710,06/12/2024,Sale,-450.0,1440.0,5,EARLY SWEET,Bag
VIDEXPORT,24E04710,06/13/2024,Sale,-540.0,900.0,6,EARLY SWEET,Bag
VIDEXPORT,24E04710,06/13/2024,Sale,-900.0,0.0,6,EARLY SWEET,Bag
VIDEXPORT,24E04712,06/08/2024,Entry,2340.0,2340.0,0,FLAME,Bag
VIDEXPORT,24E04712,06/11/2024,Sale,-360.0,1980.0,3,FLAME,Bag
VIDEXPORT,24E04712,06/14/2024,Sale,-180.0,1800.0,6,FLAME,Bag
VIDEXPORT,24E04712,06/14/2024,Sale,-270.0,1530.0,6,FLAME,Bag
VIDEXPORT,24E04712,06/14/2024,Sale,-540.0,990.0,6,FLAME,Bag
VIDEXPORT,24E04712,06/14/2024,Sale,-990.0,0.0,6,FLAME,Bag
VIDEXPORT,24E04713,06/07/2024,Entry,2250.0,2250.0,0,FLAME,Bag
VIDEXPORT,24E04713,06/12/2024,Sale,-180.0,2070.0,5,FLAME,Bag
VIDEXPORT,24E04713,06/15/2024,Sale,-1620.0,450.0,8,FLAME,Bag
VIDEXPORT,24E04713,06/17/2024,Sale,-270.0,180.0,10,FLAME,Bag
VIDEXPORT,24E04714,06/07/2024,Entry,2160.0,2160.0,0,FLAME,Bag
VIDEXPORT,24E04714,06/10/2024,Sale,-900.0,1260.0,3,FLAME,Bag
VIDEXPORT,24E04714,06/17/2024,Sale,-1080.0,180.0,10,FLAME,Bag
VIDEXPORT,24E04714,06/18/2024,Sale,-90.0,90.0,11,FLAME,Bag
VIDEXPORT,24E04714,06/19/2024,Sale,-90.0,0.0,12,FLAME,Bag
VIDEXPORT,24E04716,06/07/2024,Entry,1800.0,1800.0,0,EARLY SWEET,Bag
VIDEXPORT,24E04716,06/08/2024,Sale,-1440.0,360.0,1,EARLY SWEET,Bag
VIDEXPORT,24E04716,06/08/2024,Sale,-90.0,270.0,1,EARLY SWEET,Bag
VIDEXPORT,24E04716,06/08/2024,Sale,-270.0,0.0,1,EARLY SWEET,Bag
VIDEXPORT,24E04718,06/08/2024,Entry,1710.0,1710.0,0,EARLY SWEET,Bag
VIDEXPORT,24E04718,06/08/2024,Sale,-90.0,1620.0,0,EARLY SWEET,Bag
VIDEXPORT,24E04718,06/10/2024,Sale,-1440.0,180.0,2,EARLY SWEET,Bag
VIDEXPORT,24E04719,06/07/2024,Entry,1710.0,1710.0,0,EARLY SWEET,Bag
VIDEXPORT,24E04719,06/08/2024,Sale,-540.0,1170.0,1,EARLY SWEET,Bag
VIDEXPORT,24E04719,06/08/2024,Sale,-360.0,810.0,1,EARLY SWEET,Bag
VIDEXPORT,24E04719,06/08/2024,Sale,-810.0,0.0,1,EARLY SWEET,Bag
VIDEXPORT,24E04720,06/07/2024,Entry,2160.0,2160.0,0,EARLY SWEET,Bag
VIDEXPORT,24E04720,06/12/2024,Sale,-1980.0,180.0,5,EARLY SWEET,Bag
VIDEXPORT,24E04720,07/12/2024,Sale,-180.0,0.0,35,EARLY SWEET,Bag
VIDEXPORT,24E04723,06/08/2024,Entry,2160.0,2160.0,0,FLAME,Bag
VIDEXPORT,24E04723,06/14/2024,Sale,-450.0,1710.0,6,FLAME,Bag
VIDEXPORT,24E04723,06/14/2024,Sale,-450.0,1260.0,6,FLAME,Bag
VIDEXPORT,24E04723,06/14/2024,Sale,-90.0,1170.0,6,FLAME,Bag
VIDEXPORT,24E04723,06/15/2024,Sale,-810.0,360.0,7,FLAME,Bag
VIDEXPORT,24E04723,06/15/2024,Sale,-180.0,180.0,7,FLAME,Bag
VIDEXPORT,24E04723,06/17/2024,Sale,-180.0,0.0,9,FLAME,Bag
VIDEXPORT,24E04724,06/08/2024,Entry,2160.0,2160.0,0,FLAME,Bag
VIDEXPORT,24E04724,06/10/2024,Sale,-1260.0,900.0,2,FLAME,Bag
VIDEXPORT,24E04724,06/15/2024,Sale,-270.0,630.0,7,FLAME,Bag
VIDEXPORT,24E04724,06/15/2024,Sale,-90.0,540.0,7,FLAME,Bag
VIDEXPORT,24E04724,06/15/2024,Sale,-540.0,0.0,7,FLAME,Bag
VIDEXPORT,24E04725,06/08/2024,Entry,2160.0,2160.0,0,FLAME,Bag
VIDEXPORT,24E04725,06/12/2024,Sale,-90.0,2070.0,4,FLAME,Bag
VIDEXPORT,24E04725,06/13/2024,Sale,-90.0,1980.0,5,FLAME,Bag
VIDEXPORT,24E04725,06/14/2024,Sale,-270.0,1710.0,6,FLAME,Bag
VIDEXPORT,24E04725,06/14/2024,Sale,-360.0,1350.0,6,FLAME,Bag
VIDEXPORT,24E04725,06/14/2024,Sale,-180.0,1170.0,6,FLAME,Bag
VIDEXPORT,24E04725,06/15/2024,Sale,-1170.0,0.0,7,FLAME,Bag
VIDEXPORT,24E04727,06/08/2024,Entry,2160.0,2160.0,0,EARLY SWEET,Bag
VIDEXPORT,24E04727,06/08/2024,Sale,-1890.0,270.0,0,EARLY SWEET,Bag
VIDEXPORT,24E04727,06/10/2024,Sale,-90.0,180.0,2,EARLY SWEET,Bag
VIDEXPORT,24E04728,06/08/2024,Entry,2340.0,2340.0,0,EARLY SWEET,Bag
VIDEXPORT,24E04728,06/08/2024,Sale,-180.0,2160.0,0,EARLY SWEET,Bag
VIDEXPORT,24E04728,06/10/2024,Sale,-1260.0,900.0,2,EARLY SWEET,Bag
VIDEXPORT,24E04728,06/10/2024,Sale,-360.0,540.0,2,EARLY SWEET,Bag
VIDEXPORT,24E04728,06/10/2024,Sale,-450.0,90.0,2,EARLY SWEET,Bag
VIDEXPORT,24E04729,06/08/2024,Entry,2340.0,2340.0,0,FLAME,Bag
VIDEXPORT,24E04729,06/14/2024,Sale,-90.0,2250.0,6,FLAME,Bag
VIDEXPORT,24E04729,06/18/2024,Sale,-90.0,2160.0,10,FLAME,Bag
VIDEXPORT,24E04729,06/20/2024,Sale,-1170.0,990.0,12,FLAME,Bag
VIDEXPORT,24E04729,06/21/2024,Sale,-720.0,270.0,13,FLAME,Bag
VIDEXPORT,24E04729,06/24/2024,Sale,-270.0,0.0,16,FLAME,Bag
VIDEXPORT,24E04732,06/08/2024,Entry,2340.0,2340.0,0,EARLY SWEET,Bag
VIDEXPORT,24E04732,06/10/2024,Sale,-900.0,1440.0,2,EARLY SWEET,Bag
VIDEXPORT,24E04732,06/10/2024,Sale,-360.0,1080.0,2,EARLY SWEET,Bag
VIDEXPORT,24E04732,06/10/2024,Sale,-360.0,720.0,2,EARLY SWEET,Bag
VIDEXPORT,24E04732,06/11/2024,Sale,-90.0,630.0,3,EARLY SWEET,Bag
VIDEXPORT,24E04732,06/13/2024,Sale,-630.0,0.0,5,EARLY SWEET,Bag
VIDEXPORT,24E04734,06/08/2024,Entry,2160.0,2160.0,0,EARLY SWEET,Bag
VIDEXPORT,24E04734,06/08/2024,Sale,-360.0,1800.0,0,EARLY SWEET,Bag
VIDEXPORT,24E04734,06/08/2024,Sale,-1170.0,630.0,0,EARLY SWEET,Bag
VIDEXPORT,24E04734,06/11/2024,Sale,-540.0,90.0,3,EARLY SWEET,Bag
VIDEXPORT,24E04734,07/17/2024,Sale,-90.0,0.0,39,EARLY SWEET,Bag
VIDEXPORT,24E04737,06/08/2024,Entry,1980.0,1980.0,0,FLAME,Bag
VIDEXPORT,24E04737,06/15/2024,Sale,-450.0,1530.0,7,FLAME,Bag
VIDEXPORT,24E04737,06/15/2024,Sale,-360.0,1170.0,7,FLAME,Bag
VIDEXPORT,24E04737,06/15/2024,Sale,-900.0,270.0,7,FLAME,Bag
VIDEXPORT,24E04737,06/17/2024,Sale,-270.0,0.0,9,FLAME,Bag
VIDEXPORT,24E04739,06/08/2024,Entry,2340.0,2340.0,0,FLAME,Bag
VIDEXPORT,24E04739,06/18/2024,Sale,-90.0,2250.0,10,FLAME,Bag
VIDEXPORT,24E04739,06/19/2024,Sale,-1080.0,1170.0,11,FLAME,Bag
VIDEXPORT,24E04739,06/20/2024,Sale,-810.0,360.0,12,FLAME,Bag
VIDEXPORT,24E04739,06/24/2024,Sale,-360.0,0.0,16,FLAME,Bag
VIDEXPORT,24E04744,06/08/2024,Entry,1710.0,1710.0,0,EARLY SWEET,Bag
VIDEXPORT,24E04744,06/13/2024,Sale,-90.0,1620.0,5,EARLY SWEET,Bag
VIDEXPORT,24E04744,06/13/2024,Sale,-810.0,810.0,5,EARLY SWEET,Bag
VIDEXPORT,24E04744,06/13/2024,Sale,-180.0,630.0,5,EARLY SWEET,Bag
VIDEXPORT,24E04744,06/14/2024,Sale,-540.0,90.0,6,EARLY SWEET,Bag
VIDEXPORT,24E04744,06/24/2024,Sale,-90.0,0.0,16,EARLY SWEET,Bag
VIDEXPORT,24E04745,06/08/2024,Entry,2340.0,2340.0,0,FLAME,Bag
VIDEXPORT,24E04745,06/08/2024,Sale,-810.0,1530.0,0,FLAME,Bag
VIDEXPORT,24E04745,06/10/2024,Sale,-90.0,1440.0,2,FLAME,Bag
VIDEXPORT,24E04745,06/15/2024,Sale,-630.0,810.0,7,FLAME,Bag
VIDEXPORT,24E04745,06/15/2024,Sale,-810.0,0.0,7,FLAME,Bag
VIDEXPORT,24E04747,06/11/2024,Entry,1800.0,1800.0,0,EARLY SWEET,Bag
VIDEXPORT,24E04747,06/11/2024,Sale,-1800.0,0.0,0,EARLY SWEET,Bag
VIDEXPORT,24E04749,06/08/2024,Entry,360.0,360.0,0,FLAME,Bag
VIDEXPORT,24E04749,06/08/2024,Entry,1350.0,1710.0,0,FLAME,Bag
VIDEXPORT,24E04749,06/11/2024,Sale,-90.0,1620.0,3,FLAME,Bag
VIDEXPORT,24E04749,06/15/2024,Sale,-180.0,1440.0,7,FLAME,Bag
VIDEXPORT,24E04749,06/15/2024,Sale,-900.0,540.0,7,FLAME,Bag
VIDEXPORT,24E04749,06/15/2024,Sale,-180.0,360.0,7,FLAME,Bag
VIDEXPORT,24E04749,06/24/2024,Sale,-360.0,0.0,16,FLAME,Bag
VIDEXPORT,24E04752,06/08/2024,Entry,990.0,990.0,0,EARLY SWEET,Bag
VIDEXPORT,24E04752,06/08/2024,Entry,810.0,1800.0,0,EARLY SWEET,Bag
VIDEXPORT,24E04752,06/08/2024,Sale,-810.0,990.0,0,EARLY SWEET,Bag
VIDEXPORT,24E04752,06/08/2024,Sale,-810.0,180.0,0,EARLY SWEET,Bag
VIDEXPORT,24E04752,06/10/2024,Sale,-180.0,0.0,2,EARLY SWEET,Bag
VIDEXPORT,24E04756,06/10/2024,Entry,1440.0,1440.0,0,EARLY SWEET,Bag
VIDEXPORT,24E04756,06/10/2024,Entry,720.0,2160.0,0,FLAME,Bag
VIDEXPORT,24E04756,06/13/2024,Sale,-90.0,2070.0,3,EARLY SWEET,Bag
VIDEXPORT,24E04756,06/13/2024,Sale,-180.0,1890.0,3,FLAME,Bag
VIDEXPORT,24E04756,06/18/2024,Sale,-360.0,1530.0,8,FLAME,Bag
VIDEXPORT,24E04756,06/19/2024,Sale,-180.0,1350.0,9,FLAME,Bag
VIDEXPORT,24E04756,07/12/2024,Sale,-1350.0,0.0,32,EARLY SWEET,Bag
VIDEXPORT,24E04761,06/10/2024,Entry,2250.0,2250.0,0,FLAME,Bag
VIDEXPORT,24E04761,06/15/2024,Sale,-90.0,2160.0,5,FLAME,Bag
VIDEXPORT,24E04761,06/17/2024,Sale,-720.0,1440.0,7,FLAME,Bag
VIDEXPORT,24E04761,06/17/2024,Sale,-360.0,1080.0,7,FLAME,Bag
VIDEXPORT,24E04761,06/17/2024,Sale,-990.0,90.0,7,FLAME,Bag
VIDEXPORT,24E04761,06/18/2024,Sale,-90.0,0.0,8,FLAME,Bag
VIDEXPORT,24E04766,06/09/2024,Entry,2340.0,2340.0,0,FLAME,Bag
VIDEXPORT,24E04766,06/15/2024,Sale,-180.0,2160.0,6,FLAME,Bag
VIDEXPORT,24E04766,06/15/2024,Sale,-1710.0,450.0,6,FLAME,Bag
VIDEXPORT,24E04766,06/17/2024,Sale,-360.0,90.0,8,FLAME,Bag
VIDEXPORT,24E04766,07/10/2024,Sale,-90.0,0.0,31,FLAME,Bag
VIDEXPORT,24E04767,06/10/2024,Entry,1920.0,1920.0,0,HONEY POP,Clam
VIDEXPORT,24E04767,06/10/2024,Sale,-1600.0,320.0,0,HONEY POP,Clam
VIDEXPORT,24E04767,06/13/2024,Sale,-320.0,0.0,3,HONEY POP,Clam
VIDEXPORT,24E04770,06/09/2024,Entry,2240.0,2240.0,0,HONEY POP,Clam
VIDEXPORT,24E04770,06/10/2024,Sale,-320.0,1920.0,1,HONEY POP,Clam
VIDEXPORT,24E04770,06/10/2024,Sale,-1920.0,0.0,1,HONEY POP,Clam
VIDEXPORT,24E04771,06/10/2024,Entry,1890.0,1890.0,0,FLAME,Bag
VIDEXPORT,24E04771,06/15/2024,Sale,-90.0,1800.0,5,FLAME,Bag
VIDEXPORT,24E04771,06/15/2024,Sale,-540.0,1260.0,5,FLAME,Bag
VIDEXPORT,24E04771,06/15/2024,Sale,-810.0,450.0,5,FLAME,Bag
VIDEXPORT,24E04771,06/17/2024,Sale,-90.0,360.0,7,FLAME,Bag
VIDEXPORT,24E04771,06/17/2024,Sale,-180.0,180.0,7,FLAME,Bag
VIDEXPORT,24E04771,06/18/2024,Sale,-180.0,0.0,8,FLAME,Bag
VIDEXPORT,24E04775,06/10/2024,Entry,2160.0,2160.0,0,HONEY POP,Clam
VIDEXPORT,24E04775,06/10/2024,Sale,-960.0,1200.0,0,HONEY POP,Clam
VIDEXPORT,24E04775,06/11/2024,Sale,-1200.0,0.0,1,HONEY POP,Clam
VIDEXPORT,24E04776,06/10/2024,Entry,90.0,90.0,0,FLAME,Bag
VIDEXPORT,24E04776,06/10/2024,Entry,2430.0,2520.0,0,FLAME,Bag
VIDEXPORT,24E04776,06/10/2024,Sale,-1260.0,1260.0,0,FLAME,Bag
VIDEXPORT,24E04776,06/11/2024,Sale,-1170.0,90.0,1,FLAME,Bag
VIDEXPORT,24E04776,06/18/2024,Sale,-90.0,0.0,8,FLAME,Bag
VIDEXPORT,24E04785,06/11/2024,Entry,1920.0,1920.0,0,HONEY POP,Clam
VIDEXPORT,24E04785,06/11/2024,Sale,-480.0,1440.0,0,HONEY POP,Clam
VIDEXPORT,24E04785,06/11/2024,Sale,-720.0,720.0,0,HONEY POP,Clam
VIDEXPORT,24E04785,06/13/2024,Sale,-640.0,80.0,2,HONEY POP,Clam
VIDEXPORT,24E04785,06/15/2024,Sale,-80.0,0.0,4,HONEY POP,Clam
VIDEXPORT,24E04787,06/10/2024,Entry,2340.0,2340.0,0,FLAME,Bag
VIDEXPORT,24E04787,06/17/2024,Sale,-540.0,1800.0,7,FLAME,Bag
VIDEXPORT,24E04787,06/17/2024,Sale,-360.0,1440.0,7,FLAME,Bag
VIDEXPORT,24E04787,06/17/2024,Sale,-900.0,540.0,7,FLAME,Bag
VIDEXPORT,24E04787,06/19/2024,Sale,-540.0,0.0,9,FLAME,Bag
VIDEXPORT,24E04789,06/11/2024,Entry,1800.0,1800.0,0,EARLY SWEET,Clam
VIDEXPORT,24E04789,06/11/2024,Sale,-1650.0,150.0,0,EARLY SWEET,Clam
VIDEXPORT,24E04789,06/11/2024,Sale,-150.0,0.0,0,EARLY SWEET,Clam
VIDEXPORT,24E04791,06/11/2024,Entry,150.0,150.0,0,EARLY SWEET,Clam
VIDEXPORT,24E04791,06/11/2024,Entry,1800.0,1950.0,0,FLAME,Clam
VIDEXPORT,24E04791,06/17/2024,Sale,-150.0,1800.0,6,EARLY SWEET,Clam
VIDEXPORT,24E04791,06/27/2024,Sale,-825.0,975.0,16,FLAME,Clam
VIDEXPORT,24E04791,06/28/2024,Sale,-75.0,900.0,17,FLAME,Clam
VIDEXPORT,24E04791,07/01/2024,Sale,-225.0,675.0,20,FLAME,Clam
VIDEXPORT,24E04791,07/03/2024,Sale,-675.0,0.0,22,FLAME,Clam
VIDEXPORT,24E04793,06/10/2024,Entry,1800.0,1800.0,0,FLAME,Bag
VIDEXPORT,24E04793,06/17/2024,Sale,-630.0,1170.0,7,FLAME,Bag
VIDEXPORT,24E04793,06/17/2024,Sale,-90.0,1080.0,7,FLAME,Bag
VIDEXPORT,24E04793,06/19/2024,Sale,-1080.0,0.0,9,FLAME,Bag
VIDEXPORT,24E04794,06/10/2024,Entry,1800.0,1800.0,0,FLAME,Bag
VIDEXPORT,24E04794,06/10/2024,Sale,-720.0,1080.0,0,FLAME,Bag
VIDEXPORT,24E04794,06/13/2024,Sale,-630.0,450.0,3,FLAME,Bag
VIDEXPORT,24E04794,06/13/2024,Sale,-90.0,360.0,3,FLAME,Bag
VIDEXPORT,24E04794,06/15/2024,Sale,-360.0,0.0,5,FLAME,Bag
VIDEXPORT,24E04797,06/10/2024,Entry,810.0,810.0,0,FLAME,Bag
VIDEXPORT,24E04797,06/10/2024,Entry,880.0,1690.0,0,HONEY POP,Bag
VIDEXPORT,24E04797,06/10/2024,Sale,-630.0,1060.0,0,FLAME,Bag
VIDEXPORT,24E04797,06/10/2024,Sale,-880.0,180.0,0,HONEY POP,Clam
VIDEXPORT,24E04797,06/11/2024,Sale,-90.0,90.0,1,FLAME,Bag
VIDEXPORT,24E04797,06/13/2024,Sale,-90.0,0.0,3,FLAME,Bag
VIDEXPORT,24E04798,06/11/2024,Entry,1875.0,1875.0,0,FLAME,Clam
VIDEXPORT,24E04798,06/12/2024,Sale,-375.0,1500.0,1,FLAME,Clam
VIDEXPORT,24E04798,06/18/2024,Sale,-75.0,1425.0,7,FLAME,Clam
VIDEXPORT,24E04798,07/05/2024,Sale,-75.0,1350.0,24,FLAME,Clam
VIDEXPORT,24E04798,07/10/2024,Sale,-150.0,1200.0,29,FLAME,Clam
VIDEXPORT,24E04798,07/10/2024,Sale,-63.0,1137.0,29,FLAME,Bag
VIDEXPORT,24E04798,07/11/2024,Sale,-75.0,1062.0,30,FLAME,Clam
VIDEXPORT,24E04798,07/30/2024,Sale,-30.0,1032.0,49,FLAME,Bag
VIDEXPORT,24E04804,06/11/2024,Entry,1920.0,1920.0,0,HONEY POP,Clam
VIDEXPORT,24E04804,06/11/2024,Sale,-1920.0,0.0,0,HONEY POP,Clam
VIDEXPORT,24E04806,06/11/2024,Entry,2160.0,2160.0,0,FLAME,Bag
VIDEXPORT,24E04806,06/26/2024,Sale,-180.0,1980.0,15,FLAME,Bag
VIDEXPORT,24E04806,06/26/2024,Sale,-1980.0,0.0,15,FLAME,Bag
VIDEXPORT,24E04807,06/11/2024,Entry,2160.0,2160.0,0,FLAME,Bag
VIDEXPORT,24E04807,06/25/2024,Sale,-630.0,1530.0,14,FLAME,Bag
VIDEXPORT,24E04807,06/26/2024,Sale,-270.0,1260.0,15,FLAME,Bag
VIDEXPORT,24E04807,06/26/2024,Sale,-990.0,270.0,15,FLAME,Bag
VIDEXPORT,24E04807,06/26/2024,Sale,-180.0,90.0,15,FLAME,Bag
VIDEXPORT,24E04807,07/10/2024,Sale,-75.0,15.0,29,FLAME,Bag
VIDEXPORT,24E04807,07/10/2024,Sale,-15.0,0.0,29,FLAME,Bag
VIDEXPORT,24E04810,06/12/2024,Entry,2340.0,2340.0,0,FLAME,Bag
VIDEXPORT,24E04810,06/27/2024,Sale,-180.0,2160.0,15,FLAME,Bag
VIDEXPORT,24E04810,06/28/2024,Sale,-900.0,1260.0,16,FLAME,Bag
VIDEXPORT,24E04810,07/03/2024,Sale,-1260.0,0.0,21,FLAME,Bag
VIDEXPORT,24E04811,06/11/2024,Entry,1920.0,1920.0,0,HONEY POP,Clam
VIDEXPORT,24E04811,06/11/2024,Sale,-1920.0,0.0,0,HONEY POP,Clam
VIDEXPORT,24E04814,06/11/2024,Entry,1920.0,1920.0,0,HONEY POP,Clam
VIDEXPORT,24E04814,06/13/2024,Sale,-1920.0,0.0,2,HONEY POP,Clam
VIDEXPORT,24E04816,06/11/2024,Entry,2520.0,2520.0,0,FLAME,Bag
VIDEXPORT,24E04816,06/22/2024,Sale,-540.0,1980.0,11,FLAME,Bag
VIDEXPORT,24E04816,06/25/2024,Sale,-630.0,1350.0,14,FLAME,Bag
VIDEXPORT,24E04816,06/25/2024,Sale,-1350.0,0.0,14,FLAME,Bag
VIDEXPORT,24E04817,06/11/2024,Entry,1800.0,1800.0,0,FLAME,Clam
VIDEXPORT,24E04817,06/12/2024,Sale,-150.0,1650.0,1,FLAME,Clam
VIDEXPORT,24E04817,06/18/2024,Sale,-750.0,900.0,7,FLAME,Clam
VIDEXPORT,24E04817,07/01/2024,Sale,-300.0,600.0,20,FLAME,Bag
VIDEXPORT,24E04817,07/10/2024,Sale,-39.0,561.0,29,FLAME,Bag
VIDEXPORT,24E04817,07/10/2024,Sale,-39.0,522.0,29,FLAME,Bag
VIDEXPORT,24E04817,07/30/2024,Sale,-119.0,403.0,49,FLAME,Bag
VIDEXPORT,24E04818,06/11/2024,Entry,1440.0,1440.0,0,HONEY POP,Clam
VIDEXPORT,24E04818,06/11/2024,Sale,-1440.0,0.0,0,HONEY POP,Clam
VIDEXPORT,24E04819,06/12/2024,Entry,2155.0,2155.0,0,FLAME,Bag
VIDEXPORT,24E04819,06/27/2024,Sale,-180.0,1975.0,15,FLAME,Bag
VIDEXPORT,24E04819,06/27/2024,Sale,-1975.0,0.0,15,FLAME,Bag
VIDEXPORT,24E04820,06/11/2024,Entry,2160.0,2160.0,0,FLAME,Bag
VIDEXPORT,24E04820,06/19/2024,Sale,-360.0,1800.0,8,FLAME,Bag
VIDEXPORT,24E04820,06/22/2024,Sale,-810.0,990.0,11,FLAME,Bag
VIDEXPORT,24E04820,06/22/2024,Sale,-990.0,0.0,11,FLAME,Bag
VIDEXPORT,24E04827,06/11/2024,Entry,720.0,720.0,0,FLAME,Bag
VIDEXPORT,24E04827,06/11/2024,Entry,990.0,1710.0,0,PASSION FIRE,Bag
VIDEXPORT,24E04827,06/12/2024,Sale,-990.0,720.0,1,PASSION FIRE,Bag
VIDEXPORT,24E04827,06/13/2024,Sale,-720.0,0.0,2,FLAME,Bag
VIDEXPORT,24E04828,06/13/2024,Entry,1800.0,1800.0,0,FLAME,Bag
VIDEXPORT,24E04828,06/15/2024,Sale,-180.0,1620.0,2,FLAME,Bag
VIDEXPORT,24E04828,06/15/2024,Sale,-720.0,900.0,2,FLAME,Bag
VIDEXPORT,24E04828,06/18/2024,Sale,-540.0,360.0,5,FLAME,Bag
VIDEXPORT,24E04828,06/21/2024,Sale,-360.0,0.0,8,FLAME,Bag
VIDEXPORT,24E04829,06/12/2024,Entry,2340.0,2340.0,0,FLAME,Bag
VIDEXPORT,24E04829,06/26/2024,Sale,-900.0,1440.0,14,FLAME,Bag
VIDEXPORT,24E04829,06/26/2024,Sale,-1440.0,0.0,14,FLAME,Bag
VIDEXPORT,24E04830,06/12/2024,Entry,2340.0,2340.0,0,FLAME,Bag
VIDEXPORT,24E04830,06/15/2024,Sale,-1980.0,360.0,3,FLAME,Bag
VIDEXPORT,24E04830,06/26/2024,Sale,-360.0,0.0,14,FLAME,Bag
VIDEXPORT,24E04832,06/12/2024,Entry,2160.0,2160.0,0,FLAME,Bag
VIDEXPORT,24E04832,06/27/2024,Sale,-990.0,1170.0,15,FLAME,Bag
VIDEXPORT,24E04832,06/27/2024,Sale,-90.0,1080.0,15,FLAME,Bag
VIDEXPORT,24E04832,06/28/2024,Sale,-1080.0,0.0,16,FLAME,Bag
VIDEXPORT,24E04833,06/12/2024,Entry,2160.0,2160.0,0,FLAME,Bag
VIDEXPORT,24E04833,06/14/2024,Sale,-900.0,1260.0,2,FLAME,Bag
VIDEXPORT,24E04833,06/15/2024,Sale,-1260.0,0.0,3,FLAME,Bag
VIDEXPORT,24E04834,06/12/2024,Entry,2160.0,2160.0,0,FLAME,Bag
VIDEXPORT,24E04834,06/27/2024,Sale,-450.0,1710.0,15,FLAME,Bag
VIDEXPORT,24E04834,06/27/2024,Sale,-1710.0,0.0,15,FLAME,Bag
VIDEXPORT,24E04836,06/12/2024,Entry,1795.0,1795.0,0,FLAME,Bag
VIDEXPORT,24E04836,06/27/2024,Sale,-1795.0,0.0,15,FLAME,Bag
VIDEXPORT,24E04837,06/12/2024,Entry,900.0,900.0,0,FLAME,Bag
VIDEXPORT,24E04837,06/12/2024,Entry,1530.0,2430.0,0,PASSION FIRE,Bag
VIDEXPORT,24E04837,06/12/2024,Sale,-990.0,1440.0,0,PASSION FIRE,Bag
VIDEXPORT,24E04837,06/17/2024,Sale,-270.0,1170.0,5,PASSION FIRE,Bag
VIDEXPORT,24E04837,06/17/2024,Sale,-270.0,900.0,5,PASSION FIRE,Bag
VIDEXPORT,24E04837,06/18/2024,Sale,-180.0,720.0,6,FLAME,Bag
VIDEXPORT,24E04837,06/19/2024,Sale,-540.0,180.0,7,FLAME,Bag
VIDEXPORT,24E04837,06/21/2024,Sale,-180.0,0.0,9,FLAME,Bag
VIDEXPORT,24E04842,06/12/2024,Entry,2160.0,2160.0,0,FLAME,Bag
VIDEXPORT,24E04842,06/21/2024,Sale,-180.0,1980.0,9,FLAME,Bag
VIDEXPORT,24E04842,07/03/2024,Sale,-1980.0,0.0,21,FLAME,Bag
VIDEXPORT,24E04845,06/13/2024,Entry,540.0,540.0,0,EARLY SWEET,Bag
VIDEXPORT,24E04845,06/13/2024,Entry,1120.0,1660.0,0,HONEY POP,Bag
VIDEXPORT,24E04845,06/13/2024,Sale,-360.0,1300.0,0,EARLY SWEET,Bag
VIDEXPORT,24E04845,06/13/2024,Sale,-180.0,1120.0,0,EARLY SWEET,Bag
VIDEXPORT,24E04845,06/13/2024,Sale,-960.0,160.0,0,HONEY POP,Clam
VIDEXPORT,24E04845,06/15/2024,Sale,-160.0,0.0,2,HONEY POP,Clam
VIDEXPORT,24E04847,06/13/2024,Entry,1800.0,1800.0,0,FLAME,Bag
VIDEXPORT,24E04847,06/17/2024,Sale,-630.0,1170.0,4,FLAME,Bag
VIDEXPORT,24E04847,06/17/2024,Sale,-900.0,270.0,4,FLAME,Bag
VIDEXPORT,24E04847,07/06/2024,Sale,-270.0,0.0,23,FLAME,Bag
VIDEXPORT,24E04848,06/13/2024,Entry,1800.0,1800.0,0,FLAME,Bag
VIDEXPORT,24E04848,06/17/2024,Sale,-810.0,990.0,4,FLAME,Bag
VIDEXPORT,24E04848,07/03/2024,Sale,-630.0,360.0,20,FLAME,Bag
VIDEXPORT,24E04848,07/06/2024,Sale,-270.0,90.0,23,FLAME,Bag
VIDEXPORT,24E04848,09/30/2024,Sale,-90.0,0.0,109,FLAME,Bag
VIDEXPORT,24E04849,06/13/2024,Entry,1800.0,1800.0,0,FLAME,Bag
VIDEXPORT,24E04849,06/21/2024,Sale,-1800.0,0.0,8,FLAME,Bag
VIDEXPORT,24E04853,06/13/2024,Entry,2339.0,2339.0,0,FLAME,Bag
VIDEXPORT,24E04853,07/06/2024,Sale,-1439.0,900.0,23,FLAME,Bag
VIDEXPORT,24E04853,07/08/2024,Sale,-900.0,0.0,25,FLAME,Bag
VIDEXPORT,24E04859,06/13/2024,Entry,900.0,900.0,0,FLAME,Bag
VIDEXPORT,24E04859,06/13/2024,Entry,1440.0,2340.0,0,PASSION FIRE,Bag
VIDEXPORT,24E04859,06/14/2024,Sale,-810.0,1530.0,1,FLAME,Bag
VIDEXPORT,24E04859,06/15/2024,Sale,-90.0,1440.0,2,FLAME,Bag
VIDEXPORT,24E04859,06/17/2024,Sale,-360.0,1080.0,4,PASSION FIRE,Bag
VIDEXPORT,24E04859,06/17/2024,Sale,-450.0,630.0,4,PASSION FIRE,Bag
VIDEXPORT,24E04859,06/17/2024,Sale,-630.0,0.0,4,PASSION FIRE,Bag
VIDEXPORT,24E04862,06/14/2024,Entry,2340.0,2340.0,0,FLAME,Bag
VIDEXPORT,24E04862,06/14/2024,Sale,-360.0,1980.0,0,FLAME,Bag
VIDEXPORT,24E04862,06/14/2024,Sale,-1800.0,180.0,0,FLAME,Bag
VIDEXPORT,24E04862,06/15/2024,Sale,-180.0,0.0,1,FLAME,Bag
VIDEXPORT,24E04865,06/14/2024,Entry,1800.0,1800.0,0,PASSION FIRE,Bag
VIDEXPORT,24E04865,06/17/2024,Sale,-450.0,1350.0,3,PASSION FIRE,Bag
VIDEXPORT,24E04865,06/17/2024,Sale,-180.0,1170.0,3,PASSION FIRE,Bag
VIDEXPORT,24E04865,06/17/2024,Sale,-810.0,360.0,3,PASSION FIRE,Bag
VIDEXPORT,24E04865,06/21/2024,Sale,-90.0,270.0,7,PASSION FIRE,Bag
VIDEXPORT,24E04865,06/22/2024,Sale,-270.0,0.0,8,PASSION FIRE,Bag
VIDEXPORT,24E04868,06/14/2024,Entry,2160.0,2160.0,0,FLAME,Bag
VIDEXPORT,24E04868,06/29/2024,Sale,-900.0,1260.0,15,FLAME,Bag
VIDEXPORT,24E04868,07/08/2024,Sale,-1080.0,180.0,24,FLAME,Bag
VIDEXPORT,24E04868,07/10/2024,Sale,-180.0,0.0,26,FLAME,Bag
VIDEXPORT,24E04869,06/15/2024,Entry,1870.0,1870.0,0,PASSION FIRE,Bag
VIDEXPORT,24E04869,06/18/2024,Sale,-1785.0,85.0,3,PASSION FIRE,Bag
VIDEXPORT,24E04869,06/24/2024,Sale,-85.0,0.0,9,PASSION FIRE,Bag
VIDEXPORT,24E04871,06/15/2024,Entry,1870.0,1870.0,0,PASSION FIRE,Bag
VIDEXPORT,24E04871,06/15/2024,Sale,-765.0,1105.0,0,PASSION FIRE,Bag
VIDEXPORT,24E04871,06/17/2024,Sale,-85.0,1020.0,2,PASSION FIRE,Bag
VIDEXPORT,24E04871,06/18/2024,Sale,-170.0,850.0,3,PASSION FIRE,Bag
VIDEXPORT,24E04871,06/18/2024,Sale,-595.0,255.0,3,PASSION FIRE,Bag
VIDEXPORT,24E04871,06/18/2024,Sale,-255.0,0.0,3,PASSION FIRE,Bag
VIDEXPORT,24E04873,06/17/2024,Entry,1870.0,1870.0,0,PASSION FIRE,Bag
VIDEXPORT,24E04873,06/18/2024,Sale,-1105.0,765.0,1,PASSION FIRE,Bag
VIDEXPORT,24E04873,06/19/2024,Sale,-680.0,85.0,2,PASSION FIRE,Bag
VIDEXPORT,24E04873,06/22/2024,Sale,-85.0,0.0,5,PASSION FIRE,Bag
VIDEXPORT,24E04874,06/15/2024,Entry,1870.0,1870.0,0,PASSION FIRE,Bag
VIDEXPORT,24E04874,06/18/2024,Sale,-765.0,1105.0,3,PASSION FIRE,Bag
VIDEXPORT,24E04874,06/18/2024,Sale,-935.0,170.0,3,PASSION FIRE,Bag
VIDEXPORT,24E04874,06/19/2024,Sale,-85.0,85.0,4,PASSION FIRE,Bag
VIDEXPORT,24E04874,07/02/2024,Sale,-85.0,0.0,17,PASSION FIRE,Bag
VIDEXPORT,24E04876,06/15/2024,Entry,1530.0,1530.0,0,FLAME,Bag
VIDEXPORT,24E04876,06/15/2024,Entry,170.0,1700.0,0,SUGAR DROP,Bag
VIDEXPORT,24E04876,06/17/2024,Sale,-1440.0,260.0,2,FLAME,Bag
VIDEXPORT,24E04876,06/18/2024,Sale,-90.0,170.0,3,FLAME,Bag
VIDEXPORT,24E04876,07/12/2024,Sale,-170.0,0.0,27,SUGAR DROP,Bag
VIDEXPORT,24E04881,06/18/2024,Entry,1700.0,1700.0,0,PASSION FIRE,Bag
VIDEXPORT,24E04881,06/18/2024,Sale,-1445.0,255.0,0,PASSION FIRE,Bag
VIDEXPORT,24E04881,06/19/2024,Sale,-255.0,0.0,1,PASSION FIRE,Bag
VIDEXPORT,24E04882,06/17/2024,Entry,2040.0,2040.0,0,PASSION FIRE,Bag
VIDEXPORT,24E04882,06/21/2024,Sale,-765.0,1275.0,4,PASSION FIRE,Bag
VIDEXPORT,24E04882,06/26/2024,Sale,-1020.0,255.0,9,PASSION FIRE,Bag
VIDEXPORT,24E04882,07/01/2024,Sale,-255.0,0.0,14,PASSION FIRE,Bag
VIDEXPORT,24E04885,06/17/2024,Entry,1870.0,1870.0,0,PASSION FIRE,Bag
VIDEXPORT,24E04885,07/01/2024,Sale,-935.0,935.0,14,PASSION FIRE,Bag
VIDEXPORT,24E04885,07/01/2024,Sale,-170.0,765.0,14,PASSION FIRE,Bag
VIDEXPORT,24E04885,07/02/2024,Sale,-765.0,0.0,15,PASSION FIRE,Bag
VIDEXPORT,24E04888,06/17/2024,Entry,2520.0,2520.0,0,FLAME,Bag
VIDEXPORT,24E04888,06/17/2024,Sale,-90.0,2430.0,0,FLAME,Bag
VIDEXPORT,24E04888,06/17/2024,Sale,-720.0,1710.0,0,FLAME,Bag
VIDEXPORT,24E04888,06/18/2024,Sale,-540.0,1170.0,1,FLAME,Bag
VIDEXPORT,24E04888,06/18/2024,Sale,-900.0,270.0,1,FLAME,Bag
VIDEXPORT,24E04888,06/19/2024,Sale,-270.0,0.0,2,FLAME,Bag
VIDEXPORT,24E04889,06/17/2024,Entry,90.0,90.0,0,PASSION FIRE,Bag
VIDEXPORT,24E04889,06/17/2024,Entry,1955.0,2045.0,0,PASSION FIRE,Bag
VIDEXPORT,24E04889,06/27/2024,Sale,-255.0,1790.0,10,PASSION FIRE,Bag
VIDEXPORT,24E04889,06/27/2024,Sale,-170.0,1620.0,10,PASSION FIRE,Bag
VIDEXPORT,24E04889,06/27/2024,Sale,-170.0,1450.0,10,PASSION FIRE,Bag
VIDEXPORT,24E04889,06/27/2024,Sale,-170.0,1280.0,10,PASSION FIRE,Bag
VIDEXPORT,24E04889,06/27/2024,Sale,-255.0,1025.0,10,PASSION FIRE,Bag
VIDEXPORT,24E04889,07/01/2024,Sale,-935.0,90.0,14,PASSION FIRE,Bag
VIDEXPORT,24E04889,07/20/2024,Sale,-85.0,5.0,33,PASSION FIRE,Bag
VIDEXPORT,24E04890,06/17/2024,Entry,2040.0,2040.0,0,PASSION FIRE,Bag
VIDEXPORT,24E04890,06/29/2024,Sale,-1955.0,85.0,12,PASSION FIRE,Bag
VIDEXPORT,24E04890,07/02/2024,Sale,-85.0,0.0,15,PASSION FIRE,Bag
VIDEXPORT,24E04893,06/17/2024,Entry,2045.0,2045.0,0,PASSION FIRE,Bag
VIDEXPORT,24E04893,06/18/2024,Sale,-170.0,1875.0,1,PASSION FIRE,Bag
VIDEXPORT,24E04893,06/21/2024,Sale,-170.0,1705.0,4,PASSION FIRE,Bag
VIDEXPORT,24E04893,06/26/2024,Sale,-850.0,855.0,9,PASSION FIRE,Bag
VIDEXPORT,24E04893,07/01/2024,Sale,-770.0,85.0,14,PASSION FIRE,Bag
VIDEXPORT,24E04893,07/01/2024,Sale,-85.0,0.0,14,PASSION FIRE,Bag
VIDEXPORT,24E04894,06/17/2024,Entry,1965.0,1965.0,0,FLAME,Bag
VIDEXPORT,24E04894,06/18/2024,Sale,-450.0,1515.0,1,FLAME,Bag
VIDEXPORT,24E04894,06/18/2024,Sale,-990.0,525.0,1,FLAME,Bag
VIDEXPORT,24E04894,06/19/2024,Sale,-85.0,440.0,2,FLAME,Bag
VIDEXPORT,24E04894,06/21/2024,Sale,-270.0,170.0,4,FLAME,Bag
VIDEXPORT,24E04894,06/22/2024,Sale,-170.0,0.0,5,FLAME,Bag
VIDEXPORT,24E04898,06/18/2024,Entry,850.0,850.0,0,PASSION FIRE,Bag
VIDEXPORT,24E04898,06/18/2024,Entry,850.0,1700.0,0,PASSION FIRE,Bag
VIDEXPORT,24E04898,06/20/2024,Sale,-340.0,1360.0,2,PASSION FIRE,Bag
VIDEXPORT,24E04898,06/24/2024,Sale,-85.0,1275.0,6,PASSION FIRE,Bag
VIDEXPORT,24E04898,06/24/2024,Sale,-85.0,1190.0,6,PASSION FIRE,Bag
VIDEXPORT,24E04898,06/24/2024,Sale,-170.0,1020.0,6,PASSION FIRE,Bag
VIDEXPORT,24E04898,06/27/2024,Sale,-425.0,595.0,9,PASSION FIRE,Bag
VIDEXPORT,24E04898,07/01/2024,Sale,-170.0,425.0,13,PASSION FIRE,Bag
VIDEXPORT,24E04898,07/02/2024,Sale,-170.0,255.0,14,PASSION FIRE,Bag
VIDEXPORT,24E04898,07/10/2024,Sale,-255.0,0.0,22,PASSION FIRE,Bag
VIDEXPORT,24E04899,06/18/2024,Entry,2040.0,2040.0,0,PASSION FIRE,Bag
VIDEXPORT,24E04899,06/19/2024,Sale,-85.0,1955.0,1,PASSION FIRE,Bag
VIDEXPORT,24E04899,06/26/2024,Sale,-850.0,1105.0,8,PASSION FIRE,Bag
VIDEXPORT,24E04899,06/26/2024,Sale,-680.0,425.0,8,PASSION FIRE,Bag
VIDEXPORT,24E04899,06/28/2024,Sale,-170.0,255.0,10,PASSION FIRE,Bag
VIDEXPORT,24E04899,06/29/2024,Sale,-255.0,0.0,11,PASSION FIRE,Bag
VIDEXPORT,24E04901,06/18/2024,Entry,1705.0,1705.0,0,PASSION FIRE,Bag
VIDEXPORT,24E04901,06/19/2024,Sale,-425.0,1280.0,1,PASSION FIRE,Bag
VIDEXPORT,24E04901,06/21/2024,Sale,-680.0,600.0,3,PASSION FIRE,Bag
VIDEXPORT,24E04901,06/24/2024,Sale,-90.0,510.0,6,PASSION FIRE,Bag
VIDEXPORT,24E04901,06/25/2024,Sale,-340.0,170.0,7,PASSION FIRE,Bag
VIDEXPORT,24E04901,06/27/2024,Sale,-170.0,0.0,9,PASSION FIRE,Bag
VIDEXPORT,24E04903,06/18/2024,Entry,1705.0,1705.0,0,PASSION FIRE,Bag
VIDEXPORT,24E04903,06/19/2024,Sale,-425.0,1280.0,1,PASSION FIRE,Bag
VIDEXPORT,24E04903,06/21/2024,Sale,-170.0,1110.0,3,PASSION FIRE,Bag
VIDEXPORT,24E04903,06/22/2024,Sale,-855.0,255.0,4,PASSION FIRE,Bag
VIDEXPORT,24E04903,06/24/2024,Sale,-255.0,0.0,6,PASSION FIRE,Bag
VIDEXPORT,24E04906,06/18/2024,Entry,170.0,170.0,0,FLAME,Bag
VIDEXPORT,24E04906,06/18/2024,Entry,895.0,1065.0,0,FLAME,Bag
VIDEXPORT,24E04906,06/18/2024,Entry,850.0,1915.0,0,PASSION FIRE,Bag
VIDEXPORT,24E04906,06/19/2024,Sale,-175.0,1740.0,1,FLAME,Bag
VIDEXPORT,24E04906,06/19/2024,Sale,-270.0,1470.0,1,FLAME,Bag
VIDEXPORT,24E04906,06/19/2024,Sale,-450.0,1020.0,1,FLAME,Bag
VIDEXPORT,24E04906,06/26/2024,Sale,-170.0,850.0,8,FLAME,Bag
VIDEXPORT,24E04906,06/28/2024,Sale,-510.0,340.0,10,PASSION FIRE,Bag
VIDEXPORT,24E04906,07/01/2024,Sale,-340.0,0.0,13,PASSION FIRE,Bag
VIDEXPORT,24E04907,06/19/2024,Entry,2380.0,2380.0,0,PASSION FIRE,Bag
VIDEXPORT,24E04907,06/27/2024,Sale,-935.0,1445.0,8,PASSION FIRE,Bag
VIDEXPORT,24E04907,07/02/2024,Sale,-85.0,1360.0,13,PASSION FIRE,Bag
VIDEXPORT,24E04907,07/05/2024,Sale,-679.0,681.0,16,PASSION FIRE,Bag
VIDEXPORT,24E04907,07/10/2024,Sale,-680.0,1.0,21,PASSION FIRE,Bag
VIDEXPORT,24E04908,06/19/2024,Entry,350.0,350.0,0,FLAME,Bag
VIDEXPORT,24E04908,06/19/2024,Entry,1955.0,2305.0,0,PASSION FIRE,Bag
VIDEXPORT,24E04908,06/22/2024,Sale,-350.0,1955.0,3,FLAME,Bag
VIDEXPORT,24E04908,07/01/2024,Sale,-510.0,1445.0,12,PASSION FIRE,Bag
VIDEXPORT,24E04908,07/05/2024,Sale,-170.0,1275.0,16,PASSION FIRE,Bag
VIDEXPORT,24E04908,07/05/2024,Sale,-850.0,425.0,16,PASSION FIRE,Bag
VIDEXPORT,24E04908,07/05/2024,Sale,-425.0,0.0,16,PASSION FIRE,Bag
VIDEXPORT,24E04912,06/20/2024,Entry,2340.0,2340.0,0,PASSION FIRE,Bag
VIDEXPORT,24E04912,06/28/2024,Sale,-360.0,1980.0,8,PASSION FIRE,Bag
VIDEXPORT,24E04912,06/29/2024,Sale,-900.0,1080.0,9,PASSION FIRE,Bag
VIDEXPORT,24E04912,07/01/2024,Sale,-990.0,90.0,11,PASSION FIRE,Bag
VIDEXPORT,24E04914,06/20/2024,Entry,1800.0,1800.0,0,PASSION FIRE,Bag
VIDEXPORT,24E04914,06/28/2024,Sale,-540.0,1260.0,8,PASSION FIRE,Bag
VIDEXPORT,24E04914,06/28/2024,Sale,-270.0,990.0,8,PASSION FIRE,Bag
VIDEXPORT,24E04914,06/29/2024,Sale,-90.0,900.0,9,PASSION FIRE,Bag
VIDEXPORT,24E04914,07/16/2024,Sale,-540.0,360.0,26,PASSION FIRE,Bag
VIDEXPORT,24E04915,06/20/2024,Entry,1980.0,1980.0,0,PASSION FIRE,Bag
VIDEXPORT,24E04915,07/01/2024,Sale,-720.0,1260.0,11,PASSION FIRE,Bag
VIDEXPORT,24E04915,07/02/2024,Sale,-360.0,900.0,12,PASSION FIRE,Bag
VIDEXPORT,24E04915,07/02/2024,Sale,-630.0,270.0,12,PASSION FIRE,Bag
VIDEXPORT,24E04915,07/03/2024,Sale,-180.0,90.0,13,PASSION FIRE,Bag
VIDEXPORT,24E04915,07/20/2024,Sale,-90.0,0.0,30,PASSION FIRE,Bag
VIDEXPORT,24E04917,06/20/2024,Entry,1980.0,1980.0,0,PASSION FIRE,Bag
VIDEXPORT,24E04917,07/01/2024,Sale,-990.0,990.0,11,PASSION FIRE,Bag
VIDEXPORT,24E04917,07/01/2024,Sale,-990.0,0.0,11,PASSION FIRE,Bag
VIDEXPORT,24E04922,06/30/2024,Entry,540.0,540.0,0,PASSION FIRE,Bag
VIDEXPORT,24E04922,07/02/2024,Sale,-450.0,90.0,2,PASSION FIRE,Bag
VIDEXPORT,24E04922,07/10/2024,Sale,-90.0,0.0,10,PASSION FIRE,Bag
VIDEXPORT,24E04925,06/22/2024,Entry,1620.0,1620.0,0,PASSION FIRE,Bag
VIDEXPORT,24E04925,06/22/2024,Sale,-990.0,630.0,0,PASSION FIRE,Bag
VIDEXPORT,24E04925,06/28/2024,Sale,-540.0,90.0,6,PASSION FIRE,Bag
VIDEXPORT,24E04925,07/01/2024,Sale,-90.0,0.0,9,PASSION FIRE,Bag
VIDEXPORT,24E04926,06/22/2024,Entry,950.0,950.0,0,FLAME,Bag
VIDEXPORT,24E04926,06/22/2024,Entry,900.0,1850.0,0,PASSION FIRE,Bag
VIDEXPORT,24E04926,06/22/2024,Sale,-350.0,1500.0,0,FLAME,Bag
VIDEXPORT,24E04926,06/24/2024,Sale,-180.0,1320.0,2,PASSION FIRE,Bag
VIDEXPORT,24E04926,06/26/2024,Sale,-255.0,1065.0,4,FLAME,Bag
VIDEXPORT,24E04926,06/26/2024,Sale,-345.0,720.0,4,FLAME,Bag
VIDEXPORT,24E04926,06/28/2024,Sale,-630.0,90.0,6,PASSION FIRE,Bag
VIDEXPORT,24E04926,09/30/2024,Sale,-90.0,0.0,100,PASSION FIRE,Bag
VIDEXPORT,24E04927,06/25/2024,Entry,1710.0,1710.0,0,PASSION FIRE,Bag
VIDEXPORT,24E04927,06/25/2024,Sale,-1530.0,180.0,0,PASSION FIRE,Bag
VIDEXPORT,24E04927,07/02/2024,Sale,-180.0,0.0,7,PASSION FIRE,Bag
VIDEXPORT,24E04928,06/25/2024,Entry,2340.0,2340.0,0,PASSION FIRE,Bag
VIDEXPORT,24E04928,06/26/2024,Sale,-630.0,1710.0,1,PASSION FIRE,Bag
VIDEXPORT,24E04928,06/26/2024,Sale,-540.0,1170.0,1,PASSION FIRE,Bag
VIDEXPORT,24E04928,06/27/2024,Sale,-540.0,630.0,2,PASSION FIRE,Bag
VIDEXPORT,24E04928,06/27/2024,Sale,-90.0,540.0,2,PASSION FIRE,Bag
VIDEXPORT,24E04928,06/28/2024,Sale,-90.0,450.0,3,PASSION FIRE,Bag
VIDEXPORT,24E04928,06/28/2024,Sale,-90.0,360.0,3,PASSION FIRE,Bag
VIDEXPORT,24E04928,06/28/2024,Sale,-90.0,270.0,3,PASSION FIRE,Bag
VIDEXPORT,24E04928,06/28/2024,Sale,-270.0,0.0,3,PASSION FIRE,Bag
VIDEXPORT,24E04929,06/25/2024,Entry,2425.0,2425.0,0,PASSION FIRE,Bag
VIDEXPORT,24E04929,06/27/2024,Sale,-270.0,2155.0,2,PASSION FIRE,Bag
VIDEXPORT,24E04929,06/27/2024,Sale,-360.0,1795.0,2,PASSION FIRE,Bag
VIDEXPORT,24E04929,06/27/2024,Sale,-540.0,1255.0,2,PASSION FIRE,Bag
VIDEXPORT,24E04929,06/28/2024,Sale,-715.0,540.0,3,PASSION FIRE,Bag
VIDEXPORT,24E04929,06/28/2024,Sale,-270.0,270.0,3,PASSION FIRE,Bag
VIDEXPORT,24E04929,06/29/2024,Sale,-90.0,180.0,4,PASSION FIRE,Bag
VIDEXPORT,24E04929,07/01/2024,Sale,-180.0,0.0,6,PASSION FIRE,Bag
VIDEXPORT,24E04933,06/27/2024,Entry,1080.0,1080.0,0,PASSION FIRE,Bag
VIDEXPORT,24E04933,06/27/2024,Entry,810.0,1890.0,0,PASSION FIRE,Bag
VIDEXPORT,24E04933,07/01/2024,Sale,-630.0,1260.0,4,PASSION FIRE,Bag
VIDEXPORT,24E04933,07/09/2024,Sale,-450.0,810.0,12,PASSION FIRE,Bag
VIDEXPORT,24E04933,07/10/2024,Sale,-270.0,540.0,13,PASSION FIRE,Bag
VIDEXPORT,24E04933,07/10/2024,Sale,-360.0,180.0,13,PASSION FIRE,Bag
VIDEXPORT,24E04933,07/20/2024,Sale,-180.0,0.0,23,PASSION FIRE,Bag
VIDEXPORT,24E11471,05/13/2024,Entry,960.0,960.0,0,EARLY SWEET,Clam
VIDEXPORT,24E11471,05/14/2024,Sale,-960.0,0.0,1,EARLY SWEET,Clam
VIDEXPORT,24E11472,05/13/2024,Entry,2340.0,2340.0,0,EARLY SWEET,Bag
VIDEXPORT,24E11472,05/15/2024,Sale,-900.0,1440.0,2,EARLY SWEET,Bag
VIDEXPORT,24E11472,05/15/2024,Sale,-90.0,1350.0,2,EARLY SWEET,Bag
VIDEXPORT,24E11472,05/18/2024,Sale,-450.0,900.0,5,EARLY SWEET,Bag
VIDEXPORT,24E11472,05/18/2024,Sale,-270.0,630.0,5,EARLY SWEET,Bag
VIDEXPORT,24E11472,05/18/2024,Sale,-180.0,450.0,5,EARLY SWEET,Bag
VIDEXPORT,24E11472,05/18/2024,Sale,-360.0,90.0,5,EARLY SWEET,Bag
VIDEXPORT,24E11472,05/18/2024,Sale,-90.0,0.0,5,EARLY SWEET,Bag
VIDEXPORT,24E11473,05/13/2024,Entry,2340.0,2340.0,0,EARLY SWEET,Bag
VIDEXPORT,24E11473,05/15/2024,Sale,-720.0,1620.0,2,EARLY SWEET,Bag
VIDEXPORT,24E11473,05/16/2024,Sale,-450.0,1170.0,3,EARLY SWEET,Bag
VIDEXPORT,24E11473,05/16/2024,Sale,-540.0,630.0,3,EARLY SWEET,Bag
VIDEXPORT,24E11473,05/16/2024,Sale,-270.0,360.0,3,EARLY SWEET,Bag
VIDEXPORT,24E11473,05/17/2024,Sale,-90.0,270.0,4,EARLY SWEET,Bag
VIDEXPORT,24E11473,05/17/2024,Sale,-270.0,0.0,4,EARLY SWEET,Bag
VIDEXPORT,24E11475,05/13/2024,Entry,2340.0,2340.0,0,EARLY SWEET,Bag
VIDEXPORT,24E11475,05/16/2024,Sale,-90.0,2250.0,3,EARLY SWEET,Bag
VIDEXPORT,24E11475,05/16/2024,Sale,-180.0,2070.0,3,EARLY SWEET,Bag
VIDEXPORT,24E11475,05/17/2024,Sale,-810.0,1260.0,4,EARLY SWEET,Bag
VIDEXPORT,24E11475,05/17/2024,Sale,-360.0,900.0,4,EARLY SWEET,Bag
VIDEXPORT,24E11475,05/18/2024,Sale,-90.0,810.0,5,EARLY SWEET,Bag
VIDEXPORT,24E11475,05/18/2024,Sale,-360.0,450.0,5,EARLY SWEET,Bag
VIDEXPORT,24E11475,05/18/2024,Sale,-270.0,180.0,5,EARLY SWEET,Bag
VIDEXPORT,24E11475,05/18/2024,Sale,-180.0,0.0,5,EARLY SWEET,Bag
VIDEXPORT,24E11476,05/13/2024,Entry,2080.0,2080.0,0,EARLY SWEET,Clam
VIDEXPORT,24E11476,05/20/2024,Sale,-640.0,1440.0,7,EARLY SWEET,Clam
VIDEXPORT,24E11476,05/20/2024,Sale,-1440.0,0.0,7,EARLY SWEET,Clam
VIDEXPORT,24E11478,05/14/2024,Entry,960.0,960.0,0,EARLY SWEET,Clam
VIDEXPORT,24E11478,05/15/2024,Sale,-960.0,0.0,1,EARLY SWEET,Clam
VIDEXPORT,24E11480,05/14/2024,Entry,2070.0,2070.0,0,EARLY SWEET,Bag
VIDEXPORT,24E11480,05/15/2024,Sale,-270.0,1800.0,1,EARLY SWEET,Bag
VIDEXPORT,24E11480,05/15/2024,Sale,-900.0,900.0,1,EARLY SWEET,Bag
VIDEXPORT,24E11480,05/15/2024,Sale,-900.0,0.0,1,EARLY SWEET,Bag
VIDEXPORT,24E11482,05/14/2024,Entry,1760.0,1760.0,0,EARLY SWEET,Clam
VIDEXPORT,24E11482,05/16/2024,Sale,-560.0,1200.0,2,EARLY SWEET,Clam
VIDEXPORT,24E11482,05/16/2024,Sale,-1200.0,0.0,2,EARLY SWEET,Clam
VIDEXPORT,24E11483,05/14/2024,Entry,1600.0,1600.0,0,EARLY SWEET,Clam
VIDEXPORT,24E11483,05/15/2024,Sale,-880.0,720.0,1,EARLY SWEET,Clam
VIDEXPORT,24E11483,05/16/2024,Sale,-720.0,0.0,2,EARLY SWEET,Clam
VIDEXPORT,24E11486,05/14/2024,Entry,2250.0,2250.0,0,EARLY SWEET,Bag
VIDEXPORT,24E11486,05/16/2024,Sale,-630.0,1620.0,2,EARLY SWEET,Bag
VIDEXPORT,24E11486,05/16/2024,Sale,-810.0,810.0,2,EARLY SWEET,Bag
VIDEXPORT,24E11486,05/16/2024,Sale,-540.0,270.0,2,EARLY SWEET,Bag
VIDEXPORT,24E11486,05/17/2024,Sale,-270.0,0.0,3,EARLY SWEET,Bag
VIDEXPORT,24E11490,05/14/2024,Entry,1760.0,1760.0,0,EARLY SWEET,Clam
VIDEXPORT,24E11490,05/15/2024,Sale,-400.0,1360.0,1,EARLY SWEET,Clam
VIDEXPORT,24E11490,05/16/2024,Sale,-400.0,960.0,2,EARLY SWEET,Clam
VIDEXPORT,24E11490,05/17/2024,Sale,-960.0,0.0,3,EARLY SWEET,Clam
VIDEXPORT,24E11491,05/14/2024,Entry,2160.0,2160.0,0,EARLY SWEET,Bag
VIDEXPORT,24E11491,05/16/2024,Sale,-180.0,1980.0,2,EARLY SWEET,Bag
VIDEXPORT,24E11491,05/17/2024,Sale,-1980.0,0.0,3,EARLY SWEET,Bag
VIDEXPORT,24E11492,05/15/2024,Entry,1920.0,1920.0,0,EARLY SWEET,Clam
VIDEXPORT,24E11492,05/17/2024,Sale,-880.0,1040.0,2,EARLY SWEET,Clam
VIDEXPORT,24E11492,05/17/2024,Sale,-960.0,80.0,2,EARLY SWEET,Clam
VIDEXPORT,24E11492,05/17/2024,Sale,-80.0,0.0,2,EARLY SWEET,Clam
VIDEXPORT,24E11493,05/15/2024,Entry,1680.0,1680.0,0,EARLY SWEET,Clam
VIDEXPORT,24E11493,05/15/2024,Entry,240.0,1920.0,0,EARLY SWEET,Clam
VIDEXPORT,24E11493,05/17/2024,Sale,-1680.0,240.0,2,EARLY SWEET,Clam
VIDEXPORT,24E11493,05/18/2024,Sale,-160.0,80.0,3,EARLY SWEET,Clam
VIDEXPORT,24E11493,05/21/2024,Sale,-80.0,0.0,6,EARLY SWEET,Clam
VIDEXPORT,24E11494,05/15/2024,Entry,1760.0,1760.0,0,EARLY SWEET,Clam
VIDEXPORT,24E11494,05/15/2024,Entry,80.0,1840.0,0,EARLY SWEET,Clam
VIDEXPORT,24E11494,05/17/2024,Sale,-320.0,1520.0,2,EARLY SWEET,Clam
VIDEXPORT,24E11494,05/17/2024,Sale,-240.0,1280.0,2,EARLY SWEET,Clam
VIDEXPORT,24E11494,05/17/2024,Sale,-400.0,880.0,2,EARLY SWEET,Clam
VIDEXPORT,24E11494,05/17/2024,Sale,-80.0,800.0,2,EARLY SWEET,Clam
VIDEXPORT,24E11494,05/18/2024,Sale,-320.0,480.0,3,EARLY SWEET,Clam
VIDEXPORT,24E11494,05/18/2024,Sale,-80.0,400.0,3,EARLY SWEET,Clam
VIDEXPORT,24E11494,05/18/2024,Sale,-320.0,80.0,3,EARLY SWEET,Clam
VIDEXPORT,24E11494,05/20/2024,Sale,-80.0,0.0,5,EARLY SWEET,Clam
VIDEXPORT,24E11495,05/15/2024,Entry,1980.0,1980.0,0,EARLY SWEET,Bag
VIDEXPORT,24E11495,05/17/2024,Sale,-1980.0,0.0,2,EARLY SWEET,Bag
VIDEXPORT,24E11497,05/15/2024,Entry,1840.0,1840.0,0,EARLY SWEET,Clam
VIDEXPORT,24E11497,05/15/2024,Entry,80.0,1920.0,0,EARLY SWEET,Clam
VIDEXPORT,24E11497,05/17/2024,Sale,-160.0,1760.0,2,EARLY SWEET,Clam
VIDEXPORT,24E11497,05/17/2024,Sale,-1680.0,80.0,2,EARLY SWEET,Clam
VIDEXPORT,24E11497,05/18/2024,Sale,-80.0,0.0,3,EARLY SWEET,Clam
VIDEXPORT,24E11498,05/15/2024,Entry,1840.0,1840.0,0,EARLY SWEET,Clam
VIDEXPORT,24E11498,05/15/2024,Entry,80.0,1920.0,0,EARLY SWEET,Clam
VIDEXPORT,24E11498,05/18/2024,Sale,-1840.0,80.0,3,EARLY SWEET,Clam
VIDEXPORT,24E11498,05/20/2024,Sale,-80.0,0.0,5,EARLY SWEET,Clam
VIDEXPORT,24E11500,05/15/2024,Entry,2240.0,2240.0,0,EARLY SWEET,Clam
VIDEXPORT,24E11500,05/17/2024,Sale,-400.0,1840.0,2,EARLY SWEET,Clam
VIDEXPORT,24E11500,05/18/2024,Sale,-240.0,1600.0,3,EARLY SWEET,Clam
VIDEXPORT,24E11500,05/18/2024,Sale,-160.0,1440.0,3,EARLY SWEET,Clam
VIDEXPORT,24E11500,05/18/2024,Sale,-320.0,1120.0,3,EARLY SWEET,Clam
VIDEXPORT,24E11500,05/18/2024,Sale,-240.0,880.0,3,EARLY SWEET,Clam
VIDEXPORT,24E11500,05/20/2024,Sale,-320.0,560.0,5,EARLY SWEET,Clam
VIDEXPORT,24E11500,05/20/2024,Sale,-80.0,480.0,5,EARLY SWEET,Clam
VIDEXPORT,24E11500,05/20/2024,Sale,-80.0,400.0,5,EARLY SWEET,Clam
VIDEXPORT,24E11500,05/20/2024,Sale,-160.0,240.0,5,EARLY SWEET,Clam
VIDEXPORT,24E11500,05/21/2024,Sale,-240.0,0.0,6,EARLY SWEET,Clam
VIDEXPORT,24E11503,05/15/2024,Entry,1440.0,1440.0,0,EARLY SWEET,Bag
VIDEXPORT,24E11503,05/15/2024,Entry,160.0,1600.0,0,EARLY SWEET,Bag
VIDEXPORT,24E11503,05/15/2024,Entry,560.0,2160.0,0,EARLY SWEET,Bag
VIDEXPORT,24E11503,05/17/2024,Sale,-990.0,1170.0,2,EARLY SWEET,Bag
VIDEXPORT,24E11503,05/17/2024,Sale,-80.0,1090.0,2,EARLY SWEET,Clam
VIDEXPORT,24E11503,05/18/2024,Sale,-90.0,1000.0,3,EARLY SWEET,Bag
VIDEXPORT,24E11503,05/18/2024,Sale,-360.0,640.0,3,EARLY SWEET,Bag
VIDEXPORT,24E11503,05/18/2024,Sale,-80.0,560.0,3,EARLY SWEET,Clam
VIDEXPORT,24E11503,05/20/2024,Sale,-240.0,320.0,5,EARLY SWEET,Clam
VIDEXPORT,24E11503,05/20/2024,Sale,-240.0,80.0,5,EARLY SWEET,Clam
VIDEXPORT,24E11503,05/20/2024,Sale,-80.0,0.0,5,EARLY SWEET,Clam
VIDEXPORT,24E11505,05/15/2024,Entry,1890.0,1890.0,0,EARLY SWEET,Bag
VIDEXPORT,24E11505,05/20/2024,Sale,-1890.0,0.0,5,EARLY SWEET,Bag
VIDEXPORT,24E11506,05/16/2024,Entry,90.0,90.0,0,EARLY SWEET,Bag
VIDEXPORT,24E11506,05/18/2024,Sale,-90.0,0.0,2,EARLY SWEET,Bag
VIDEXPORT,24E11508,05/16/2024,Entry,1920.0,1920.0,0,EARLY SWEET,Clam
VIDEXPORT,24E11508,05/21/2024,Sale,-1920.0,0.0,5,EARLY SWEET,Clam
VIDEXPORT,24E11509,05/16/2024,Entry,1600.0,1600.0,0,EARLY SWEET,Clam
VIDEXPORT,24E11509,05/18/2024,Sale,-1600.0,0.0,2,EARLY SWEET,Clam
VIDEXPORT,24E11511,05/16/2024,Entry,1840.0,1840.0,0,EARLY SWEET,Clam
VIDEXPORT,24E11511,05/17/2024,Sale,-1840.0,0.0,1,EARLY SWEET,Clam
VIDEXPORT,24E11513,05/16/2024,Entry,1520.0,1520.0,0,EARLY SWEET,Clam
VIDEXPORT,24E11513,05/20/2024,Sale,-960.0,560.0,4,EARLY SWEET,Clam
VIDEXPORT,24E11513,05/20/2024,Sale,-320.0,240.0,4,EARLY SWEET,Clam
VIDEXPORT,24E11513,05/20/2024,Sale,-80.0,160.0,4,EARLY SWEET,Clam
VIDEXPORT,24E11513,05/20/2024,Sale,-80.0,80.0,4,EARLY SWEET,Clam
VIDEXPORT,24E11513,05/22/2024,Sale,-80.0,0.0,6,EARLY SWEET,Clam
VIDEXPORT,24E11514,05/16/2024,Entry,2160.0,2160.0,0,EARLY SWEET,Clam
VIDEXPORT,24E11514,05/16/2024,Entry,80.0,2240.0,0,EARLY SWEET,Clam
VIDEXPORT,24E11514,05/17/2024,Sale,-80.0,2160.0,1,EARLY SWEET,Clam
VIDEXPORT,24E11514,05/17/2024,Sale,-240.0,1920.0,1,EARLY SWEET,Clam
VIDEXPORT,24E11514,05/18/2024,Sale,-1840.0,80.0,2,EARLY SWEET,Clam
VIDEXPORT,24E11514,05/22/2024,Sale,-80.0,0.0,6,EARLY SWEET,Clam
VIDEXPORT,24E11516,05/16/2024,Entry,2417.0,2417.0,0,EARLY SWEET,Bag
VIDEXPORT,24E11516,05/22/2024,Sale,-270.0,2147.0,6,EARLY SWEET,Bag
VIDEXPORT,24E11516,05/23/2024,Sale,-450.0,1697.0,7,EARLY SWEET,Bag
VIDEXPORT,24E11516,05/24/2024,Sale,-1620.0,77.0,8,EARLY SWEET,Bag
VIDEXPORT,24E11516,08/02/2024,Sale,-77.0,0.0,78,EARLY SWEET,Bag
VIDEXPORT,24E11517,05/16/2024,Entry,270.0,270.0,0,EARLY SWEET,Bag
VIDEXPORT,24E11517,05/16/2024,Entry,2160.0,2430.0,0,EARLY SWEET,Bag
VIDEXPORT,24E11517,05/16/2024,Sale,-900.0,1530.0,0,EARLY SWEET,Bag
VIDEXPORT,24E11517,05/16/2024,Sale,-360.0,1170.0,0,EARLY SWEET,Bag
VIDEXPORT,24E11517,05/18/2024,Sale,-90.0,1080.0,2,EARLY SWEET,Bag
VIDEXPORT,24E11517,05/18/2024,Sale,-180.0,900.0,2,EARLY SWEET,Bag
VIDEXPORT,24E11517,05/18/2024,Sale,-360.0,540.0,2,EARLY SWEET,Bag
VIDEXPORT,24E11517,05/18/2024,Sale,-270.0,270.0,2,EARLY SWEET,Bag
VIDEXPORT,24E11517,05/20/2024,Sale,-270.0,0.0,4,EARLY SWEET,Bag
VIDEXPORT,24E11518,05/16/2024,Entry,1520.0,1520.0,0,EARLY SWEET,Clam
VIDEXPORT,24E11518,05/20/2024,Sale,-80.0,1440.0,4,EARLY SWEET,Clam
VIDEXPORT,24E11518,05/20/2024,Sale,-240.0,1200.0,4,EARLY SWEET,Clam
VIDEXPORT,24E11518,05/20/2024,Sale,-160.0,1040.0,4,EARLY SWEET,Clam
VIDEXPORT,24E11518,05/20/2024,Sale,-80.0,960.0,4,EARLY SWEET,Clam
VIDEXPORT,24E11518,05/20/2024,Sale,-80.0,880.0,4,EARLY SWEET,Clam
VIDEXPORT,24E11518,05/20/2024,Sale,-80.0,800.0,4,EARLY SWEET,Clam
VIDEXPORT,24E11518,05/22/2024,Sale,-80.0,720.0,6,EARLY SWEET,Clam
VIDEXPORT,24E11518,05/22/2024,Sale,-160.0,560.0,6,EARLY SWEET,Clam
VIDEXPORT,24E11518,05/22/2024,Sale,-80.0,480.0,6,EARLY SWEET,Clam
VIDEXPORT,24E11518,05/22/2024,Sale,-240.0,240.0,6,EARLY SWEET,Clam
VIDEXPORT,24E11518,05/22/2024,Sale,-160.0,80.0,6,EARLY SWEET,Clam
VIDEXPORT,24E11518,05/23/2024,Sale,-80.0,0.0,7,EARLY SWEET,Clam
VIDEXPORT,24E11520,05/17/2024,Entry,2340.0,2340.0,0,EARLY SWEET,Bag
VIDEXPORT,24E11520,05/18/2024,Sale,-900.0,1440.0,1,EARLY SWEET,Bag
VIDEXPORT,24E11520,05/20/2024,Sale,-540.0,900.0,3,EARLY SWEET,Bag
VIDEXPORT,24E11520,05/20/2024,Sale,-180.0,720.0,3,EARLY SWEET,Bag
VIDEXPORT,24E11520,05/20/2024,Sale,-720.0,0.0,3,EARLY SWEET,Bag
VIDEXPORT,24E11522,05/17/2024,Entry,2080.0,2080.0,0,EARLY SWEET,Clam
VIDEXPORT,24E11522,05/18/2024,Sale,-160.0,1920.0,1,EARLY SWEET,Clam
VIDEXPORT,24E11522,05/18/2024,Sale,-1920.0,0.0,1,EARLY SWEET,Clam
VIDEXPORT,24E11524,05/17/2024,Entry,2003.0,2003.0,0,EARLY SWEET,Clam
VIDEXPORT,24E11524,05/17/2024,Entry,77.0,2080.0,0,EARLY SWEET,Clam
VIDEXPORT,24E11524,05/18/2024,Sale,-80.0,2000.0,1,EARLY SWEET,Clam
VIDEXPORT,24E11524,05/18/2024,Sale,-1920.0,80.0,1,EARLY SWEET,Clam
VIDEXPORT,24E11524,05/23/2024,Sale,-76.0,4.0,6,EARLY SWEET,Clam
VIDEXPORT,24E11524,05/25/2024,Sale,-3.0,1.0,8,EARLY SWEET,Clam
VIDEXPORT,24E11526,05/17/2024,Entry,1800.0,1800.0,0,EARLY SWEET,Bag
VIDEXPORT,24E11526,05/18/2024,Sale,-540.0,1260.0,1,EARLY SWEET,Bag
VIDEXPORT,24E11526,05/18/2024,Sale,-90.0,1170.0,1,EARLY SWEET,Bag
VIDEXPORT,24E11526,05/21/2024,Sale,-1170.0,0.0,4,EARLY SWEET,Bag
VIDEXPORT,24E11527,05/17/2024,Entry,2340.0,2340.0,0,EARLY SWEET,Bag
VIDEXPORT,24E11527,05/18/2024,Sale,-900.0,1440.0,1,EARLY SWEET,Bag
VIDEXPORT,24E11527,05/20/2024,Sale,-540.0,900.0,3,EARLY SWEET,Bag
VIDEXPORT,24E11527,05/20/2024,Sale,-720.0,180.0,3,EARLY SWEET,Bag
VIDEXPORT,24E11527,05/22/2024,Sale,-180.0,0.0,5,EARLY SWEET,Bag
VIDEXPORT,24E11528,05/17/2024,Entry,1890.0,1890.0,0,EARLY SWEET,Bag
VIDEXPORT,24E11528,05/18/2024,Sale,-1890.0,0.0,1,EARLY SWEET,Bag
VIDEXPORT,24E11529,05/17/2024,Entry,1520.0,1520.0,0,EARLY SWEET,Clam
VIDEXPORT,24E11529,05/18/2024,Sale,-160.0,1360.0,1,EARLY SWEET,Clam
VIDEXPORT,24E11529,05/18/2024,Sale,-480.0,880.0,1,EARLY SWEET,Clam
VIDEXPORT,24E11529,05/18/2024,Sale,-880.0,0.0,1,EARLY SWEET,Clam
VIDEXPORT,24E11530,05/17/2024,Entry,1520.0,1520.0,0,EARLY SWEET,Clam
VIDEXPORT,24E11530,05/20/2024,Sale,-240.0,1280.0,3,EARLY SWEET,Clam
VIDEXPORT,24E11530,05/20/2024,Sale,-240.0,1040.0,3,EARLY SWEET,Clam
VIDEXPORT,24E11530,05/21/2024,Sale,-320.0,720.0,4,EARLY SWEET,Clam
VIDEXPORT,24E11530,05/22/2024,Sale,-240.0,480.0,5,EARLY SWEET,Clam
VIDEXPORT,24E11530,05/22/2024,Sale,-240.0,240.0,5,EARLY SWEET,Clam
VIDEXPORT,24E11530,05/22/2024,Sale,-160.0,80.0,5,EARLY SWEET,Clam
VIDEXPORT,24E11530,05/22/2024,Sale,-80.0,0.0,5,EARLY SWEET,Clam
VIDEXPORT,24E11531,05/17/2024,Entry,2080.0,2080.0,0,EARLY SWEET,Clam
VIDEXPORT,24E11531,05/18/2024,Sale,-1520.0,560.0,1,EARLY SWEET,Clam
VIDEXPORT,24E11531,05/20/2024,Sale,-560.0,0.0,3,EARLY SWEET,Clam
VIDEXPORT,24E11532,05/17/2024,Entry,1520.0,1520.0,0,EARLY SWEET,Clam
VIDEXPORT,24E11532,05/17/2024,Sale,-1440.0,80.0,0,EARLY SWEET,Clam
VIDEXPORT,24E11532,05/25/2024,Sale,-80.0,0.0,8,EARLY SWEET,Clam
VIDEXPORT,24E11533,05/17/2024,Entry,810.0,810.0,0,EARLY SWEET,Bag
VIDEXPORT,24E11533,05/17/2024,Entry,960.0,1770.0,0,EARLY SWEET,Bag
VIDEXPORT,24E11533,05/23/2024,Sale,-810.0,960.0,6,EARLY SWEET,Bag
VIDEXPORT,24E11533,05/24/2024,Sale,-560.0,400.0,7,EARLY SWEET,Clam
VIDEXPORT,24E11533,05/28/2024,Sale,-400.0,0.0,11,EARLY SWEET,Clam
VIDEXPORT,24E11534,05/17/2024,Entry,1920.0,1920.0,0,EARLY SWEET,Clam
VIDEXPORT,24E11534,05/18/2024,Sale,-1920.0,0.0,1,EARLY SWEET,Clam
VIDEXPORT,24E11536,05/17/2024,Entry,1260.0,1260.0,0,EARLY SWEET,Bag
VIDEXPORT,24E11536,05/17/2024,Entry,1170.0,2430.0,0,EARLY SWEET,Bag
VIDEXPORT,24E11536,05/18/2024,Sale,-1260.0,1170.0,1,EARLY SWEET,Bag
VIDEXPORT,24E11536,05/21/2024,Sale,-990.0,180.0,4,EARLY SWEET,Bag
VIDEXPORT,24E11536,05/22/2024,Sale,-180.0,0.0,5,EARLY SWEET,Bag
VIDEXPORT,24E11537,05/18/2024,Entry,2080.0,2080.0,0,EARLY SWEET,Clam
VIDEXPORT,24E11537,05/20/2024,Sale,-160.0,1920.0,2,EARLY SWEET,Clam
VIDEXPORT,24E11537,05/20/2024,Sale,-1440.0,480.0,2,EARLY SWEET,Clam
VIDEXPORT,24E11537,05/20/2024,Sale,-480.0,0.0,2,EARLY SWEET,Clam
VIDEXPORT,24E11538,05/19/2024,Entry,1840.0,1840.0,0,EARLY SWEET,Clam
VIDEXPORT,24E11538,05/20/2024,Sale,-1520.0,320.0,1,EARLY SWEET,Clam
VIDEXPORT,24E11538,05/21/2024,Sale,-160.0,160.0,2,EARLY SWEET,Clam
VIDEXPORT,24E11538,05/22/2024,Sale,-160.0,0.0,3,EARLY SWEET,Clam
VIDEXPORT,24E11539,05/18/2024,Entry,1800.0,1800.0,0,EARLY SWEET,Bag
VIDEXPORT,24E11539,05/21/2024,Sale,-990.0,810.0,3,EARLY SWEET,Bag
VIDEXPORT,24E11539,05/21/2024,Sale,-450.0,360.0,3,EARLY SWEET,Bag
VIDEXPORT,24E11539,05/21/2024,Sale,-360.0,0.0,3,EARLY SWEET,Bag
VIDEXPORT,24E11540,05/18/2024,Entry,1920.0,1920.0,0,EARLY SWEET,Clam
VIDEXPORT,24E11540,05/20/2024,Sale,-160.0,1760.0,2,EARLY SWEET,Clam
VIDEXPORT,24E11540,05/20/2024,Sale,-1120.0,640.0,2,EARLY SWEET,Clam
VIDEXPORT,24E11540,05/20/2024,Sale,-320.0,320.0,2,EARLY SWEET,Clam
VIDEXPORT,24E11540,05/20/2024,Sale,-240.0,80.0,2,EARLY SWEET,Clam
VIDEXPORT,24E11540,05/21/2024,Sale,-80.0,0.0,3,EARLY SWEET,Clam
VIDEXPORT,24E11541,05/18/2024,Entry,1840.0,1840.0,0,EARLY SWEET,Clam
VIDEXPORT,24E11541,05/18/2024,Entry,80.0,1920.0,0,EARLY SWEET,Clam
VIDEXPORT,24E11541,05/20/2024,Sale,-1360.0,560.0,2,EARLY SWEET,Clam
VIDEXPORT,24E11541,05/20/2024,Sale,-480.0,80.0,2,EARLY SWEET,Clam
VIDEXPORT,24E11541,05/23/2024,Sale,-80.0,0.0,5,EARLY SWEET,Clam
VIDEXPORT,24E11543,05/19/2024,Entry,1520.0,1520.0,0,EARLY SWEET,Clam
VIDEXPORT,24E11543,05/24/2024,Sale,-1520.0,0.0,5,EARLY SWEET,Clam
VIDEXPORT,24E11544,05/18/2024,Entry,1600.0,1600.0,0,EARLY SWEET,Clam
VIDEXPORT,24E11544,05/20/2024,Sale,-1600.0,0.0,2,EARLY SWEET,Clam
VIDEXPORT,24E11545,05/19/2024,Entry,1800.0,1800.0,0,EARLY SWEET,Bag
VIDEXPORT,24E11545,05/22/2024,Sale,-1800.0,0.0,3,EARLY SWEET,Bag
VIDEXPORT,24E11547,05/18/2024,Entry,637.0,637.0,0,EARLY SWEET,Clam
VIDEXPORT,24E11547,05/18/2024,Entry,1123.0,1760.0,0,EARLY SWEET,Clam
VIDEXPORT,24E11547,05/18/2024,Sale,-960.0,800.0,0,EARLY SWEET,Clam
VIDEXPORT,24E11547,05/21/2024,Sale,-480.0,320.0,3,EARLY SWEET,Clam
VIDEXPORT,24E11547,05/25/2024,Sale,-160.0,160.0,7,EARLY SWEET,Clam
VIDEXPORT,24E11547,05/27/2024,Sale,-80.0,80.0,9,EARLY SWEET,Clam
VIDEXPORT,24E11547,05/31/2024,Sale,-3.0,77.0,13,EARLY SWEET,Clam
VIDEXPORT,24E11547,06/03/2024,Sale,-77.0,0.0,16,EARLY SWEET,Clam
VIDEXPORT,24E11548,05/19/2024,Entry,90.0,90.0,0,EARLY SWEET,Bag
VIDEXPORT,24E11548,05/19/2024,Entry,1620.0,1710.0,0,EARLY SWEET,Bag
VIDEXPORT,24E11548,05/20/2024,Sale,-270.0,1440.0,1,EARLY SWEET,Bag
VIDEXPORT,24E11548,05/23/2024,Sale,-90.0,1350.0,4,EARLY SWEET,Bag
VIDEXPORT,24E11548,05/23/2024,Sale,-630.0,720.0,4,EARLY SWEET,Bag
VIDEXPORT,24E11548,05/24/2024,Sale,-360.0,360.0,5,EARLY SWEET,Bag
VIDEXPORT,24E11548,05/24/2024,Sale,-180.0,180.0,5,EARLY SWEET,Bag
VIDEXPORT,24E11548,05/25/2024,Sale,-180.0,0.0,6,EARLY SWEET,Bag
VIDEXPORT,24E11550,05/19/2024,Entry,1260.0,1260.0,0,EARLY SWEET,Clam
VIDEXPORT,24E11550,05/19/2024,Entry,960.0,2220.0,0,EARLY SWEET,Clam
VIDEXPORT,24E11550,05/23/2024,Sale,-240.0,1980.0,4,EARLY SWEET,Clam
VIDEXPORT,24E11550,05/23/2024,Sale,-320.0,1660.0,4,EARLY SWEET,Clam
VIDEXPORT,24E11550,05/23/2024,Sale,-160.0,1500.0,4,EARLY SWEET,Clam
VIDEXPORT,24E11550,05/23/2024,Sale,-240.0,1260.0,4,EARLY SWEET,Clam
VIDEXPORT,24E11550,05/31/2024,Sale,-990.0,270.0,12,EARLY SWEET,Bag
VIDEXPORT,24E11550,06/01/2024,Sale,-270.0,0.0,13,EARLY SWEET,Bag
VIDEXPORT,24E11551,05/20/2024,Entry,1920.0,1920.0,0,EARLY SWEET,Clam
VIDEXPORT,24E11551,05/22/2024,Sale,-80.0,1840.0,2,EARLY SWEET,Clam
VIDEXPORT,24E11551,05/22/2024,Sale,-1840.0,0.0,2,EARLY SWEET,Clam
VIDEXPORT,24E11552,05/19/2024,Entry,2160.0,2160.0,0,EARLY SWEET,Bag
VIDEXPORT,24E11552,05/25/2024,Sale,-360.0,1800.0,6,EARLY SWEET,Bag
VIDEXPORT,24E11552,05/25/2024,Sale,-630.0,1170.0,6,EARLY SWEET,Bag
VIDEXPORT,24E11552,05/25/2024,Sale,-540.0,630.0,6,EARLY SWEET,Bag
VIDEXPORT,24E11552,05/27/2024,Sale,-270.0,360.0,8,EARLY SWEET,Bag
VIDEXPORT,24E11552,05/31/2024,Sale,-270.0,90.0,12,EARLY SWEET,Bag
VIDEXPORT,24E11552,05/31/2024,Sale,-90.0,0.0,12,EARLY SWEET,Bag
VIDEXPORT,24E11553,05/20/2024,Entry,1917.0,1917.0,0,EARLY SWEET,Clam
VIDEXPORT,24E11553,05/21/2024,Sale,-160.0,1757.0,1,EARLY SWEET,Clam
VIDEXPORT,24E11553,05/21/2024,Sale,-560.0,1197.0,1,EARLY SWEET,Clam
VIDEXPORT,24E11553,05/21/2024,Sale,-720.0,477.0,1,EARLY SWEET,Clam
VIDEXPORT,24E11553,05/22/2024,Sale,-80.0,397.0,2,EARLY SWEET,Clam
VIDEXPORT,24E11553,05/22/2024,Sale,-320.0,77.0,2,EARLY SWEET,Clam
VIDEXPORT,24E11553,05/25/2024,Sale,-77.0,0.0,5,EARLY SWEET,Clam
VIDEXPORT,24E11555,05/21/2024,Entry,1980.0,1980.0,0,EARLY SWEET,Bag
VIDEXPORT,24E11555,05/22/2024,Sale,-90.0,1890.0,1,EARLY SWEET,Bag
VIDEXPORT,24E11555,05/22/2024,Sale,-270.0,1620.0,1,EARLY SWEET,Bag
VIDEXPORT,24E11555,05/23/2024,Sale,-990.0,630.0,2,EARLY SWEET,Bag
VIDEXPORT,24E11555,05/23/2024,Sale,-630.0,0.0,2,EARLY SWEET,Bag
VIDEXPORT,24E11556,05/20/2024,Entry,1920.0,1920.0,0,EARLY SWEET,Clam
VIDEXPORT,24E11556,05/22/2024,Sale,-80.0,1840.0,2,EARLY SWEET,Clam
VIDEXPORT,24E11556,05/24/2024,Sale,-1760.0,80.0,4,EARLY SWEET,Clam
VIDEXPORT,24E11556,05/25/2024,Sale,-80.0,0.0,5,EARLY SWEET,Clam
VIDEXPORT,24E11558,05/20/2024,Entry,1620.0,1620.0,0,EARLY SWEET,Bag
VIDEXPORT,24E11558,05/22/2024,Sale,-90.0,1530.0,2,EARLY SWEET,Bag
VIDEXPORT,24E11559,05/20/2024,Entry,1840.0,1840.0,0,EARLY SWEET,Clam
VIDEXPORT,24E11559,05/22/2024,Sale,-1840.0,0.0,2,EARLY SWEET,Clam
VIDEXPORT,24E11561,05/20/2024,Entry,1680.0,1680.0,0,EARLY SWEET,Clam
VIDEXPORT,24E11561,05/21/2024,Sale,-1600.0,80.0,1,EARLY SWEET,Clam
VIDEXPORT,24E11561,05/30/2024,Sale,-80.0,0.0,10,EARLY SWEET,Clam
VIDEXPORT,24E11562,05/20/2024,Entry,1600.0,1600.0,0,EARLY SWEET,Clam
VIDEXPORT,24E11562,05/22/2024,Sale,-1600.0,0.0,2,EARLY SWEET,Clam
VIDEXPORT,24E11564,05/20/2024,Entry,1600.0,1600.0,0,EARLY SWEET,Clam
VIDEXPORT,24E11564,05/20/2024,Sale,-240.0,1360.0,0,EARLY SWEET,Clam
VIDEXPORT,24E11564,05/21/2024,Sale,-80.0,1280.0,1,EARLY SWEET,Clam
VIDEXPORT,24E11564,05/21/2024,Sale,-1280.0,0.0,1,EARLY SWEET,Clam
VIDEXPORT,24E11565,05/20/2024,Entry,990.0,990.0,0,EARLY SWEET,Bag
VIDEXPORT,24E11565,05/20/2024,Entry,960.0,1950.0,0,EARLY SWEET,Bag
VIDEXPORT,24E11565,05/21/2024,Sale,-540.0,1410.0,1,EARLY SWEET,Bag
VIDEXPORT,24E11565,05/21/2024,Sale,-960.0,450.0,1,EARLY SWEET,Clam
VIDEXPORT,24E11565,05/22/2024,Sale,-450.0,0.0,2,EARLY SWEET,Bag
VIDEXPORT,24E11566,05/20/2024,Entry,1800.0,1800.0,0,EARLY SWEET,Bag
VIDEXPORT,24E11566,05/20/2024,Entry,180.0,1980.0,0,EARLY SWEET,Bag
VIDEXPORT,24E11566,05/21/2024,Sale,-180.0,1800.0,1,EARLY SWEET,Bag
VIDEXPORT,24E11566,05/23/2024,Sale,-990.0,810.0,3,EARLY SWEET,Bag
VIDEXPORT,24E11566,05/24/2024,Sale,-180.0,630.0,4,EARLY SWEET,Bag
VIDEXPORT,24E11566,05/24/2024,Sale,-630.0,0.0,4,EARLY SWEET,Bag
VIDEXPORT,24E11567,05/20/2024,Entry,2160.0,2160.0,0,EARLY SWEET,Bag
VIDEXPORT,24E11567,05/21/2024,Sale,-1980.0,180.0,1,EARLY SWEET,Bag
VIDEXPORT,24E11567,05/22/2024,Sale,-90.0,90.0,2,EARLY SWEET,Bag
VIDEXPORT,24E11567,05/22/2024,Sale,-90.0,0.0,2,EARLY SWEET,Bag
VIDEXPORT,24E11568,05/20/2024,Entry,1920.0,1920.0,0,EARLY SWEET,Clam
VIDEXPORT,24E11568,05/22/2024,Sale,-1920.0,0.0,2,EARLY SWEET,Clam
VIDEXPORT,24E11569,05/20/2024,Entry,2160.0,2160.0,0,EARLY SWEET,Bag
VIDEXPORT,24E11569,05/22/2024,Sale,-1980.0,180.0,2,EARLY SWEET,Bag
VIDEXPORT,24E11569,05/23/2024,Sale,-180.0,0.0,3,EARLY SWEET,Bag
VIDEXPORT,24E11570,05/20/2024,Entry,2160.0,2160.0,0,EARLY SWEET,Bag
VIDEXPORT,24E11570,05/22/2024,Sale,-450.0,1710.0,2,EARLY SWEET,Bag
VIDEXPORT,24E11570,05/22/2024,Sale,-900.0,810.0,2,EARLY SWEET,Bag
VIDEXPORT,24E11570,05/22/2024,Sale,-90.0,720.0,2,EARLY SWEET,Bag
VIDEXPORT,24E11570,05/23/2024,Sale,-720.0,0.0,3,EARLY SWEET,Bag
VIDEXPORT,24E11571,05/20/2024,Entry,1980.0,1980.0,0,EARLY SWEET,Bag
VIDEXPORT,24E11571,05/23/2024,Sale,-1080.0,900.0,3,EARLY SWEET,Bag
VIDEXPORT,24E11571,05/23/2024,Sale,-900.0,0.0,3,EARLY SWEET,Bag
VIDEXPORT,24E11572,05/20/2024,Entry,1840.0,1840.0,0,EARLY SWEET,Clam
VIDEXPORT,24E11572,05/24/2024,Sale,-240.0,1600.0,4,EARLY SWEET,Clam
VIDEXPORT,24E11572,05/25/2024,Sale,-560.0,1040.0,5,EARLY SWEET,Clam
VIDEXPORT,24E11572,05/25/2024,Sale,-960.0,80.0,5,EARLY SWEET,Clam
VIDEXPORT,24E11572,05/25/2024,Sale,-80.0,0.0,5,EARLY SWEET,Clam
VIDEXPORT,24E11573,05/20/2024,Entry,2160.0,2160.0,0,EARLY SWEET,Bag
VIDEXPORT,24E11573,05/23/2024,Sale,-90.0,2070.0,3,EARLY SWEET,Bag
VIDEXPORT,24E11573,05/23/2024,Sale,-90.0,1980.0,3,EARLY SWEET,Bag
VIDEXPORT,24E11573,05/23/2024,Sale,-540.0,1440.0,3,EARLY SWEET,Bag
VIDEXPORT,24E11573,05/23/2024,Sale,-900.0,540.0,3,EARLY SWEET,Bag
VIDEXPORT,24E11573,05/24/2024,Sale,-270.0,270.0,4,EARLY SWEET,Bag
VIDEXPORT,24E11573,05/31/2024,Sale,-180.0,90.0,11,EARLY SWEET,Bag
VIDEXPORT,24E11573,07/30/2024,Sale,-90.0,0.0,71,EARLY SWEET,Bag
VIDEXPORT,24E11574,05/20/2024,Entry,1920.0,1920.0,0,EARLY SWEET,Clam
VIDEXPORT,24E11574,05/21/2024,Sale,-80.0,1840.0,1,EARLY SWEET,Clam
VIDEXPORT,24E11574,05/22/2024,Sale,-1840.0,0.0,2,EARLY SWEET,Clam
VIDEXPORT,24E11577,05/20/2024,Entry,2160.0,2160.0,0,EARLY SWEET,Bag
VIDEXPORT,24E11577,05/22/2024,Sale,-1710.0,450.0,2,EARLY SWEET,Bag
VIDEXPORT,24E11577,05/22/2024,Sale,-450.0,0.0,2,EARLY SWEET,Bag
VIDEXPORT,24E11578,05/20/2024,Entry,2070.0,2070.0,0,EARLY SWEET,Bag
VIDEXPORT,24E11578,05/24/2024,Sale,-1980.0,90.0,4,EARLY SWEET,Bag
VIDEXPORT,24E11578,06/05/2024,Sale,-30.0,60.0,16,BI-COLOR,Clam
VIDEXPORT,24E11579,05/21/2024,Entry,1440.0,1440.0,0,EARLY SWEET,Bag
VIDEXPORT,24E11579,05/21/2024,Entry,630.0,2070.0,0,EARLY SWEET,Bag
VIDEXPORT,24E11579,05/22/2024,Sale,-90.0,1980.0,1,EARLY SWEET,Bag
VIDEXPORT,24E11579,05/22/2024,Sale,-450.0,1530.0,1,EARLY SWEET,Bag
VIDEXPORT,24E11579,05/22/2024,Sale,-180.0,1350.0,1,EARLY SWEET,Bag
VIDEXPORT,24E11579,05/24/2024,Sale,-540.0,810.0,3,EARLY SWEET,Bag
VIDEXPORT,24E11579,05/25/2024,Sale,-810.0,0.0,4,EARLY SWEET,Bag
VIDEXPORT,24E11581,05/20/2024,Entry,1520.0,1520.0,0,EARLY SWEET,Clam
VIDEXPORT,24E11581,05/22/2024,Sale,-80.0,1440.0,2,EARLY SWEET,Clam
VIDEXPORT,24E11581,05/22/2024,Sale,-80.0,1360.0,2,EARLY SWEET,Clam
VIDEXPORT,24E11581,05/23/2024,Sale,-1360.0,0.0,3,EARLY SWEET,Clam
VIDEXPORT,24E11582,05/21/2024,Entry,1600.0,1600.0,0,EARLY SWEET,Clam
VIDEXPORT,24E11582,05/23/2024,Sale,-560.0,1040.0,2,EARLY SWEET,Clam
VIDEXPORT,24E11582,05/23/2024,Sale,-80.0,960.0,2,EARLY SWEET,Clam
VIDEXPORT,24E11582,05/25/2024,Sale,-80.0,880.0,4,EARLY SWEET,Clam
VIDEXPORT,24E11582,05/25/2024,Sale,-880.0,0.0,4,EARLY SWEET,Clam
VIDEXPORT,24E11583,05/21/2024,Entry,2160.0,2160.0,0,EARLY SWEET,Bag
VIDEXPORT,24E11583,05/23/2024,Sale,-270.0,1890.0,2,EARLY SWEET,Bag
VIDEXPORT,24E11583,05/23/2024,Sale,-1800.0,90.0,2,EARLY SWEET,Bag
VIDEXPORT,24E11583,05/23/2024,Sale,-90.0,0.0,2,EARLY SWEET,Bag
VIDEXPORT,24E11584,05/21/2024,Entry,2080.0,2080.0,0,EARLY SWEET,Clam
VIDEXPORT,24E11584,05/23/2024,Sale,-1840.0,240.0,2,EARLY SWEET,Clam
VIDEXPORT,24E11584,05/25/2024,Sale,-240.0,0.0,4,EARLY SWEET,Clam
VIDEXPORT,24E11585,05/21/2024,Entry,2160.0,2160.0,0,EARLY SWEET,Bag
VIDEXPORT,24E11585,05/22/2024,Sale,-1620.0,540.0,1,EARLY SWEET,Bag
VIDEXPORT,24E11585,05/22/2024,Sale,-360.0,180.0,1,EARLY SWEET,Bag
VIDEXPORT,24E11585,05/23/2024,Sale,-180.0,0.0,2,EARLY SWEET,Bag
VIDEXPORT,24E11586,05/21/2024,Entry,1890.0,1890.0,0,EARLY SWEET,Bag
VIDEXPORT,24E11586,05/21/2024,Entry,630.0,2520.0,0,EARLY SWEET,Bag
VIDEXPORT,24E11586,05/23/2024,Sale,-720.0,1800.0,2,EARLY SWEET,Bag
VIDEXPORT,24E11586,05/23/2024,Sale,-90.0,1710.0,2,EARLY SWEET,Bag
VIDEXPORT,24E11586,05/24/2024,Sale,-180.0,1530.0,3,EARLY SWEET,Bag
VIDEXPORT,24E11586,05/24/2024,Sale,-450.0,1080.0,3,EARLY SWEET,Bag
VIDEXPORT,24E11586,05/24/2024,Sale,-360.0,720.0,3,EARLY SWEET,Bag
VIDEXPORT,24E11586,05/24/2024,Sale,-270.0,450.0,3,EARLY SWEET,Bag
VIDEXPORT,24E11586,05/25/2024,Sale,-360.0,90.0,4,EARLY SWEET,Bag
VIDEXPORT,24E11586,05/30/2024,Sale,-90.0,0.0,9,EARLY SWEET,Bag
VIDEXPORT,24E11587,05/21/2024,Entry,2340.0,2340.0,0,EARLY SWEET,Bag
VIDEXPORT,24E11587,05/24/2024,Sale,-1980.0,360.0,3,EARLY SWEET,Bag
VIDEXPORT,24E11587,06/08/2024,Sale,-1.0,359.0,18,BI-COLOR,Clam
VIDEXPORT,24E11589,05/21/2024,Entry,360.0,360.0,0,EARLY SWEET,Bag
VIDEXPORT,24E11589,05/21/2024,Entry,1800.0,2160.0,0,EARLY SWEET,Bag
VIDEXPORT,24E11589,05/22/2024,Sale,-990.0,1170.0,1,EARLY SWEET,Bag
VIDEXPORT,24E11589,05/23/2024,Sale,-360.0,810.0,2,EARLY SWEET,Bag
VIDEXPORT,24E11589,05/23/2024,Sale,-450.0,360.0,2,EARLY SWEET,Bag
VIDEXPORT,24E11589,05/24/2024,Sale,-360.0,0.0,3,EARLY SWEET,Bag
VIDEXPORT,24E11591,05/21/2024,Entry,2240.0,2240.0,0,EARLY SWEET,Clam
VIDEXPORT,24E11591,05/25/2024,Sale,-1883.0,357.0,4,EARLY SWEET,Clam
VIDEXPORT,24E11591,05/25/2024,Sale,-37.0,320.0,4,EARLY SWEET,Clam
VIDEXPORT,24E11591,05/25/2024,Sale,-320.0,0.0,4,EARLY SWEET,Clam
VIDEXPORT,24E11592,05/21/2024,Entry,2080.0,2080.0,0,EARLY SWEET,Clam
VIDEXPORT,24E11592,05/25/2024,Sale,-160.0,1920.0,4,EARLY SWEET,Clam
VIDEXPORT,24E11592,05/25/2024,Sale,-1920.0,0.0,4,EARLY SWEET,Clam
VIDEXPORT,24E11593,05/21/2024,Entry,90.0,90.0,0,EARLY SWEET,Bag
VIDEXPORT,24E11593,05/21/2024,Entry,2160.0,2250.0,0,EARLY SWEET,Bag
VIDEXPORT,24E11593,05/23/2024,Sale,-990.0,1260.0,2,EARLY SWEET,Bag
VIDEXPORT,24E11593,05/23/2024,Sale,-1080.0,180.0,2,EARLY SWEET,Bag
VIDEXPORT,24E11593,05/23/2024,Sale,-90.0,90.0,2,EARLY SWEET,Bag
VIDEXPORT,24E11593,05/24/2024,Sale,-90.0,0.0,3,EARLY SWEET,Bag
VIDEXPORT,24E11594,05/22/2024,Entry,2340.0,2340.0,0,EARLY SWEET,Bag
VIDEXPORT,24E11594,05/25/2024,Sale,-90.0,2250.0,3,EARLY SWEET,Bag
VIDEXPORT,24E11594,05/25/2024,Sale,-360.0,1890.0,3,EARLY SWEET,Bag
VIDEXPORT,24E11594,05/28/2024,Sale,-90.0,1800.0,6,EARLY SWEET,Bag
VIDEXPORT,24E11594,05/29/2024,Sale,-1440.0,360.0,7,EARLY SWEET,Bag
VIDEXPORT,24E11594,05/31/2024,Sale,-360.0,0.0,9,EARLY SWEET,Bag
VIDEXPORT,24E11595,05/22/2024,Entry,2160.0,2160.0,0,EARLY SWEET,Bag
VIDEXPORT,24E11595,05/24/2024,Sale,-720.0,1440.0,2,EARLY SWEET,Bag
VIDEXPORT,24E11595,05/24/2024,Sale,-1350.0,90.0,2,EARLY SWEET,Bag
VIDEXPORT,24E11595,05/24/2024,Sale,-90.0,0.0,2,EARLY SWEET,Bag
VIDEXPORT,24E11596,05/22/2024,Entry,1980.0,1980.0,0,EARLY SWEET,Clam
VIDEXPORT,24E11596,06/05/2024,Sale,-270.0,1710.0,14,BI-COLOR,Clam
VIDEXPORT,24E11596,06/06/2024,Sale,-76.0,1634.0,15,BI-COLOR,Clam
VIDEXPORT,24E11596,06/06/2024,Sale,-150.0,1484.0,15,BI-COLOR,Clam
VIDEXPORT,24E11596,06/08/2024,Sale,-37.0,1447.0,17,BI-COLOR,Clam
VIDEXPORT,24E11596,06/10/2024,Sale,-38.0,1409.0,19,BI-COLOR,Clam
VIDEXPORT,24E11596,06/11/2024,Sale,-38.0,1371.0,20,BI-COLOR,Clam
VIDEXPORT,24E11596,06/11/2024,Sale,-76.0,1295.0,20,BI-COLOR,Clam
VIDEXPORT,24E11596,06/12/2024,Sale,-75.0,1220.0,21,EARLY SWEET,Clam
VIDEXPORT,24E11596,06/12/2024,Sale,-225.0,995.0,21,EARLY SWEET,Clam
VIDEXPORT,24E11596,06/12/2024,Sale,-375.0,620.0,21,EARLY SWEET,Clam
VIDEXPORT,24E11596,06/13/2024,Sale,-446.0,174.0,22,EARLY SWEET,Clam
VIDEXPORT,24E11597,05/22/2024,Entry,1600.0,1600.0,0,EARLY SWEET,Clam
VIDEXPORT,24E11597,05/25/2024,Sale,-1440.0,160.0,3,EARLY SWEET,Clam
VIDEXPORT,24E11597,05/25/2024,Sale,-160.0,0.0,3,EARLY SWEET,Clam
VIDEXPORT,24E11598,05/23/2024,Entry,1890.0,1890.0,0,EARLY SWEET,Bag
VIDEXPORT,24E11598,05/23/2024,Sale,-1800.0,90.0,0,EARLY SWEET,Bag
VIDEXPORT,24E11598,05/24/2024,Sale,-90.0,0.0,1,EARLY SWEET,Bag
VIDEXPORT,24E11599,05/23/2024,Entry,2080.0,2080.0,0,EARLY SWEET,Clam
VIDEXPORT,24E11599,05/23/2024,Sale,-160.0,1920.0,0,EARLY SWEET,Clam
VIDEXPORT,24E11599,05/24/2024,Sale,-1760.0,160.0,1,EARLY SWEET,Clam
VIDEXPORT,24E11599,05/25/2024,Sale,-150.0,10.0,2,EARLY SWEET,Clam
VIDEXPORT,24E11599,06/03/2024,Sale,-10.0,0.0,11,EARLY SWEET,Clam
VIDEXPORT,24E11600,05/22/2024,Entry,1710.0,1710.0,0,EARLY SWEET,Bag
VIDEXPORT,24E11600,05/29/2024,Sale,-450.0,1260.0,7,EARLY SWEET,Bag
VIDEXPORT,24E11600,05/29/2024,Sale,-180.0,1080.0,7,EARLY SWEET,Bag
VIDEXPORT,24E11600,05/29/2024,Sale,-1080.0,0.0,7,EARLY SWEET,Bag
VIDEXPORT,24E11601,05/22/2024,Entry,1600.0,1600.0,0,EARLY SWEET,Clam
VIDEXPORT,24E11601,05/24/2024,Sale,-640.0,960.0,2,EARLY SWEET,Clam
VIDEXPORT,24E11601,05/25/2024,Sale,-960.0,0.0,3,EARLY SWEET,Clam
VIDEXPORT,24E11602,05/22/2024,Entry,1800.0,1800.0,0,EARLY SWEET,Bag
VIDEXPORT,24E11602,05/29/2024,Sale,-540.0,1260.0,7,EARLY SWEET,Bag
VIDEXPORT,24E11602,05/29/2024,Sale,-450.0,810.0,7,EARLY SWEET,Bag
VIDEXPORT,24E11602,05/30/2024,Sale,-360.0,450.0,8,EARLY SWEET,Bag
VIDEXPORT,24E11602,05/30/2024,Sale,-450.0,0.0,8,EARLY SWEET,Bag
VIDEXPORT,24E11604,05/22/2024,Entry,1800.0,1800.0,0,EARLY SWEET,Bag
VIDEXPORT,24E11604,05/27/2024,Sale,-90.0,1710.0,5,EARLY SWEET,Bag
VIDEXPORT,24E11604,05/29/2024,Sale,-90.0,1620.0,7,EARLY SWEET,Bag
VIDEXPORT,24E11604,05/29/2024,Sale,-450.0,1170.0,7,EARLY SWEET,Bag
VIDEXPORT,24E11604,05/29/2024,Sale,-990.0,180.0,7,EARLY SWEET,Bag
VIDEXPORT,24E11604,05/29/2024,Sale,-90.0,90.0,7,EARLY SWEET,Bag
VIDEXPORT,24E11604,05/30/2024,Sale,-90.0,0.0,8,EARLY SWEET,Bag
VIDEXPORT,24E11605,05/22/2024,Entry,1520.0,1520.0,0,EARLY SWEET,Clam
VIDEXPORT,24E11605,05/25/2024,Sale,-560.0,960.0,3,EARLY SWEET,Clam
VIDEXPORT,24E11605,05/25/2024,Sale,-640.0,320.0,3,EARLY SWEET,Clam
VIDEXPORT,24E11605,05/25/2024,Sale,-320.0,0.0,3,EARLY SWEET,Clam
VIDEXPORT,24E11606,05/22/2024,Entry,1980.0,1980.0,0,EARLY SWEET,Clam
VIDEXPORT,24E11606,06/04/2024,Sale,-75.0,1905.0,13,EARLY SWEET,Clam
VIDEXPORT,24E11606,06/05/2024,Sale,-25.0,1880.0,14,BI-COLOR,Clam
VIDEXPORT,24E11606,06/05/2024,Sale,-425.0,1455.0,14,BI-COLOR,Clam
VIDEXPORT,24E11606,06/08/2024,Sale,-150.0,1305.0,17,EARLY SWEET,Clam
VIDEXPORT,24E11606,06/10/2024,Sale,-150.0,1155.0,19,BI-COLOR,Clam
VIDEXPORT,24E11606,06/11/2024,Sale,-525.0,630.0,20,EARLY SWEET,Clam
VIDEXPORT,24E11606,06/11/2024,Sale,-150.0,480.0,20,EARLY SWEET,Clam
VIDEXPORT,24E11607,05/23/2024,Entry,2160.0,2160.0,0,EARLY SWEET,Bag
VIDEXPORT,24E11607,05/23/2024,Sale,-1800.0,360.0,0,EARLY SWEET,Bag
VIDEXPORT,24E11607,05/24/2024,Sale,-180.0,180.0,1,EARLY SWEET,Bag
VIDEXPORT,24E11607,05/24/2024,Sale,-180.0,0.0,1,EARLY SWEET,Bag
VIDEXPORT,24E11608,05/24/2024,Entry,2340.0,2340.0,0,EARLY SWEET,Bag
VIDEXPORT,24E11608,05/29/2024,Sale,-1080.0,1260.0,5,EARLY SWEET,Bag
VIDEXPORT,24E11608,05/31/2024,Sale,-540.0,720.0,7,EARLY SWEET,Bag
VIDEXPORT,24E11608,05/31/2024,Sale,-630.0,90.0,7,EARLY SWEET,Bag
VIDEXPORT,24E11608,06/01/2024,Sale,-90.0,0.0,8,EARLY SWEET,Bag
VIDEXPORT,24E11609,05/24/2024,Entry,2340.0,2340.0,0,EARLY SWEET,Bag
VIDEXPORT,24E11609,05/24/2024,Sale,-1260.0,1080.0,0,EARLY SWEET,Bag
VIDEXPORT,24E11609,05/24/2024,Sale,-1080.0,0.0,0,EARLY SWEET,Bag
VIDEXPORT,24E11610,05/23/2024,Entry,1890.0,1890.0,0,EARLY SWEET,Bag
VIDEXPORT,24E11610,05/30/2024,Sale,-360.0,1530.0,7,EARLY SWEET,Bag
VIDEXPORT,24E11610,05/30/2024,Sale,-1440.0,90.0,7,EARLY SWEET,Bag
VIDEXPORT,24E11610,05/31/2024,Sale,-90.0,0.0,8,EARLY SWEET,Bag
VIDEXPORT,24E11611,05/23/2024,Entry,1600.0,1600.0,0,EARLY SWEET,Clam
VIDEXPORT,24E11611,05/25/2024,Sale,-1600.0,0.0,2,EARLY SWEET,Clam
VIDEXPORT,24E11612,05/24/2024,Entry,2080.0,2080.0,0,EARLY SWEET,Clam
VIDEXPORT,24E11612,05/27/2024,Sale,-1440.0,640.0,3,EARLY SWEET,Clam
VIDEXPORT,24E11612,05/27/2024,Sale,-240.0,400.0,3,EARLY SWEET,Clam
VIDEXPORT,24E11612,05/27/2024,Sale,-400.0,0.0,3,EARLY SWEET,Clam
VIDEXPORT,24E11613,05/23/2024,Entry,1800.0,1800.0,0,EARLY SWEET,Bag
VIDEXPORT,24E11613,05/30/2024,Sale,-1710.0,90.0,7,EARLY SWEET,Bag
VIDEXPORT,24E11613,05/31/2024,Sale,-90.0,0.0,8,EARLY SWEET,Bag
VIDEXPORT,24E11614,05/23/2024,Entry,1980.0,1980.0,0,EARLY SWEET,Bag
VIDEXPORT,24E11614,05/24/2024,Sale,-180.0,1800.0,1,EARLY SWEET,Bag
VIDEXPORT,24E11614,05/24/2024,Sale,-1800.0,0.0,1,EARLY SWEET,Bag
VIDEXPORT,24E11615,05/25/2024,Entry,2340.0,2340.0,0,EARLY SWEET,Bag
VIDEXPORT,24E11615,05/30/2024,Sale,-1980.0,360.0,5,EARLY SWEET,Bag
VIDEXPORT,24E11615,05/30/2024,Sale,-270.0,90.0,5,EARLY SWEET,Bag
VIDEXPORT,24E11615,06/01/2024,Sale,-90.0,0.0,7,EARLY SWEET,Bag
VIDEXPORT,24E11616,05/23/2024,Entry,1600.0,1600.0,0,EARLY SWEET,Clam
VIDEXPORT,24E11616,05/25/2024,Sale,-80.0,1520.0,2,EARLY SWEET,Clam
VIDEXPORT,24E11616,05/27/2024,Sale,-1520.0,0.0,4,EARLY SWEET,Clam
VIDEXPORT,24E11617,05/24/2024,Entry,1520.0,1520.0,0,EARLY SWEET,Clam
VIDEXPORT,24E11617,05/24/2024,Entry,80.0,1600.0,0,EARLY SWEET,Clam
VIDEXPORT,24E11617,05/25/2024,Sale,-80.0,1520.0,1,EARLY SWEET,Clam
VIDEXPORT,24E11617,05/27/2024,Sale,-1520.0,0.0,3,EARLY SWEET,Clam
VIDEXPORT,24E11618,05/23/2024,Entry,1800.0,1800.0,0,EARLY SWEET,Bag
VIDEXPORT,24E11618,05/23/2024,Sale,-1710.0,90.0,0,EARLY SWEET,Bag
VIDEXPORT,24E11618,05/24/2024,Sale,-90.0,0.0,1,EARLY SWEET,Bag
VIDEXPORT,24E11619,05/23/2024,Entry,2520.0,2520.0,0,EARLY SWEET,Bag
VIDEXPORT,24E11619,06/01/2024,Sale,-1980.0,540.0,9,EARLY SWEET,Bag
VIDEXPORT,24E11620,05/23/2024,Entry,90.0,90.0,0,EARLY SWEET,Clam
VIDEXPORT,24E11620,05/23/2024,Entry,1520.0,1610.0,0,EARLY SWEET,Clam
VIDEXPORT,24E11620,05/25/2024,Sale,-1200.0,410.0,2,EARLY SWEET,Clam
VIDEXPORT,24E11620,05/25/2024,Sale,-160.0,250.0,2,EARLY SWEET,Clam
VIDEXPORT,24E11620,05/27/2024,Sale,-160.0,90.0,4,EARLY SWEET,Clam
VIDEXPORT,24E11621,05/23/2024,Entry,1800.0,1800.0,0,EARLY SWEET,Clam
VIDEXPORT,24E11621,05/23/2024,Entry,400.0,2200.0,0,EARLY SWEET,Clam
VIDEXPORT,24E11621,05/24/2024,Sale,-160.0,2040.0,1,EARLY SWEET,Clam
VIDEXPORT,24E11621,05/25/2024,Sale,-80.0,1960.0,2,EARLY SWEET,Clam
VIDEXPORT,24E11621,05/25/2024,Sale,-160.0,1800.0,2,EARLY SWEET,Clam
VIDEXPORT,24E11621,05/30/2024,Sale,-180.0,1620.0,7,EARLY SWEET,Bag
VIDEXPORT,24E11621,05/30/2024,Sale,-1620.0,0.0,7,EARLY SWEET,Bag
VIDEXPORT,24E11622,05/24/2024,Entry,1920.0,1920.0,0,EARLY SWEET,Clam
VIDEXPORT,24E11622,05/28/2024,Sale,-480.0,1440.0,4,EARLY SWEET,Clam
VIDEXPORT,24E11622,05/28/2024,Sale,-1440.0,0.0,4,EARLY SWEET,Clam
VIDEXPORT,24E11623,05/24/2024,Entry,2340.0,2340.0,0,EARLY SWEET,Bag
VIDEXPORT,24E11623,05/24/2024,Sale,-1260.0,1080.0,0,EARLY SWEET,Bag
VIDEXPORT,24E11623,05/24/2024,Sale,-1080.0,0.0,0,EARLY SWEET,Bag
VIDEXPORT,24E11624,05/24/2024,Entry,2340.0,2340.0,0,EARLY SWEET,Bag
VIDEXPORT,24E11624,05/27/2024,Sale,-90.0,2250.0,3,EARLY SWEET,Bag
VIDEXPORT,24E11624,05/31/2024,Sale,-360.0,1890.0,7,EARLY SWEET,Bag
VIDEXPORT,24E11624,05/31/2024,Sale,-1890.0,0.0,7,EARLY SWEET,Bag
VIDEXPORT,24E11625,05/25/2024,Entry,2340.0,2340.0,0,EARLY SWEET,Bag
VIDEXPORT,24E11625,05/31/2024,Sale,-1350.0,990.0,6,EARLY SWEET,Bag
VIDEXPORT,24E11625,05/31/2024,Sale,-630.0,360.0,6,EARLY SWEET,Bag
VIDEXPORT,24E11625,05/31/2024,Sale,-180.0,180.0,6,EARLY SWEET,Bag
VIDEXPORT,24E11625,05/31/2024,Sale,-90.0,90.0,6,EARLY SWEET,Bag
VIDEXPORT,24E11625,06/01/2024,Sale,-90.0,0.0,7,EARLY SWEET,Bag
VIDEXPORT,24E11626,05/24/2024,Entry,2340.0,2340.0,0,EARLY SWEET,Bag
VIDEXPORT,24E11626,05/24/2024,Sale,-360.0,1980.0,0,EARLY SWEET,Bag
VIDEXPORT,24E11626,05/24/2024,Sale,-1800.0,180.0,0,EARLY SWEET,Bag
VIDEXPORT,24E11626,05/25/2024,Sale,-90.0,90.0,1,EARLY SWEET,Bag
VIDEXPORT,24E11626,05/28/2024,Sale,-90.0,0.0,4,EARLY SWEET,Bag
VIDEXPORT,24E11627,05/24/2024,Entry,2160.0,2160.0,0,EARLY SWEET,Bag
VIDEXPORT,24E11627,05/25/2024,Sale,-1980.0,180.0,1,EARLY SWEET,Bag
VIDEXPORT,24E11627,05/25/2024,Sale,-180.0,0.0,1,EARLY SWEET,Bag
VIDEXPORT,24E11628,05/25/2024,Entry,1980.0,1980.0,0,EARLY SWEET,Bag
VIDEXPORT,24E11628,05/30/2024,Sale,-90.0,1890.0,5,EARLY SWEET,Bag
VIDEXPORT,24E11628,05/30/2024,Sale,-630.0,1260.0,5,EARLY SWEET,Bag
VIDEXPORT,24E11628,05/31/2024,Sale,-90.0,1170.0,6,EARLY SWEET,Bag
VIDEXPORT,24E11628,06/01/2024,Sale,-450.0,720.0,7,EARLY SWEET,Bag
VIDEXPORT,24E11628,06/08/2024,Sale,-90.0,630.0,14,EARLY SWEET,Bag
VIDEXPORT,24E11628,06/12/2024,Sale,-450.0,180.0,18,EARLY SWEET,Bag
VIDEXPORT,24E11628,06/14/2024,Sale,-180.0,0.0,20,EARLY SWEET,Bag
VIDEXPORT,24E11629,05/25/2024,Entry,2340.0,2340.0,0,EARLY SWEET,Bag
VIDEXPORT,24E11629,05/25/2024,Sale,-360.0,1980.0,0,EARLY SWEET,Bag
VIDEXPORT,24E11629,05/25/2024,Sale,-1980.0,0.0,0,EARLY SWEET,Bag
VIDEXPORT,24E11630,05/24/2024,Entry,1980.0,1980.0,0,EARLY SWEET,Bag
VIDEXPORT,24E11630,05/30/2024,Sale,-180.0,1800.0,6,EARLY SWEET,Bag
VIDEXPORT,24E11630,05/30/2024,Sale,-720.0,1080.0,6,EARLY SWEET,Bag
VIDEXPORT,24E11630,05/30/2024,Sale,-90.0,990.0,6,EARLY SWEET,Bag
VIDEXPORT,24E11630,05/31/2024,Sale,-180.0,810.0,7,EARLY SWEET,Bag
VIDEXPORT,24E11630,05/31/2024,Sale,-90.0,720.0,7,EARLY SWEET,Bag
VIDEXPORT,24E11630,05/31/2024,Sale,-270.0,450.0,7,EARLY SWEET,Bag
VIDEXPORT,24E11630,05/31/2024,Sale,-90.0,360.0,7,EARLY SWEET,Bag
VIDEXPORT,24E11630,06/12/2024,Sale,-180.0,180.0,19,EARLY SWEET,Bag
VIDEXPORT,24E11630,06/12/2024,Sale,-90.0,90.0,19,EARLY SWEET,Bag
VIDEXPORT,24E11630,06/24/2024,Sale,-90.0,0.0,31,EARLY SWEET,Bag
VIDEXPORT,24E11631,05/24/2024,Entry,2340.0,2340.0,0,EARLY SWEET,Bag
VIDEXPORT,24E11631,05/25/2024,Sale,-180.0,2160.0,1,EARLY SWEET,Bag
VIDEXPORT,24E11631,05/25/2024,Sale,-1800.0,360.0,1,EARLY SWEET,Bag
VIDEXPORT,24E11631,05/25/2024,Sale,-180.0,180.0,1,EARLY SWEET,Bag
VIDEXPORT,24E11631,05/31/2024,Sale,-180.0,0.0,7,EARLY SWEET,Bag
VIDEXPORT,24E11632,05/25/2024,Entry,2070.0,2070.0,0,EARLY SWEET,Bag
VIDEXPORT,24E11632,06/01/2024,Sale,-1890.0,180.0,7,EARLY SWEET,Bag
VIDEXPORT,24E11632,06/01/2024,Sale,-180.0,0.0,7,EARLY SWEET,Bag
VIDEXPORT,24E11633,05/24/2024,Entry,1920.0,1920.0,0,EARLY SWEET,Clam
VIDEXPORT,24E11633,05/24/2024,Entry,160.0,2080.0,0,EARLY SWEET,Clam
VIDEXPORT,24E11633,05/27/2024,Sale,-125.0,1955.0,3,EARLY SWEET,Clam
VIDEXPORT,24E11633,05/27/2024,Sale,-160.0,1795.0,3,EARLY SWEET,Clam
VIDEXPORT,24E11633,05/30/2024,Sale,-800.0,995.0,6,EARLY SWEET,Clam
VIDEXPORT,24E11633,05/31/2024,Sale,-160.0,835.0,7,EARLY SWEET,Clam
VIDEXPORT,24E11633,06/03/2024,Sale,-35.0,800.0,10,EARLY SWEET,Clam
VIDEXPORT,24E11633,06/04/2024,Sale,-160.0,640.0,11,EARLY SWEET,Clam
VIDEXPORT,24E11633,06/05/2024,Sale,-560.0,80.0,12,EARLY SWEET,Clam
VIDEXPORT,24E11633,06/11/2024,Sale,-80.0,0.0,18,EARLY SWEET,Clam
VIDEXPORT,24E11634,05/25/2024,Entry,2340.0,2340.0,0,EARLY SWEET,Bag
VIDEXPORT,24E11634,05/25/2024,Sale,-1980.0,360.0,0,EARLY SWEET,Bag
VIDEXPORT,24E11634,05/25/2024,Sale,-360.0,0.0,0,EARLY SWEET,Bag
VIDEXPORT,24E11635,05/25/2024,Entry,1890.0,1890.0,0,EARLY SWEET,Bag
VIDEXPORT,24E11635,05/25/2024,Entry,320.0,2210.0,0,EARLY SWEET,Bag
VIDEXPORT,24E11635,05/30/2024,Sale,-90.0,2120.0,5,EARLY SWEET,Bag
VIDEXPORT,24E11635,05/31/2024,Sale,-1800.0,320.0,6,EARLY SWEET,Bag
VIDEXPORT,24E11635,06/06/2024,Sale,-160.0,160.0,12,EARLY SWEET,Clam
VIDEXPORT,24E11635,06/07/2024,Sale,-160.0,0.0,13,EARLY SWEET,Clam
VIDEXPORT,24E11638,05/27/2024,Entry,2340.0,2340.0,0,EARLY SWEET,Bag
VIDEXPORT,24E11638,05/27/2024,Sale,-1080.0,1260.0,0,EARLY SWEET,Bag
VIDEXPORT,24E11638,05/27/2024,Sale,-1260.0,0.0,0,EARLY SWEET,Bag
VIDEXPORT,24E11639,05/25/2024,Entry,2340.0,2340.0,0,EARLY SWEET,Bag
VIDEXPORT,24E11639,05/27/2024,Sale,-450.0,1890.0,2,EARLY SWEET,Bag
VIDEXPORT,24E11639,05/27/2024,Sale,-1710.0,180.0,2,EARLY SWEET,Bag
VIDEXPORT,24E11639,05/28/2024,Sale,-180.0,0.0,3,EARLY SWEET,Bag
VIDEXPORT,24E11640,05/25/2024,Entry,2160.0,2160.0,0,EARLY SWEET,Bag
VIDEXPORT,24E11640,05/27/2024,Sale,-1260.0,900.0,2,EARLY SWEET,Bag
VIDEXPORT,24E11640,05/27/2024,Sale,-360.0,540.0,2,EARLY SWEET,Bag
VIDEXPORT,24E11640,05/29/2024,Sale,-540.0,0.0,4,EARLY SWEET,Bag
VIDEXPORT,24E11641,05/25/2024,Entry,2340.0,2340.0,0,EARLY SWEET,Bag
VIDEXPORT,24E11641,05/25/2024,Sale,-720.0,1620.0,0,EARLY SWEET,Bag
VIDEXPORT,24E11641,05/25/2024,Sale,-630.0,990.0,0,EARLY SWEET,Bag
VIDEXPORT,24E11641,05/27/2024,Sale,-360.0,630.0,2,EARLY SWEET,Bag
VIDEXPORT,24E11641,05/27/2024,Sale,-630.0,0.0,2,EARLY SWEET,Bag
VIDEXPORT,24E11642,05/27/2024,Entry,2340.0,2340.0,0,EARLY SWEET,Bag
VIDEXPORT,24E11642,06/03/2024,Sale,-1350.0,990.0,7,EARLY SWEET,Bag
VIDEXPORT,24E11642,06/03/2024,Sale,-900.0,90.0,7,EARLY SWEET,Bag
VIDEXPORT,24E11645,05/25/2024,Entry,2340.0,2340.0,0,EARLY SWEET,Bag
VIDEXPORT,24E11645,05/25/2024,Sale,-1980.0,360.0,0,EARLY SWEET,Bag
VIDEXPORT,24E11645,05/25/2024,Sale,-90.0,270.0,0,EARLY SWEET,Bag
VIDEXPORT,24E11645,05/27/2024,Sale,-270.0,0.0,2,EARLY SWEET,Bag
VIDEXPORT,24E11646,05/25/2024,Entry,1800.0,1800.0,0,EARLY SWEET,Bag
VIDEXPORT,24E11646,05/27/2024,Sale,-180.0,1620.0,2,EARLY SWEET,Bag
VIDEXPORT,24E11646,05/31/2024,Sale,-1620.0,0.0,6,EARLY SWEET,Bag
VIDEXPORT,24E11647,05/25/2024,Entry,2160.0,2160.0,0,EARLY SWEET,Bag
VIDEXPORT,24E11647,05/27/2024,Sale,-180.0,1980.0,2,EARLY SWEET,Bag
VIDEXPORT,24E11647,05/27/2024,Sale,-360.0,1620.0,2,EARLY SWEET,Bag
VIDEXPORT,24E11647,05/28/2024,Sale,-180.0,1440.0,3,EARLY SWEET,Bag
VIDEXPORT,24E11647,05/28/2024,Sale,-1440.0,0.0,3,EARLY SWEET,Bag
VIDEXPORT,24E11648,05/27/2024,Entry,1800.0,1800.0,0,EARLY SWEET,Bag
VIDEXPORT,24E11648,05/29/2024,Sale,-180.0,1620.0,2,EARLY SWEET,Bag
VIDEXPORT,24E11648,05/29/2024,Sale,-360.0,1260.0,2,EARLY SWEET,Bag
VIDEXPORT,24E11648,05/31/2024,Sale,-1260.0,0.0,4,EARLY SWEET,Bag
VIDEXPORT,24E11649,05/27/2024,Entry,2160.0,2160.0,0,EARLY SWEET,Bag
VIDEXPORT,24E11649,05/28/2024,Sale,-270.0,1890.0,1,EARLY SWEET,Bag
VIDEXPORT,24E11649,05/29/2024,Sale,-1710.0,180.0,2,EARLY SWEET,Bag
VIDEXPORT,24E11649,05/29/2024,Sale,-180.0,0.0,2,EARLY SWEET,Bag
VIDEXPORT,24E11650,05/25/2024,Entry,2160.0,2160.0,0,EARLY SWEET,Bag
VIDEXPORT,24E11650,05/27/2024,Sale,-900.0,1260.0,2,EARLY SWEET,Bag
VIDEXPORT,24E11650,05/29/2024,Sale,-810.0,450.0,4,EARLY SWEET,Bag
VIDEXPORT,24E11650,05/29/2024,Sale,-360.0,90.0,4,EARLY SWEET,Bag
VIDEXPORT,24E11650,05/31/2024,Sale,-90.0,0.0,6,EARLY SWEET,Bag
VIDEXPORT,24E11651,05/25/2024,Entry,1890.0,1890.0,0,EARLY SWEET,Bag
VIDEXPORT,24E11651,05/25/2024,Sale,-180.0,1710.0,0,EARLY SWEET,Bag
VIDEXPORT,24E11651,05/25/2024,Sale,-540.0,1170.0,0,EARLY SWEET,Bag
VIDEXPORT,24E11651,05/27/2024,Sale,-990.0,180.0,2,EARLY SWEET,Bag
VIDEXPORT,24E11651,05/28/2024,Sale,-90.0,90.0,3,EARLY SWEET,Bag
VIDEXPORT,24E11651,05/28/2024,Sale,-90.0,0.0,3,EARLY SWEET,Bag
VIDEXPORT,24E11652,05/27/2024,Entry,1530.0,1530.0,0,EARLY SWEET,Bag
VIDEXPORT,24E11652,05/29/2024,Sale,-90.0,1440.0,2,EARLY SWEET,Bag
VIDEXPORT,24E11652,05/31/2024,Sale,-1440.0,0.0,4,EARLY SWEET,Bag
VIDEXPORT,24E11654,05/27/2024,Entry,2340.0,2340.0,0,EARLY SWEET,Bag
VIDEXPORT,24E11654,05/31/2024,Sale,-1980.0,360.0,4,EARLY SWEET,Bag
VIDEXPORT,24E11654,06/01/2024,Sale,-360.0,0.0,5,EARLY SWEET,Bag
VIDEXPORT,24E11655,05/27/2024,Entry,2340.0,2340.0,0,EARLY SWEET,Bag
VIDEXPORT,24E11655,05/28/2024,Sale,-720.0,1620.0,1,EARLY SWEET,Bag
VIDEXPORT,24E11655,05/28/2024,Sale,-1620.0,0.0,1,EARLY SWEET,Bag
VIDEXPORT,24E11658,05/27/2024,Entry,2520.0,2520.0,0,EARLY SWEET,Bag
VIDEXPORT,24E11658,05/28/2024,Sale,-540.0,1980.0,1,EARLY SWEET,Bag
VIDEXPORT,24E11658,05/28/2024,Sale,-1440.0,540.0,1,EARLY SWEET,Bag
VIDEXPORT,24E11658,05/28/2024,Sale,-540.0,0.0,1,EARLY SWEET,Bag
VIDEXPORT,24E11659,05/27/2024,Entry,2520.0,2520.0,0,EARLY SWEET,Bag
VIDEXPORT,24E11659,05/27/2024,Sale,-1710.0,810.0,0,EARLY SWEET,Bag
VIDEXPORT,24E11659,05/27/2024,Sale,-360.0,450.0,0,EARLY SWEET,Bag
VIDEXPORT,24E11659,05/27/2024,Sale,-90.0,360.0,0,EARLY SWEET,Bag
VIDEXPORT,24E11659,05/28/2024,Sale,-360.0,0.0,1,EARLY SWEET,Bag
VIDEXPORT,24E11660,05/27/2024,Entry,2340.0,2340.0,0,EARLY SWEET,Bag
VIDEXPORT,24E11660,05/28/2024,Sale,-720.0,1620.0,1,EARLY SWEET,Bag
VIDEXPORT,24E11660,05/29/2024,Sale,-540.0,1080.0,2,EARLY SWEET,Bag
VIDEXPORT,24E11660,05/29/2024,Sale,-1080.0,0.0,2,EARLY SWEET,Bag
VIDEXPORT,24E11661,05/27/2024,Entry,2340.0,2340.0,0,EARLY SWEET,Bag
VIDEXPORT,24E11661,05/28/2024,Sale,-90.0,2250.0,1,EARLY SWEET,Bag
VIDEXPORT,24E11661,05/28/2024,Sale,-270.0,1980.0,1,EARLY SWEET,Bag
VIDEXPORT,24E11661,05/28/2024,Sale,-990.0,990.0,1,EARLY SWEET,Bag
VIDEXPORT,24E11661,05/28/2024,Sale,-630.0,360.0,1,EARLY SWEET,Bag
VIDEXPORT,24E11661,05/29/2024,Sale,-360.0,0.0,2,EARLY SWEET,Bag
VIDEXPORT,24E11662,05/27/2024,Entry,1530.0,1530.0,0,EARLY SWEET,Bag
VIDEXPORT,24E11662,05/27/2024,Sale,-1530.0,0.0,0,EARLY SWEET,Bag
VIDEXPORT,24E11663,05/28/2024,Entry,1800.0,1800.0,0,EARLY SWEET,Bag
VIDEXPORT,24E11663,05/29/2024,Sale,-540.0,1260.0,1,EARLY SWEET,Bag
VIDEXPORT,24E11663,05/29/2024,Sale,-270.0,990.0,1,EARLY SWEET,Bag
VIDEXPORT,24E11663,05/31/2024,Sale,-990.0,0.0,3,EARLY SWEET,Bag
VIDEXPORT,24E11665,05/27/2024,Entry,2160.0,2160.0,0,EARLY SWEET,Bag
VIDEXPORT,24E11665,05/31/2024,Sale,-180.0,1980.0,4,EARLY SWEET,Bag
VIDEXPORT,24E11665,05/31/2024,Sale,-1980.0,0.0,4,EARLY SWEET,Bag
VIDEXPORT,24E11666,05/27/2024,Entry,720.0,720.0,0,EARLY SWEET,Bag
VIDEXPORT,24E11666,05/27/2024,Entry,1530.0,2250.0,0,EARLY SWEET,Bag
VIDEXPORT,24E11666,05/27/2024,Sale,-990.0,1260.0,0,EARLY SWEET,Bag
VIDEXPORT,24E11666,05/28/2024,Sale,-540.0,720.0,1,EARLY SWEET,Bag
VIDEXPORT,24E11666,05/29/2024,Sale,-720.0,0.0,2,EARLY SWEET,Bag
VIDEXPORT,24E11669,05/27/2024,Entry,2520.0,2520.0,0,EARLY SWEET,Bag
VIDEXPORT,24E11669,05/28/2024,Sale,-180.0,2340.0,1,EARLY SWEET,Bag
VIDEXPORT,24E11669,05/28/2024,Sale,-540.0,1800.0,1,EARLY SWEET,Bag
VIDEXPORT,24E11669,05/29/2024,Sale,-630.0,1170.0,2,EARLY SWEET,Bag
VIDEXPORT,24E11669,05/30/2024,Sale,-180.0,990.0,3,EARLY SWEET,Bag
VIDEXPORT,24E11669,05/31/2024,Sale,-990.0,0.0,4,EARLY SWEET,Bag
VIDEXPORT,24E11674,05/27/2024,Entry,2160.0,2160.0,0,EARLY SWEET,Bag
VIDEXPORT,24E11674,05/28/2024,Sale,-540.0,1620.0,1,EARLY SWEET,Bag
VIDEXPORT,24E11674,05/28/2024,Sale,-270.0,1350.0,1,EARLY SWEET,Bag
VIDEXPORT,24E11674,05/28/2024,Sale,-1350.0,0.0,1,EARLY SWEET,Bag
VIDEXPORT,24E11676,05/28/2024,Entry,2160.0,2160.0,0,EARLY SWEET,Bag
VIDEXPORT,24E11676,05/28/2024,Sale,-90.0,2070.0,0,EARLY SWEET,Bag
VIDEXPORT,24E11676,05/30/2024,Sale,-540.0,1530.0,2,EARLY SWEET,Bag
VIDEXPORT,24E11676,05/30/2024,Sale,-450.0,1080.0,2,EARLY SWEET,Bag
VIDEXPORT,24E11676,05/30/2024,Sale,-270.0,810.0,2,EARLY SWEET,Bag
VIDEXPORT,24E11676,05/30/2024,Sale,-270.0,540.0,2,EARLY SWEET,Bag
VIDEXPORT,24E11676,05/30/2024,Sale,-540.0,0.0,2,EARLY SWEET,Bag
VIDEXPORT,24E11677,05/28/2024,Entry,1800.0,1800.0,0,HONEY POP,Bag
VIDEXPORT,24E11677,05/30/2024,Sale,-900.0,900.0,2,HONEY POP,Bag
VIDEXPORT,24E11677,05/30/2024,Sale,-720.0,180.0,2,HONEY POP,Bag
VIDEXPORT,24E11677,05/31/2024,Sale,-40.0,140.0,3,BI-COLOR,Clam
VIDEXPORT,24E11678,05/28/2024,Entry,1980.0,1980.0,0,EARLY SWEET,Bag
VIDEXPORT,24E11678,05/28/2024,Entry,400.0,2380.0,0,EARLY SWEET,Bag
VIDEXPORT,24E11678,05/29/2024,Sale,-1080.0,1300.0,1,EARLY SWEET,Bag
VIDEXPORT,24E11678,05/29/2024,Sale,-160.0,1140.0,1,EARLY SWEET,Clam
VIDEXPORT,24E11678,05/30/2024,Sale,-270.0,870.0,2,EARLY SWEET,Bag
VIDEXPORT,24E11678,05/30/2024,Sale,-450.0,420.0,2,EARLY SWEET,Bag
VIDEXPORT,24E11678,05/31/2024,Sale,-180.0,240.0,3,EARLY SWEET,Bag
VIDEXPORT,24E11678,05/31/2024,Sale,-80.0,160.0,3,EARLY SWEET,Clam
VIDEXPORT,24E11678,06/01/2024,Sale,-160.0,0.0,4,EARLY SWEET,Clam
VIDEXPORT,24E11679,05/28/2024,Entry,2520.0,2520.0,0,EARLY SWEET,Bag
VIDEXPORT,24E11679,05/29/2024,Sale,-1980.0,540.0,1,EARLY SWEET,Bag
VIDEXPORT,24E11679,05/29/2024,Sale,-360.0,180.0,1,EARLY SWEET,Bag
VIDEXPORT,24E11679,05/29/2024,Sale,-90.0,90.0,1,EARLY SWEET,Bag
VIDEXPORT,24E11679,06/01/2024,Sale,-90.0,0.0,4,EARLY SWEET,Bag
VIDEXPORT,24E11680,05/28/2024,Entry,2160.0,2160.0,0,EARLY SWEET,Bag
VIDEXPORT,24E11680,05/29/2024,Sale,-360.0,1800.0,1,EARLY SWEET,Bag
VIDEXPORT,24E11680,05/29/2024,Sale,-1260.0,540.0,1,EARLY SWEET,Bag
VIDEXPORT,24E11680,05/30/2024,Sale,-270.0,270.0,2,EARLY SWEET,Bag
VIDEXPORT,24E11680,05/30/2024,Sale,-270.0,0.0,2,EARLY SWEET,Bag
VIDEXPORT,24E11681,05/28/2024,Entry,2520.0,2520.0,0,EARLY SWEET,Bag
VIDEXPORT,24E11681,06/11/2024,Sale,-450.0,2070.0,14,EARLY SWEET,Bag
VIDEXPORT,24E11681,06/11/2024,Sale,-90.0,1980.0,14,EARLY SWEET,Bag
VIDEXPORT,24E11681,06/11/2024,Sale,-1980.0,0.0,14,EARLY SWEET,Bag
VIDEXPORT,24E11682,05/27/2024,Entry,90.0,90.0,0,EARLY SWEET,Bag
VIDEXPORT,24E11682,05/28/2024,Sale,-90.0,0.0,1,EARLY SWEET,Bag
VIDEXPORT,24E11683,05/28/2024,Entry,2250.0,2250.0,0,EARLY SWEET,Bag
VIDEXPORT,24E11683,06/11/2024,Sale,-360.0,1890.0,14,EARLY SWEET,Bag
VIDEXPORT,24E11683,06/12/2024,Sale,-1890.0,0.0,15,EARLY SWEET,Bag
VIDEXPORT,24E11684,05/28/2024,Entry,1350.0,1350.0,0,EARLY SWEET,Bag
VIDEXPORT,24E11684,05/28/2024,Entry,90.0,1440.0,0,HONEY POP,Bag
VIDEXPORT,24E11684,05/28/2024,Entry,270.0,1710.0,0,HONEY POP,Bag
VIDEXPORT,24E11684,05/29/2024,Sale,-360.0,1350.0,1,EARLY SWEET,Bag
VIDEXPORT,24E11684,05/29/2024,Sale,-90.0,1260.0,1,EARLY SWEET,Bag
VIDEXPORT,24E11684,05/29/2024,Sale,-90.0,1170.0,1,EARLY SWEET,Bag
VIDEXPORT,24E11684,05/30/2024,Sale,-630.0,540.0,2,EARLY SWEET,Bag
VIDEXPORT,24E11684,05/30/2024,Sale,-90.0,450.0,2,EARLY SWEET,Bag
VIDEXPORT,24E11684,05/31/2024,Sale,-40.0,410.0,3,BI-COLOR,Clam
VIDEXPORT,24E11684,05/31/2024,Sale,-90.0,320.0,3,EARLY SWEET,Bag
VIDEXPORT,24E11684,07/10/2024,Sale,-270.0,50.0,43,HONEY POP,Bag
VIDEXPORT,24E11687,05/28/2024,Entry,2520.0,2520.0,0,EARLY SWEET,Bag
VIDEXPORT,24E11687,05/30/2024,Sale,-270.0,2250.0,2,EARLY SWEET,Bag
VIDEXPORT,24E11687,05/30/2024,Sale,-1080.0,1170.0,2,EARLY SWEET,Bag
VIDEXPORT,24E11687,05/30/2024,Sale,-900.0,270.0,2,EARLY SWEET,Bag
VIDEXPORT,24E11687,06/01/2024,Sale,-90.0,180.0,4,EARLY SWEET,Bag
VIDEXPORT,24E11687,06/01/2024,Sale,-180.0,0.0,4,EARLY SWEET,Bag
VIDEXPORT,24E11689,05/29/2024,Entry,2520.0,2520.0,0,HONEY POP,Bag
VIDEXPORT,24E11689,06/01/2024,Sale,-90.0,2430.0,3,HONEY POP,Bag
VIDEXPORT,24E11689,06/01/2024,Sale,-810.0,1620.0,3,HONEY POP,Bag
VIDEXPORT,24E11689,06/01/2024,Sale,-270.0,1350.0,3,HONEY POP,Bag
VIDEXPORT,24E11689,06/08/2024,Sale,-1350.0,0.0,10,HONEY POP,Bag
VIDEXPORT,24E11693,05/29/2024,Entry,1650.0,1650.0,0,SUGAR DROP,Clam
VIDEXPORT,24E11693,06/10/2024,Sale,-1650.0,0.0,12,SUGAR DROP,Clam
VIDEXPORT,24E11694,05/29/2024,Entry,2430.0,2430.0,0,HONEY POP,Bag
VIDEXPORT,24E11694,06/01/2024,Sale,-540.0,1890.0,3,HONEY POP,Bag
VIDEXPORT,24E11694,06/01/2024,Sale,-1710.0,180.0,3,HONEY POP,Bag
VIDEXPORT,24E11694,06/08/2024,Sale,-180.0,0.0,10,HONEY POP,Bag
VIDEXPORT,24E11695,05/29/2024,Entry,1620.0,1620.0,0,EARLY SWEET,Bag
VIDEXPORT,24E11695,05/30/2024,Sale,-1620.0,0.0,1,EARLY SWEET,Bag
VIDEXPORT,24E11696,05/29/2024,Entry,1520.0,1520.0,0,EARLY SWEET,Clam
VIDEXPORT,24E11696,05/31/2024,Sale,-1520.0,0.0,2,EARLY SWEET,Clam
VIDEXPORT,24E11698,05/29/2024,Entry,1760.0,1760.0,0,EARLY SWEET,Clam
VIDEXPORT,24E11698,06/03/2024,Sale,-1600.0,160.0,5,EARLY SWEET,Clam
VIDEXPORT,24E11698,06/05/2024,Sale,-160.0,0.0,7,EARLY SWEET,Clam
VIDEXPORT,24E11702,05/29/2024,Entry,1800.0,1800.0,0,EARLY SWEET,Bag
VIDEXPORT,24E11702,05/30/2024,Sale,-90.0,1710.0,1,EARLY SWEET,Bag
VIDEXPORT,24E11702,05/30/2024,Sale,-900.0,810.0,1,EARLY SWEET,Bag
VIDEXPORT,24E11702,05/30/2024,Sale,-90.0,720.0,1,EARLY SWEET,Bag
VIDEXPORT,24E11702,05/30/2024,Sale,-540.0,180.0,1,EARLY SWEET,Bag
VIDEXPORT,24E11702,05/31/2024,Sale,-180.0,0.0,2,EARLY SWEET,Bag
VIDEXPORT,24E11703,05/30/2024,Entry,1620.0,1620.0,0,HONEY POP,Bag
VIDEXPORT,24E11703,06/01/2024,Sale,-720.0,900.0,2,HONEY POP,Bag
VIDEXPORT,24E11703,06/03/2024,Sale,-900.0,0.0,4,HONEY POP,Bag
VIDEXPORT,24E11704,05/30/2024,Entry,1260.0,1260.0,0,EARLY SWEET,Bag
VIDEXPORT,24E11704,05/30/2024,Entry,240.0,1500.0,0,EARLY SWEET,Bag
VIDEXPORT,24E11704,05/30/2024,Entry,85.0,1585.0,0,SUGAR DROP,Bag
VIDEXPORT,24E11704,05/30/2024,Sale,-90.0,1495.0,0,EARLY SWEET,Bag
VIDEXPORT,24E11704,05/30/2024,Sale,-1170.0,325.0,0,EARLY SWEET,Bag
VIDEXPORT,24E11704,06/06/2024,Sale,-80.0,245.0,7,EARLY SWEET,Clam
VIDEXPORT,24E11704,06/08/2024,Sale,-160.0,85.0,9,EARLY SWEET,Clam
VIDEXPORT,24E11704,06/28/2024,Sale,-85.0,0.0,29,SUGAR DROP,Bag
VIDEXPORT,24E11705,05/30/2024,Entry,2080.0,2080.0,0,EARLY SWEET,Clam
VIDEXPORT,24E11705,06/06/2024,Sale,-2080.0,0.0,7,EARLY SWEET,Clam
VIDEXPORT,24E11706,05/30/2024,Entry,1600.0,1600.0,0,EARLY SWEET,Clam
VIDEXPORT,24E11706,06/04/2024,Sale,-1600.0,0.0,5,EARLY SWEET,Clam
VIDEXPORT,24E11707,05/30/2024,Entry,1700.0,1700.0,0,SUGAR DROP,Bag
VIDEXPORT,24E11707,06/05/2024,Sale,-1530.0,170.0,6,SUGAR DROP,Bag
VIDEXPORT,24E11707,06/05/2024,Sale,-170.0,0.0,6,SUGAR DROP,Bag
VIDEXPORT,24E11708,05/30/2024,Entry,900.0,900.0,0,HONEY POP,Bag
VIDEXPORT,24E11708,05/30/2024,Entry,850.0,1750.0,0,SUGAR DROP,Bag
VIDEXPORT,24E11708,05/30/2024,Entry,150.0,1900.0,0,SUGAR DROP,Bag
VIDEXPORT,24E11708,06/01/2024,Sale,-900.0,1000.0,2,HONEY POP,Bag
VIDEXPORT,24E11708,06/05/2024,Sale,-170.0,830.0,6,SUGAR DROP,Bag
VIDEXPORT,24E11708,06/06/2024,Sale,-680.0,150.0,7,SUGAR DROP,Bag
VIDEXPORT,24E11708,06/10/2024,Sale,-150.0,0.0,11,SUGAR DROP,Clam
VIDEXPORT,24E11709,05/30/2024,Entry,1980.0,1980.0,0,EARLY SWEET,Bag
VIDEXPORT,24E11709,05/31/2024,Sale,-90.0,1890.0,1,EARLY SWEET,Bag
VIDEXPORT,24E11709,05/31/2024,Sale,-1530.0,360.0,1,EARLY SWEET,Bag
VIDEXPORT,24E11709,05/31/2024,Sale,-360.0,0.0,1,EARLY SWEET,Bag
VIDEXPORT,24E11711,05/31/2024,Entry,1440.0,1440.0,0,EARLY SWEET,Clam
VIDEXPORT,24E11711,05/31/2024,Entry,640.0,2080.0,0,EARLY SWEET,Clam
VIDEXPORT,24E11711,05/31/2024,Sale,-160.0,1920.0,0,EARLY SWEET,Clam
VIDEXPORT,24E11711,06/01/2024,Sale,-270.0,1650.0,1,EARLY SWEET,Bag
VIDEXPORT,24E11711,06/01/2024,Sale,-1170.0,480.0,1,EARLY SWEET,Bag
VIDEXPORT,24E11711,06/01/2024,Sale,-160.0,320.0,1,EARLY SWEET,Clam
VIDEXPORT,24E11711,06/08/2024,Sale,-320.0,0.0,8,EARLY SWEET,Clam
VIDEXPORT,24E11712,05/31/2024,Entry,1980.0,1980.0,0,EARLY SWEET,Bag
VIDEXPORT,24E11712,05/31/2024,Sale,-180.0,1800.0,0,EARLY SWEET,Bag
VIDEXPORT,24E11712,05/31/2024,Sale,-90.0,1710.0,0,EARLY SWEET,Bag
VIDEXPORT,24E11712,05/31/2024,Sale,-180.0,1530.0,0,EARLY SWEET,Bag
VIDEXPORT,24E11712,05/31/2024,Sale,-630.0,900.0,0,EARLY SWEET,Bag
VIDEXPORT,24E11712,06/01/2024,Sale,-90.0,810.0,1,EARLY SWEET,Bag
VIDEXPORT,24E11712,06/01/2024,Sale,-810.0,0.0,1,EARLY SWEET,Bag
VIDEXPORT,24E11714,06/01/2024,Entry,810.0,810.0,0,EARLY SWEET,Bag
VIDEXPORT,24E11714,06/01/2024,Sale,-810.0,0.0,0,EARLY SWEET,Bag
VIDEXPORT,24E11716,06/01/2024,Entry,2070.0,2070.0,0,EARLY SWEET,Bag
VIDEXPORT,24E11716,06/01/2024,Sale,-180.0,1890.0,0,EARLY SWEET,Bag
VIDEXPORT,24E11716,06/01/2024,Sale,-270.0,1620.0,0,EARLY SWEET,Bag
VIDEXPORT,24E11716,06/01/2024,Sale,-1440.0,180.0,0,EARLY SWEET,Bag
VIDEXPORT,24E11716,06/01/2024,Sale,-90.0,90.0,0,EARLY SWEET,Bag
VIDEXPORT,24E11716,06/03/2024,Sale,-90.0,0.0,2,EARLY SWEET,Bag
VIDEXPORT,24E11721,06/04/2024,Entry,90.0,90.0,0,EARLY SWEET,Bag
VIDEXPORT,24E11721,06/04/2024,Entry,90.0,180.0,0,HONEY POP,Bag
VIDEXPORT,24E11721,06/04/2024,Entry,90.0,270.0,0,HONEY POP,Bag
VIDEXPORT,24E11721,06/05/2024,Sale,-90.0,180.0,1,EARLY SWEET,Bag
VIDEXPORT,24E11721,06/07/2024,Sale,-90.0,90.0,3,HONEY POP,Bag
VIDEXPORT,24E11721,06/08/2024,Sale,-90.0,0.0,4,HONEY POP,Bag
VIDEXPORT,24E14000,05/30/2024,Entry,2210.0,2210.0,0,EARLY SWEET,Bag
VIDEXPORT,24E14000,05/31/2024,Sale,-170.0,2040.0,1,EARLY SWEET,Bag
VIDEXPORT,24E14000,05/31/2024,Sale,-1955.0,85.0,1,EARLY SWEET,Bag
VIDEXPORT,24E14000,06/01/2024,Sale,-85.0,0.0,2,EARLY SWEET,Bag
VIDEXPORT,24E14001,05/30/2024,Entry,2210.0,2210.0,0,EARLY SWEET,Bag
VIDEXPORT,24E14001,06/04/2024,Sale,-1955.0,255.0,5,EARLY SWEET,Bag
VIDEXPORT,24E14001,06/07/2024,Sale,-85.0,170.0,8,EARLY SWEET,Bag
VIDEXPORT,24E14001,06/07/2024,Sale,-170.0,0.0,8,EARLY SWEET,Bag
VIDEXPORT,24E14002,05/31/2024,Entry,2210.0,2210.0,0,EARLY SWEET,Bag
VIDEXPORT,24E14002,05/31/2024,Sale,-765.0,1445.0,0,EARLY SWEET,Bag
VIDEXPORT,24E14002,06/01/2024,Sale,-595.0,850.0,1,EARLY SWEET,Bag
VIDEXPORT,24E14002,06/01/2024,Sale,-850.0,0.0,1,EARLY SWEET,Bag
VIDEXPORT,24E14003,05/30/2024,Entry,2040.0,2040.0,0,EARLY SWEET,Bag
VIDEXPORT,24E14003,05/31/2024,Sale,-2040.0,0.0,1,EARLY SWEET,Bag
VIDEXPORT,24E14004,05/31/2024,Entry,1700.0,1700.0,0,EARLY SWEET,Bag
VIDEXPORT,24E14004,06/01/2024,Sale,-680.0,1020.0,1,EARLY SWEET,Bag
VIDEXPORT,24E14004,06/01/2024,Sale,-850.0,170.0,1,EARLY SWEET,Bag
VIDEXPORT,24E14004,06/03/2024,Sale,-85.0,85.0,3,EARLY SWEET,Bag
VIDEXPORT,24E14004,06/05/2024,Sale,-85.0,0.0,5,EARLY SWEET,Bag
VIDEXPORT,24E14005,05/31/2024,Entry,2160.0,2160.0,0,EARLY SWEET,Bag
VIDEXPORT,24E14005,05/31/2024,Sale,-540.0,1620.0,0,EARLY SWEET,Bag
VIDEXPORT,24E14005,05/31/2024,Sale,-810.0,810.0,0,EARLY SWEET,Bag
VIDEXPORT,24E14005,06/01/2024,Sale,-810.0,0.0,1,EARLY SWEET,Bag
VIDEXPORT,24E14006,05/31/2024,Entry,2160.0,2160.0,0,EARLY SWEET,Bag
VIDEXPORT,24E14006,05/31/2024,Sale,-810.0,1350.0,0,EARLY SWEET,Bag
VIDEXPORT,24E14006,05/31/2024,Sale,-1350.0,0.0,0,EARLY SWEET,Bag
VIDEXPORT,24E14007,05/31/2024,Entry,2160.0,2160.0,0,EARLY SWEET,Bag
VIDEXPORT,24E14007,05/31/2024,Sale,-630.0,1530.0,0,EARLY SWEET,Bag
VIDEXPORT,24E14007,05/31/2024,Sale,-1530.0,0.0,0,EARLY SWEET,Bag
VIDEXPORT,24E14008,06/01/2024,Entry,1980.0,1980.0,0,EARLY SWEET,Bag
VIDEXPORT,24E14008,06/01/2024,Sale,-1350.0,630.0,0,EARLY SWEET,Bag
VIDEXPORT,24E14008,06/01/2024,Sale,-630.0,0.0,0,EARLY SWEET,Bag
VIDEXPORT,24E14009,06/01/2024,Entry,1890.0,1890.0,0,EARLY SWEET,Bag
VIDEXPORT,24E14009,06/01/2024,Sale,-1350.0,540.0,0,EARLY SWEET,Bag
VIDEXPORT,24E14009,06/04/2024,Sale,-540.0,0.0,3,EARLY SWEET,Bag
VIDEXPORT,24E14010,06/01/2024,Entry,1620.0,1620.0,0,EARLY SWEET,Bag
VIDEXPORT,24E14010,06/06/2024,Sale,-1080.0,540.0,5,EARLY SWEET,Bag
VIDEXPORT,24E14010,06/07/2024,Sale,-450.0,90.0,6,EARLY SWEET,Bag
VIDEXPORT,24E14010,06/10/2024,Sale,-90.0,0.0,9,EARLY SWEET,Bag
VIDEXPORT,24E14011,06/01/2024,Entry,1620.0,1620.0,0,EARLY SWEET,Bag
VIDEXPORT,24E14011,06/04/2024,Sale,-180.0,1440.0,3,EARLY SWEET,Bag
VIDEXPORT,24E14011,06/07/2024,Sale,-1440.0,0.0,6,EARLY SWEET,Bag
VIDEXPORT,24E14012,06/03/2024,Entry,1440.0,1440.0,0,EARLY SWEET,Bag
VIDEXPORT,24E14012,06/03/2024,Entry,90.0,1530.0,0,EARLY SWEET,Bag
VIDEXPORT,24E14012,06/03/2024,Sale,-1530.0,0.0,0,EARLY SWEET,Bag
VIDEXPORT,24E14012,06/04/2024,Entry,810.0,810.0,1,EARLY SWEET,Bag
VIDEXPORT,24E14012,06/04/2024,Sale,-180.0,630.0,1,EARLY SWEET,Bag
VIDEXPORT,24E14012,06/05/2024,Sale,-630.0,0.0,2,EARLY SWEET,Bag
VIDEXPORT,24E14013,06/03/2024,Entry,810.0,810.0,0,EARLY SWEET,Bag
VIDEXPORT,24E14013,06/03/2024,Entry,360.0,1170.0,0,EARLY SWEET,Bag
VIDEXPORT,24E14013,06/03/2024,Entry,540.0,1710.0,0,EARLY SWEET,Bag
VIDEXPORT,24E14013,06/03/2024,Sale,-720.0,990.0,0,EARLY SWEET,Bag
VIDEXPORT,24E14013,06/03/2024,Sale,-900.0,90.0,0,EARLY SWEET,Bag
VIDEXPORT,24E14013,06/04/2024,Sale,-90.0,0.0,1,EARLY SWEET,Bag
VIDEXPORT,24E14014,06/03/2024,Entry,540.0,540.0,0,EARLY SWEET,Bag
VIDEXPORT,24E14014,06/03/2024,Entry,180.0,720.0,0,EARLY SWEET,Bag
VIDEXPORT,24E14014,06/03/2024,Entry,1440.0,2160.0,0,EARLY SWEET,Bag
VIDEXPORT,24E14014,06/03/2024,Sale,-1800.0,360.0,0,EARLY SWEET,Bag
VIDEXPORT,24E14014,06/03/2024,Sale,-180.0,180.0,0,EARLY SWEET,Bag
VIDEXPORT,24E14014,06/04/2024,Sale,-180.0,0.0,1,EARLY SWEET,Bag
VIDEXPORT,24E14015,06/01/2024,Entry,1350.0,1350.0,0,EARLY SWEET,Bag
VIDEXPORT,24E14015,06/04/2024,Sale,-270.0,1080.0,3,EARLY SWEET,Bag
VIDEXPORT,24E14015,06/07/2024,Sale,-1080.0,0.0,6,EARLY SWEET,Bag
VIDEXPORT,24E14016,06/01/2024,Entry,1800.0,1800.0,0,EARLY SWEET,Bag
VIDEXPORT,24E14016,06/01/2024,Entry,360.0,2160.0,0,EARLY SWEET,Bag
VIDEXPORT,24E14016,06/01/2024,Sale,-900.0,1260.0,0,EARLY SWEET,Bag
VIDEXPORT,24E14016,06/01/2024,Sale,-810.0,450.0,0,EARLY SWEET,Bag
VIDEXPORT,24E14016,06/01/2024,Sale,-90.0,360.0,0,EARLY SWEET,Bag
VIDEXPORT,24E14016,06/01/2024,Sale,-360.0,0.0,0,EARLY SWEET,Bag
VIDEXPORT,24E14017,06/01/2024,Entry,1800.0,1800.0,0,EARLY SWEET,Bag
VIDEXPORT,24E14017,06/01/2024,Sale,-720.0,1080.0,0,EARLY SWEET,Bag
VIDEXPORT,24E14017,06/01/2024,Sale,-990.0,90.0,0,EARLY SWEET,Bag
VIDEXPORT,24E14017,06/04/2024,Sale,-90.0,0.0,3,EARLY SWEET,Bag
VIDEXPORT,24E14018,06/03/2024,Entry,2070.0,2070.0,0,EARLY SWEET,Bag
VIDEXPORT,24E14018,06/03/2024,Sale,-1710.0,360.0,0,EARLY SWEET,Bag
VIDEXPORT,24E14018,06/03/2024,Sale,-360.0,0.0,0,EARLY SWEET,Bag
VIDEXPORT,24E14019,06/01/2024,Entry,1710.0,1710.0,0,EARLY SWEET,Bag
VIDEXPORT,24E14019,06/01/2024,Entry,270.0,1980.0,0,EARLY SWEET,Bag
VIDEXPORT,24E14019,06/04/2024,Sale,-1710.0,270.0,3,EARLY SWEET,Bag
VIDEXPORT,24E14019,06/05/2024,Sale,-270.0,0.0,4,EARLY SWEET,Bag
VIDEXPORT,24E14020,06/01/2024,Sale,-90.0,-90.0,0,EARLY SWEET,Bag
VIDEXPORT,24E14020,06/03/2024,Sale,-720.0,-810.0,2,EARLY SWEET,Bag
VIDEXPORT,24E14020,06/06/2024,Entry,1800.0,990.0,5,EARLY SWEET,Bag
VIDEXPORT,24E14020,06/07/2024,Sale,-360.0,630.0,6,EARLY SWEET,Bag
VIDEXPORT,24E14020,06/10/2024,Sale,-630.0,0.0,9,EARLY SWEET,Bag
VIDEXPORT,24E14021,06/03/2024,Entry,2520.0,2520.0,0,EARLY SWEET,Bag
VIDEXPORT,24E14021,06/03/2024,Sale,-180.0,2340.0,0,EARLY SWEET,Bag
VIDEXPORT,24E14021,06/03/2024,Sale,-1710.0,630.0,0,EARLY SWEET,Bag
VIDEXPORT,24E14021,06/03/2024,Sale,-180.0,450.0,0,EARLY SWEET,Bag
VIDEXPORT,24E14021,06/03/2024,Sale,-90.0,360.0,0,EARLY SWEET,Bag
VIDEXPORT,24E14021,06/04/2024,Sale,-360.0,0.0,1,EARLY SWEET,Bag
VIDEXPORT,24E14022,06/03/2024,Entry,2160.0,2160.0,0,EARLY SWEET,Bag
VIDEXPORT,24E14022,06/13/2024,Sale,-1710.0,450.0,10,EARLY SWEET,Bag
VIDEXPORT,24E14022,07/12/2024,Sale,-450.0,0.0,39,EARLY SWEET,Bag
VIDEXPORT,24E14023,06/03/2024,Sale,-360.0,-360.0,0,EARLY SWEET,Bag
VIDEXPORT,24E14023,06/05/2024,Entry,2520.0,2160.0,2,EARLY SWEET,Bag
VIDEXPORT,24E14023,06/06/2024,Sale,-900.0,1260.0,3,EARLY SWEET,Bag
VIDEXPORT,24E14023,06/06/2024,Sale,-1260.0,0.0,3,EARLY SWEET,Bag
VIDEXPORT,24E14024,06/03/2024,Entry,2340.0,2340.0,0,EARLY SWEET,Bag
VIDEXPORT,24E14024,06/03/2024,Sale,-1620.0,720.0,0,EARLY SWEET,Bag
VIDEXPORT,24E14024,06/03/2024,Sale,-540.0,180.0,0,EARLY SWEET,Bag
VIDEXPORT,24E14024,06/03/2024,Sale,-180.0,0.0,0,EARLY SWEET,Bag
VIDEXPORT,24E14025,06/03/2024,Entry,2160.0,2160.0,0,EARLY SWEET,Bag
VIDEXPORT,24E14025,06/03/2024,Sale,-270.0,1890.0,0,EARLY SWEET,Bag
VIDEXPORT,24E14025,06/03/2024,Sale,-1170.0,720.0,0,EARLY SWEET,Bag
VIDEXPORT,24E14025,06/03/2024,Sale,-720.0,0.0,0,EARLY SWEET,Bag
VIDEXPORT,24E14026,06/03/2024,Entry,2160.0,2160.0,0,EARLY SWEET,Bag
VIDEXPORT,24E14026,06/12/2024,Sale,-1980.0,180.0,9,EARLY SWEET,Bag
VIDEXPORT,24E14026,06/13/2024,Sale,-180.0,0.0,10,EARLY SWEET,Bag
VIDEXPORT,24E14027,06/03/2024,Sale,-180.0,-180.0,0,EARLY SWEET,Bag
VIDEXPORT,24E14027,06/04/2024,Entry,2340.0,2160.0,1,EARLY SWEET,Bag
VIDEXPORT,24E14027,06/05/2024,Sale,-630.0,1530.0,2,EARLY SWEET,Bag
VIDEXPORT,24E14027,06/06/2024,Sale,-1530.0,0.0,3,EARLY SWEET,Bag
VIDEXPORT,24E14028,06/04/2024,Entry,1800.0,1800.0,0,EARLY SWEET,Bag
VIDEXPORT,24E14028,06/05/2024,Sale,-180.0,1620.0,1,EARLY SWEET,Bag
VIDEXPORT,24E14028,06/06/2024,Sale,-1620.0,0.0,2,EARLY SWEET,Bag
VIDEXPORT,24E14029,06/05/2024,Entry,2160.0,2160.0,0,EARLY SWEET,Bag
VIDEXPORT,24E14029,06/05/2024,Sale,-1260.0,900.0,0,EARLY SWEET,Bag
VIDEXPORT,24E14029,06/06/2024,Sale,-630.0,270.0,1,EARLY SWEET,Bag
VIDEXPORT,24E14029,06/06/2024,Sale,-270.0,0.0,1,EARLY SWEET,Bag
VIDEXPORT,24E14030,06/04/2024,Sale,-360.0,-360.0,0,EARLY SWEET,Bag
VIDEXPORT,24E14030,06/05/2024,Sale,-360.0,-720.0,1,EARLY SWEET,Bag
VIDEXPORT,24E14030,06/06/2024,Entry,720.0,0.0,2,EARLY SWEET,Bag
VIDEXPORT,24E14030,06/06/2024,Entry,1170.0,1170.0,2,SUGAR DROP,Bag
VIDEXPORT,24E14030,06/09/2024,Sale,-1170.0,0.0,5,SUGAR DROP,Bag
VIDEXPORT,24E14031,06/03/2024,Entry,1980.0,1980.0,0,EARLY SWEET,Bag
VIDEXPORT,24E14031,06/04/2024,Sale,-1980.0,0.0,1,EARLY SWEET,Bag
VIDEXPORT,24E14032,06/04/2024,Entry,2160.0,2160.0,0,EARLY SWEET,Bag
VIDEXPORT,24E14032,06/04/2024,Sale,-1350.0,810.0,0,EARLY SWEET,Bag
VIDEXPORT,24E14032,06/05/2024,Sale,-810.0,0.0,1,EARLY SWEET,Bag
VIDEXPORT,24E14033,06/07/2024,Entry,1800.0,1800.0,0,SUGAR DROP,Bag
VIDEXPORT,24E14033,06/07/2024,Sale,-270.0,1530.0,0,SUGAR DROP,Bag
VIDEXPORT,24E14033,06/07/2024,Sale,-990.0,540.0,0,SUGAR DROP,Bag
VIDEXPORT,24E14033,06/08/2024,Sale,-360.0,180.0,1,SUGAR DROP,Bag
VIDEXPORT,24E14034,06/03/2024,Sale,-180.0,-180.0,0,EARLY SWEET,Bag
VIDEXPORT,24E14034,06/04/2024,Entry,2340.0,2160.0,1,EARLY SWEET,Bag
VIDEXPORT,24E14034,06/05/2024,Sale,-1800.0,360.0,2,EARLY SWEET,Bag
VIDEXPORT,24E14034,06/07/2024,Sale,-360.0,0.0,4,EARLY SWEET,Bag
VIDEXPORT,24E14035,06/04/2024,Entry,1800.0,1800.0,0,EARLY SWEET,Bag
VIDEXPORT,24E14035,06/05/2024,Sale,-1800.0,0.0,1,EARLY SWEET,Bag
VIDEXPORT,24E14036,06/05/2024,Entry,1800.0,1800.0,0,EARLY SWEET,Bag
VIDEXPORT,24E14036,06/06/2024,Sale,-180.0,1620.0,1,EARLY SWEET,Bag
VIDEXPORT,24E14036,06/07/2024,Sale,-1620.0,0.0,2,EARLY SWEET,Bag
VIDEXPORT,24E14038,06/04/2024,Entry,1980.0,1980.0,0,EARLY SWEET,Bag
VIDEXPORT,24E14038,06/05/2024,Sale,-1620.0,360.0,1,EARLY SWEET,Bag
VIDEXPORT,24E14038,06/05/2024,Sale,-90.0,270.0,1,EARLY SWEET,Bag
VIDEXPORT,24E14038,06/07/2024,Sale,-270.0,0.0,3,EARLY SWEET,Bag
VIDEXPORT,24E14040,06/05/2024,Entry,1710.0,1710.0,0,EARLY SWEET,Bag
VIDEXPORT,24E14040,06/05/2024,Sale,-1710.0,0.0,0,EARLY SWEET,Bag
VIDEXPORT,24E14041,06/04/2024,Sale,-90.0,-90.0,0,EARLY SWEET,Bag
VIDEXPORT,24E14041,06/05/2024,Entry,2340.0,2250.0,1,EARLY SWEET,Bag
VIDEXPORT,24E14041,06/05/2024,Sale,-1350.0,900.0,1,EARLY SWEET,Bag
VIDEXPORT,24E14041,06/06/2024,Sale,-180.0,720.0,2,EARLY SWEET,Bag
VIDEXPORT,24E14041,06/06/2024,Sale,-360.0,360.0,2,EARLY SWEET,Bag
VIDEXPORT,24E14041,06/08/2024,Sale,-90.0,270.0,4,EARLY SWEET,Bag
VIDEXPORT,24E14041,06/08/2024,Sale,-270.0,0.0,4,EARLY SWEET,Bag
VIDEXPORT,24E14043,06/05/2024,Entry,2160.0,2160.0,0,EARLY SWEET,Bag
VIDEXPORT,24E14043,06/06/2024,Sale,-450.0,1710.0,1,EARLY SWEET,Bag
VIDEXPORT,24E14043,06/06/2024,Sale,-450.0,1260.0,1,EARLY SWEET,Bag
VIDEXPORT,24E14043,06/07/2024,Sale,-810.0,450.0,2,EARLY SWEET,Bag
VIDEXPORT,24E14043,06/08/2024,Sale,-450.0,0.0,3,EARLY SWEET,Bag
VIDEXPORT,24E14044,06/05/2024,Entry,2160.0,2160.0,0,EARLY SWEET,Bag
VIDEXPORT,24E14044,06/05/2024,Entry,180.0,2340.0,0,EARLY SWEET,Bag
VIDEXPORT,24E14044,06/06/2024,Sale,-1980.0,360.0,1,EARLY SWEET,Bag
VIDEXPORT,24E14044,06/07/2024,Sale,-180.0,180.0,2,EARLY SWEET,Bag
VIDEXPORT,24E14044,06/10/2024,Sale,-90.0,90.0,5,EARLY SWEET,Bag
VIDEXPORT,24E14044,06/13/2024,Sale,-90.0,0.0,8,EARLY SWEET,Bag
VIDEXPORT,24E14045,06/05/2024,Entry,1710.0,1710.0,0,EARLY SWEET,Bag
VIDEXPORT,24E14045,06/06/2024,Sale,-180.0,1530.0,1,EARLY SWEET,Bag
VIDEXPORT,24E14045,06/06/2024,Sale,-360.0,1170.0,1,EARLY SWEET,Bag
VIDEXPORT,24E14045,06/06/2024,Sale,-900.0,270.0,1,EARLY SWEET,Bag
VIDEXPORT,24E14045,06/08/2024,Sale,-270.0,0.0,3,EARLY SWEET,Bag
VIDEXPORT,24E14047,06/05/2024,Entry,1530.0,1530.0,0,EARLY SWEET,Bag
VIDEXPORT,24E14047,06/05/2024,Entry,360.0,1890.0,0,EARLY SWEET,Bag
VIDEXPORT,24E14047,06/07/2024,Sale,-1170.0,720.0,2,EARLY SWEET,Bag
VIDEXPORT,24E14047,06/07/2024,Sale,-360.0,360.0,2,EARLY SWEET,Bag
VIDEXPORT,24E14047,06/07/2024,Sale,-180.0,180.0,2,EARLY SWEET,Bag
VIDEXPORT,24E14047,06/07/2024,Sale,-90.0,90.0,2,EARLY SWEET,Bag
VIDEXPORT,24E14047,06/07/2024,Sale,-90.0,0.0,2,EARLY SWEET,Bag
VIDEXPORT,24E14049,06/06/2024,Entry,2340.0,2340.0,0,EARLY SWEET,Bag
VIDEXPORT,24E14049,06/08/2024,Sale,-270.0,2070.0,2,EARLY SWEET,Bag
VIDEXPORT,24E14049,06/08/2024,Sale,-1890.0,180.0,2,EARLY SWEET,Bag
VIDEXPORT,24E14049,06/08/2024,Sale,-180.0,0.0,2,EARLY SWEET,Bag
VIDEXPORT,24E14050,06/06/2024,Entry,2160.0,2160.0,0,EARLY SWEET,Bag
VIDEXPORT,24E14050,06/08/2024,Sale,-810.0,1350.0,2,EARLY SWEET,Bag
VIDEXPORT,24E14050,06/08/2024,Sale,-900.0,450.0,2,EARLY SWEET,Bag
VIDEXPORT,24E14050,06/08/2024,Sale,-450.0,0.0,2,EARLY SWEET,Bag
VIDEXPORT,24E14052,06/06/2024,Entry,1620.0,1620.0,0,EARLY SWEET,Bag
VIDEXPORT,24E14052,06/08/2024,Sale,-810.0,810.0,2,EARLY SWEET,Bag
VIDEXPORT,24E14052,06/10/2024,Sale,-810.0,0.0,4,EARLY SWEET,Bag
VIDEXPORT,24E14053,06/06/2024,Entry,2160.0,2160.0,0,EARLY SWEET,Bag
VIDEXPORT,24E14053,06/07/2024,Sale,-1980.0,180.0,1,EARLY SWEET,Bag
VIDEXPORT,24E14053,06/07/2024,Sale,-180.0,0.0,1,EARLY SWEET,Bag
VIDEXPORT,24E14055,06/05/2024,Sale,-90.0,-90.0,0,EARLY SWEET,Bag
VIDEXPORT,24E14055,06/06/2024,Entry,1800.0,1710.0,1,EARLY SWEET,Bag
VIDEXPORT,24E14055,06/07/2024,Sale,-180.0,1530.0,2,EARLY SWEET,Bag
VIDEXPORT,24E14055,06/08/2024,Sale,-90.0,1440.0,3,EARLY SWEET,Bag
VIDEXPORT,24E14055,06/08/2024,Sale,-1260.0,180.0,3,EARLY SWEET,Bag
VIDEXPORT,24E14055,06/08/2024,Sale,-180.0,0.0,3,EARLY SWEET,Bag
VIDEXPORT,24E14056,06/04/2024,Sale,-450.0,-450.0,0,EARLY SWEET,Bag
VIDEXPORT,24E14056,06/04/2024,Sale,-270.0,-720.0,0,EARLY SWEET,Bag
VIDEXPORT,24E14056,06/07/2024,Entry,2340.0,1620.0,3,EARLY SWEET,Bag
VIDEXPORT,24E14056,06/08/2024,Sale,-90.0,1530.0,4,EARLY SWEET,Bag
VIDEXPORT,24E14056,06/10/2024,Sale,-1170.0,360.0,6,EARLY SWEET,Bag
VIDEXPORT,24E14056,06/10/2024,Sale,-360.0,0.0,6,EARLY SWEET,Bag
VIDEXPORT,24E14057,06/07/2024,Entry,2340.0,2340.0,0,EARLY SWEET,Bag
VIDEXPORT,24E14057,06/08/2024,Sale,-90.0,2250.0,1,EARLY SWEET,Bag
VIDEXPORT,24E14057,06/12/2024,Sale,-90.0,2160.0,5,EARLY SWEET,Bag
VIDEXPORT,24E14058,06/04/2024,Sale,-90.0,-90.0,0,EARLY SWEET,Bag
VIDEXPORT,24E14058,06/07/2024,Entry,2340.0,2250.0,3,EARLY SWEET,Bag
VIDEXPORT,24E14058,06/08/2024,Sale,-270.0,1980.0,4,EARLY SWEET,Bag
VIDEXPORT,24E14058,06/10/2024,Sale,-720.0,1260.0,6,EARLY SWEET,Bag
VIDEXPORT,24E14058,06/10/2024,Sale,-1170.0,90.0,6,EARLY SWEET,Bag
VIDEXPORT,24E14058,06/11/2024,Sale,-90.0,0.0,7,EARLY SWEET,Bag
VIDEXPORT,24E14059,06/07/2024,Entry,2340.0,2340.0,0,EARLY SWEET,Bag
VIDEXPORT,24E14059,06/08/2024,Sale,-1980.0,360.0,1,EARLY SWEET,Bag
VIDEXPORT,24E14059,06/10/2024,Sale,-360.0,0.0,3,EARLY SWEET,Bag
VIDEXPORT,24E14060,06/07/2024,Entry,1980.0,1980.0,0,EARLY SWEET,Bag
VIDEXPORT,24E14060,06/08/2024,Sale,-450.0,1530.0,1,EARLY SWEET,Bag
VIDEXPORT,24E14060,06/10/2024,Sale,-810.0,720.0,3,EARLY SWEET,Bag
VIDEXPORT,24E14060,06/10/2024,Sale,-720.0,0.0,3,EARLY SWEET,Bag
VIDEXPORT,24E14061,06/07/2024,Entry,1170.0,1170.0,0,EARLY SWEET,Bag
VIDEXPORT,24E14061,06/07/2024,Entry,810.0,1980.0,0,EARLY SWEET,Bag
VIDEXPORT,24E14061,06/07/2024,Sale,-810.0,1170.0,0,EARLY SWEET,Bag
VIDEXPORT,24E14061,06/07/2024,Sale,-450.0,720.0,0,EARLY SWEET,Bag
VIDEXPORT,24E14061,06/08/2024,Sale,-180.0,540.0,1,EARLY SWEET,Bag
VIDEXPORT,24E14061,06/08/2024,Sale,-90.0,450.0,1,EARLY SWEET,Bag
VIDEXPORT,24E14061,06/10/2024,Sale,-270.0,180.0,3,EARLY SWEET,Bag
VIDEXPORT,24E14061,06/10/2024,Sale,-90.0,90.0,3,EARLY SWEET,Bag
VIDEXPORT,24E14061,06/13/2024,Sale,-90.0,0.0,6,EARLY SWEET,Bag
VIDEXPORT,24E14062,06/07/2024,Entry,2520.0,2520.0,0,EARLY SWEET,Bag
VIDEXPORT,24E14062,06/08/2024,Sale,-180.0,2340.0,1,EARLY SWEET,Bag
VIDEXPORT,24E14062,06/10/2024,Sale,-360.0,1980.0,3,EARLY SWEET,Bag
VIDEXPORT,24E14062,06/10/2024,Sale,-1980.0,0.0,3,EARLY SWEET,Bag
VIDEXPORT,24E14063,06/10/2024,Entry,2340.0,2340.0,0,EARLY SWEET,Bag
VIDEXPORT,24E14063,06/10/2024,Sale,-180.0,2160.0,0,EARLY SWEET,Bag
VIDEXPORT,24E14063,06/10/2024,Sale,-990.0,1170.0,0,EARLY SWEET,Bag
VIDEXPORT,24E14063,06/10/2024,Sale,-1080.0,90.0,0,EARLY SWEET,Bag
VIDEXPORT,24E14063,06/11/2024,Sale,-90.0,0.0,1,EARLY SWEET,Bag
VIDEXPORT,24E14064,06/09/2024,Sale,-540.0,-540.0,0,SUGAR DROP,Bag
VIDEXPORT,24E14064,06/10/2024,Entry,1800.0,1260.0,1,SUGAR DROP,Bag
VIDEXPORT,24E14064,06/13/2024,Sale,-630.0,630.0,4,SUGAR DROP,Bag
VIDEXPORT,24E14064,06/13/2024,Sale,-630.0,0.0,4,SUGAR DROP,Bag
VIDEXPORT,24E14065,06/08/2024,Entry,2430.0,2430.0,0,SUGAR DROP,Bag
VIDEXPORT,24E14065,06/08/2024,Sale,-900.0,1530.0,0,SUGAR DROP,Bag
VIDEXPORT,24E14065,06/08/2024,Sale,-360.0,1170.0,0,SUGAR DROP,Bag
VIDEXPORT,24E14065,06/08/2024,Sale,-720.0,450.0,0,SUGAR DROP,Bag
VIDEXPORT,24E14065,06/13/2024,Sale,-450.0,0.0,5,SUGAR DROP,Bag
VIDEXPORT,24E14066,06/08/2024,Entry,1530.0,1530.0,0,EARLY SWEET,Bag
VIDEXPORT,24E14066,06/10/2024,Sale,-1350.0,180.0,2,EARLY SWEET,Bag
VIDEXPORT,24E14066,06/10/2024,Sale,-180.0,0.0,2,EARLY SWEET,Bag
VIDEXPORT,24E14067,06/09/2024,Sale,-270.0,-270.0,0,SUGAR DROP,Bag
VIDEXPORT,24E14067,06/09/2024,Sale,-1440.0,-1710.0,0,SUGAR DROP,Bag
VIDEXPORT,24E14067,06/10/2024,Entry,1800.0,90.0,1,SUGAR DROP,Bag
VIDEXPORT,24E14067,06/13/2024,Sale,-90.0,0.0,4,SUGAR DROP,Bag
VIDEXPORT,24E14068,06/08/2024,Entry,1710.0,1710.0,0,EARLY SWEET,Bag
VIDEXPORT,24E14068,06/08/2024,Sale,-270.0,1440.0,0,EARLY SWEET,Bag
VIDEXPORT,24E14068,06/10/2024,Sale,-990.0,450.0,2,EARLY SWEET,Bag
VIDEXPORT,24E14068,06/10/2024,Sale,-450.0,0.0,2,EARLY SWEET,Bag
VIDEXPORT,24E14069,06/10/2024,Entry,1620.0,1620.0,0,EARLY SWEET,Bag
VIDEXPORT,24E14069,06/10/2024,Sale,-1440.0,180.0,0,EARLY SWEET,Bag
VIDEXPORT,24E14069,06/10/2024,Sale,-180.0,0.0,0,EARLY SWEET,Bag
VIDEXPORT,24E14070,06/10/2024,Entry,1530.0,1530.0,0,SUGAR DROP,Bag
VIDEXPORT,24E14070,06/13/2024,Sale,-1521.0,9.0,3,SUGAR DROP,Bag
VIDEXPORT,24E14071,06/08/2024,Entry,1440.0,1440.0,0,EARLY SWEET,Bag
VIDEXPORT,24E14071,06/08/2024,Sale,-180.0,1260.0,0,EARLY SWEET,Bag
VIDEXPORT,24E14071,06/10/2024,Sale,-1260.0,0.0,2,EARLY SWEET,Bag
VIDEXPORT,24E14072,06/10/2024,Entry,2340.0,2340.0,0,SUGAR DROP,Bag
VIDEXPORT,24E14072,06/10/2024,Sale,-990.0,1350.0,0,SUGAR DROP,Bag
VIDEXPORT,24E14072,06/17/2024,Sale,-720.0,630.0,7,SUGAR DROP,Bag
VIDEXPORT,24E14072,06/18/2024,Sale,-630.0,0.0,8,SUGAR DROP,Bag
VIDEXPORT,24E14073,06/10/2024,Entry,2340.0,2340.0,0,SUGAR DROP,Bag
VIDEXPORT,24E14073,06/11/2024,Sale,-2250.0,90.0,1,SUGAR DROP,Bag
VIDEXPORT,24E14073,06/12/2024,Sale,-90.0,0.0,2,SUGAR DROP,Bag
VIDEXPORT,24E14074,06/09/2024,Entry,90.0,90.0,0,EARLY SWEET,Bag
VIDEXPORT,24E14074,06/09/2024,Entry,2250.0,2340.0,0,SUGAR DROP,Bag
VIDEXPORT,24E14074,06/10/2024,Sale,-1350.0,990.0,1,SUGAR DROP,Bag
VIDEXPORT,24E14074,06/12/2024,Sale,-900.0,90.0,3,SUGAR DROP,Bag
VIDEXPORT,24E14075,06/09/2024,Entry,1800.0,1800.0,0,EARLY SWEET,Bag
VIDEXPORT,24E14075,06/10/2024,Sale,-1620.0,180.0,1,EARLY SWEET,Bag
VIDEXPORT,24E14075,06/11/2024,Sale,-180.0,0.0,2,EARLY SWEET,Bag
VIDEXPORT,24E14076,06/09/2024,Entry,2340.0,2340.0,0,SUGAR DROP,Bag
VIDEXPORT,24E14076,06/10/2024,Sale,-630.0,1710.0,1,SUGAR DROP,Bag
VIDEXPORT,24E14076,06/10/2024,Sale,-1710.0,0.0,1,SUGAR DROP,Bag
VIDEXPORT,24E14077,06/10/2024,Entry,2340.0,2340.0,0,SUGAR DROP,Bag
VIDEXPORT,24E14077,06/11/2024,Sale,-2340.0,0.0,1,SUGAR DROP,Bag
VIDEXPORT,24E14078,06/09/2024,Entry,90.0,90.0,0,SUGAR DROP,Bag
VIDEXPORT,24E14078,06/09/2024,Entry,2250.0,2340.0,0,SUGAR DROP,Bag
VIDEXPORT,24E14078,06/10/2024,Sale,-90.0,2250.0,1,SUGAR DROP,Bag
VIDEXPORT,24E14078,06/10/2024,Sale,-1980.0,270.0,1,SUGAR DROP,Bag
VIDEXPORT,24E14078,06/10/2024,Sale,-270.0,0.0,1,SUGAR DROP,Bag
VIDEXPORT,24E14079,06/10/2024,Entry,2430.0,2430.0,0,SUGAR DROP,Bag
VIDEXPORT,24E14079,06/12/2024,Sale,-540.0,1890.0,2,SUGAR DROP,Bag
VIDEXPORT,24E14079,06/12/2024,Sale,-1890.0,0.0,2,SUGAR DROP,Bag
VIDEXPORT,24E14080,06/09/2024,Entry,2070.0,2070.0,0,SUGAR DROP,Bag
VIDEXPORT,24E14080,06/14/2024,Sale,-270.0,1800.0,5,SUGAR DROP,Bag
VIDEXPORT,24E14080,06/14/2024,Sale,-1350.0,450.0,5,SUGAR DROP,Bag
VIDEXPORT,24E14080,07/12/2024,Sale,-450.0,0.0,33,SUGAR DROP,Bag
VIDEXPORT,24E14081,06/09/2024,Entry,2160.0,2160.0,0,SUGAR DROP,Bag
VIDEXPORT,24E14081,06/10/2024,Sale,-1260.0,900.0,1,SUGAR DROP,Bag
VIDEXPORT,24E14081,06/13/2024,Sale,-270.0,630.0,4,SUGAR DROP,Bag
VIDEXPORT,24E14081,06/14/2024,Sale,-630.0,0.0,5,SUGAR DROP,Bag
VIDEXPORT,24E14082,06/10/2024,Entry,2160.0,2160.0,0,SUGAR DROP,Bag
VIDEXPORT,24E14082,06/13/2024,Sale,-1980.0,180.0,3,SUGAR DROP,Bag
VIDEXPORT,24E14082,06/20/2024,Sale,-90.0,90.0,10,SUGAR DROP,Bag
VIDEXPORT,24E14082,07/12/2024,Sale,-90.0,0.0,32,SUGAR DROP,Bag
VIDEXPORT,24E14083,06/09/2024,Entry,2380.0,2380.0,0,EARLY SWEET,Bag
VIDEXPORT,24E14083,06/10/2024,Sale,-425.0,1955.0,1,EARLY SWEET,Bag
VIDEXPORT,24E14083,06/10/2024,Sale,-1955.0,0.0,1,EARLY SWEET,Bag
VIDEXPORT,24E14084,06/09/2024,Entry,1620.0,1620.0,0,EARLY SWEET,Bag
VIDEXPORT,24E14084,06/11/2024,Sale,-180.0,1440.0,2,EARLY SWEET,Bag
VIDEXPORT,24E14084,06/12/2024,Sale,-1500.0,-60.0,3,EARLY SWEET,Clam
VIDEXPORT,24E14084,06/14/2024,Sale,-45.0,-105.0,5,EARLY SWEET,Clam
VIDEXPORT,24E14084,06/15/2024,Sale,-225.0,-330.0,6,EARLY SWEET,Clam
VIDEXPORT,24E14084,06/18/2024,Sale,-90.0,-420.0,9,EARLY SWEET,Bag
VIDEXPORT,24E14085,06/10/2024,Entry,2380.0,2380.0,0,EARLY SWEET,Bag
VIDEXPORT,24E14085,06/12/2024,Sale,-425.0,1955.0,2,EARLY SWEET,Bag
VIDEXPORT,24E14085,06/18/2024,Sale,-425.0,1530.0,8,EARLY SWEET,Bag
VIDEXPORT,24E14085,06/21/2024,Sale,-510.0,1020.0,11,EARLY SWEET,Bag
VIDEXPORT,24E14085,06/21/2024,Sale,-85.0,935.0,11,EARLY SWEET,Bag
VIDEXPORT,24E14085,06/22/2024,Sale,-340.0,595.0,12,EARLY SWEET,Bag
VIDEXPORT,24E14085,07/12/2024,Sale,-595.0,0.0,32,EARLY SWEET,Bag
VIDEXPORT,24E14086,06/10/2024,Entry,2160.0,2160.0,0,SUGAR DROP,Bag
VIDEXPORT,24E14086,06/12/2024,Sale,-2160.0,0.0,2,SUGAR DROP,Bag
VIDEXPORT,24E14087,06/10/2024,Entry,2160.0,2160.0,0,SUGAR DROP,Bag
VIDEXPORT,24E14087,06/10/2024,Sale,-360.0,1800.0,0,SUGAR DROP,Bag
VIDEXPORT,24E14087,06/10/2024,Sale,-900.0,900.0,0,SUGAR DROP,Bag
VIDEXPORT,24E14087,06/10/2024,Sale,-900.0,0.0,0,SUGAR DROP,Bag
VIDEXPORT,24E14088,06/10/2024,Entry,2340.0,2340.0,0,SUGAR DROP,Bag
VIDEXPORT,24E14088,06/11/2024,Sale,-360.0,1980.0,1,SUGAR DROP,Bag
VIDEXPORT,24E14088,06/11/2024,Sale,-1980.0,0.0,1,SUGAR DROP,Bag
VIDEXPORT,24E14089,06/10/2024,Entry,2160.0,2160.0,0,SUGAR DROP,Bag
VIDEXPORT,24E14089,06/10/2024,Sale,-720.0,1440.0,0,SUGAR DROP,Bag
VIDEXPORT,24E14089,06/11/2024,Sale,-1440.0,0.0,1,SUGAR DROP,Bag
VIDEXPORT,24E14090,06/11/2024,Entry,2340.0,2340.0,0,SUGAR DROP,Bag
VIDEXPORT,24E14090,06/12/2024,Sale,-1980.0,360.0,1,SUGAR DROP,Bag
VIDEXPORT,24E14090,06/13/2024,Sale,-360.0,0.0,2,SUGAR DROP,Bag
VIDEXPORT,24E14091,06/10/2024,Entry,2340.0,2340.0,0,EARLY SWEET,Bag
VIDEXPORT,24E14091,06/11/2024,Sale,-810.0,1530.0,1,EARLY SWEET,Bag
VIDEXPORT,24E14091,06/11/2024,Sale,-1170.0,360.0,1,EARLY SWEET,Bag
VIDEXPORT,24E14091,06/11/2024,Sale,-180.0,180.0,1,EARLY SWEET,Bag
VIDEXPORT,24E14091,06/12/2024,Sale,-90.0,90.0,2,EARLY SWEET,Bag
VIDEXPORT,24E14091,06/13/2024,Sale,-90.0,0.0,3,EARLY SWEET,Bag
VIDEXPORT,24E14092,06/11/2024,Entry,2160.0,2160.0,0,SUGAR DROP,Bag
VIDEXPORT,24E14092,06/11/2024,Sale,-1980.0,180.0,0,SUGAR DROP,Bag
VIDEXPORT,24E14092,06/12/2024,Sale,-90.0,90.0,1,SUGAR DROP,Bag
VIDEXPORT,24E14092,06/13/2024,Sale,-90.0,0.0,2,SUGAR DROP,Bag
VIDEXPORT,24E14093,06/11/2024,Entry,1980.0,1980.0,0,SUGAR DROP,Bag
VIDEXPORT,24E14093,06/13/2024,Sale,-1800.0,180.0,2,SUGAR DROP,Bag
VIDEXPORT,24E14093,06/19/2024,Sale,-90.0,90.0,8,SUGAR DROP,Bag
VIDEXPORT,24E14093,06/24/2024,Sale,-90.0,0.0,13,SUGAR DROP,Bag
VIDEXPORT,24E14094,06/10/2024,Entry,2160.0,2160.0,0,SUGAR DROP,Bag
VIDEXPORT,24E14094,06/12/2024,Sale,-1980.0,180.0,2,SUGAR DROP,Bag
VIDEXPORT,24E14094,06/12/2024,Sale,-180.0,0.0,2,SUGAR DROP,Bag
VIDEXPORT,24E14095,06/10/2024,Entry,1890.0,1890.0,0,SUGAR DROP,Bag
VIDEXPORT,24E14095,06/12/2024,Sale,-540.0,1350.0,2,SUGAR DROP,Bag
VIDEXPORT,24E14095,06/13/2024,Sale,-1350.0,0.0,3,SUGAR DROP,Bag
VIDEXPORT,24E14096,06/10/2024,Entry,2100.0,2100.0,0,SUGAR DROP,Bag
VIDEXPORT,24E14096,06/14/2024,Sale,-600.0,1500.0,4,SUGAR DROP,Bag
VIDEXPORT,24E14096,06/14/2024,Sale,-150.0,1350.0,4,SUGAR DROP,Bag
VIDEXPORT,24E14096,06/17/2024,Sale,-1350.0,0.0,7,SUGAR DROP,Bag
VIDEXPORT,24E14097,06/10/2024,Entry,1980.0,1980.0,0,EARLY SWEET,Bag
VIDEXPORT,24E14097,06/11/2024,Sale,-720.0,1260.0,1,EARLY SWEET,Bag
VIDEXPORT,24E14097,06/11/2024,Sale,-1170.0,90.0,1,EARLY SWEET,Bag
VIDEXPORT,24E14097,06/12/2024,Sale,-90.0,0.0,2,EARLY SWEET,Bag
VIDEXPORT,24E14098,06/10/2024,Entry,2520.0,2520.0,0,EARLY SWEET,Bag
VIDEXPORT,24E14098,06/10/2024,Sale,-1350.0,1170.0,0,EARLY SWEET,Bag
VIDEXPORT,24E14098,06/10/2024,Sale,-990.0,180.0,0,EARLY SWEET,Bag
VIDEXPORT,24E14098,06/11/2024,Sale,-180.0,0.0,1,EARLY SWEET,Bag
VIDEXPORT,24E14099,06/10/2024,Entry,2160.0,2160.0,0,SUGAR DROP,Bag
VIDEXPORT,24E14099,06/14/2024,Sale,-180.0,1980.0,4,SUGAR DROP,Bag
VIDEXPORT,24E14099,06/14/2024,Sale,-1980.0,0.0,4,SUGAR DROP,Bag
VIDEXPORT,24E14100,06/10/2024,Entry,2160.0,2160.0,0,SUGAR DROP,Bag
VIDEXPORT,24E14100,06/11/2024,Sale,-1440.0,720.0,1,SUGAR DROP,Bag
VIDEXPORT,24E14100,06/13/2024,Sale,-90.0,630.0,3,SUGAR DROP,Bag
VIDEXPORT,24E14100,06/13/2024,Sale,-90.0,540.0,3,SUGAR DROP,Bag
VIDEXPORT,24E14100,06/13/2024,Sale,-180.0,360.0,3,SUGAR DROP,Bag
VIDEXPORT,24E14100,06/14/2024,Sale,-90.0,270.0,4,SUGAR DROP,Bag
VIDEXPORT,24E14100,06/15/2024,Sale,-180.0,90.0,5,SUGAR DROP,Bag
VIDEXPORT,24E14100,06/18/2024,Sale,-90.0,0.0,8,SUGAR DROP,Bag
VIDEXPORT,24E14101,06/11/2024,Entry,2520.0,2520.0,0,EARLY SWEET,Bag
VIDEXPORT,24E14101,06/11/2024,Sale,-1710.0,810.0,0,EARLY SWEET,Bag
VIDEXPORT,24E14101,06/11/2024,Sale,-450.0,360.0,0,EARLY SWEET,Clam
VIDEXPORT,24E14101,06/12/2024,Sale,-180.0,180.0,1,EARLY SWEET,Bag
VIDEXPORT,24E14101,06/14/2024,Sale,-90.0,90.0,3,EARLY SWEET,Bag
VIDEXPORT,24E14102,06/10/2024,Entry,1700.0,1700.0,0,EARLY SWEET,Bag
VIDEXPORT,24E14102,06/12/2024,Sale,-85.0,1615.0,2,EARLY SWEET,Bag
VIDEXPORT,24E14102,06/13/2024,Sale,-255.0,1360.0,3,EARLY SWEET,Bag
VIDEXPORT,24E14102,06/14/2024,Sale,-595.0,765.0,4,EARLY SWEET,Bag
VIDEXPORT,24E14102,06/14/2024,Sale,-170.0,595.0,4,EARLY SWEET,Bag
VIDEXPORT,24E14102,06/14/2024,Sale,-425.0,170.0,4,EARLY SWEET,Bag
VIDEXPORT,24E14102,06/22/2024,Sale,-170.0,0.0,12,EARLY SWEET,Bag
VIDEXPORT,24E14103,06/10/2024,Entry,2160.0,2160.0,0,EARLY SWEET,Bag
VIDEXPORT,24E14103,06/11/2024,Sale,-270.0,1890.0,1,EARLY SWEET,Bag
VIDEXPORT,24E14103,06/11/2024,Sale,-810.0,1080.0,1,EARLY SWEET,Bag
VIDEXPORT,24E14103,06/11/2024,Sale,-1080.0,0.0,1,EARLY SWEET,Bag
VIDEXPORT,24E14104,06/11/2024,Entry,2160.0,2160.0,0,SUGAR DROP,Bag
VIDEXPORT,24E14104,06/13/2024,Sale,-1980.0,180.0,2,SUGAR DROP,Bag
VIDEXPORT,24E14104,06/13/2024,Sale,-180.0,0.0,2,SUGAR DROP,Bag
VIDEXPORT,24E14105,06/10/2024,Entry,1445.0,1445.0,0,EARLY SWEET,Bag
VIDEXPORT,24E14105,06/12/2024,Sale,-935.0,510.0,2,EARLY SWEET,Bag
VIDEXPORT,24E14105,06/13/2024,Sale,-510.0,0.0,3,EARLY SWEET,Bag
VIDEXPORT,24E14106,06/10/2024,Entry,2160.0,2160.0,0,SUGAR DROP,Bag
VIDEXPORT,24E14106,06/11/2024,Sale,-1170.0,990.0,1,SUGAR DROP,Bag
VIDEXPORT,24E14106,06/11/2024,Sale,-720.0,270.0,1,SUGAR DROP,Bag
VIDEXPORT,24E14106,06/11/2024,Sale,-270.0,0.0,1,SUGAR DROP,Bag
VIDEXPORT,24E14107,06/11/2024,Entry,1800.0,1800.0,0,SUGAR DROP,Bag
VIDEXPORT,24E14107,06/11/2024,Entry,540.0,2340.0,0,SUGAR DROP,Bag
VIDEXPORT,24E14107,06/11/2024,Sale,-270.0,2070.0,0,SUGAR DROP,Bag
VIDEXPORT,24E14107,06/11/2024,Sale,-270.0,1800.0,0,SUGAR DROP,Bag
VIDEXPORT,24E14107,06/15/2024,Sale,-810.0,990.0,4,SUGAR DROP,Bag
VIDEXPORT,24E14107,06/18/2024,Sale,-180.0,810.0,7,SUGAR DROP,Bag
VIDEXPORT,24E14107,06/19/2024,Sale,-720.0,90.0,8,SUGAR DROP,Bag
VIDEXPORT,24E14107,06/24/2024,Sale,-90.0,0.0,13,SUGAR DROP,Bag
VIDEXPORT,24E14108,06/11/2024,Entry,1080.0,1080.0,0,SUGAR DROP,Bag
VIDEXPORT,24E14108,06/11/2024,Entry,600.0,1680.0,0,SUGAR DROP,Bag
VIDEXPORT,24E14108,06/14/2024,Sale,-90.0,1590.0,3,SUGAR DROP,Bag
VIDEXPORT,24E14108,06/14/2024,Sale,-990.0,600.0,3,SUGAR DROP,Bag
VIDEXPORT,24E14108,06/14/2024,Sale,-150.0,450.0,3,SUGAR DROP,Bag
VIDEXPORT,24E14108,06/17/2024,Sale,-450.0,0.0,6,SUGAR DROP,Bag
VIDEXPORT,24E14109,06/11/2024,Entry,1800.0,1800.0,0,EARLY SWEET,Bag
VIDEXPORT,24E14109,06/12/2024,Sale,-1170.0,630.0,1,EARLY SWEET,Bag
VIDEXPORT,24E14109,06/13/2024,Sale,-630.0,0.0,2,EARLY SWEET,Bag
VIDEXPORT,24E14110,06/11/2024,Entry,2520.0,2520.0,0,SUGAR DROP,Bag
VIDEXPORT,24E14110,06/12/2024,Sale,-540.0,1980.0,1,SUGAR DROP,Bag
VIDEXPORT,24E14110,06/12/2024,Sale,-1980.0,0.0,1,SUGAR DROP,Bag
VIDEXPORT,24E14111,06/11/2024,Entry,2160.0,2160.0,0,EARLY SWEET,Bag
VIDEXPORT,24E14111,06/12/2024,Sale,-90.0,2070.0,1,EARLY SWEET,Bag
VIDEXPORT,24E14111,06/12/2024,Sale,-90.0,1980.0,1,EARLY SWEET,Bag
VIDEXPORT,24E14111,06/12/2024,Sale,-270.0,1710.0,1,EARLY SWEET,Bag
VIDEXPORT,24E14111,06/12/2024,Sale,-360.0,1350.0,1,EARLY SWEET,Bag
VIDEXPORT,24E14111,06/12/2024,Sale,-1080.0,270.0,1,EARLY SWEET,Bag
VIDEXPORT,24E14111,06/12/2024,Sale,-180.0,90.0,1,EARLY SWEET,Bag
VIDEXPORT,24E14111,06/13/2024,Sale,-90.0,0.0,2,EARLY SWEET,Bag
VIDEXPORT,24E14112,06/11/2024,Entry,1800.0,1800.0,0,SUGAR DROP,Bag
VIDEXPORT,24E14112,06/11/2024,Sale,-990.0,810.0,0,SUGAR DROP,Bag
VIDEXPORT,24E14112,06/12/2024,Sale,-540.0,270.0,1,SUGAR DROP,Bag
VIDEXPORT,24E14112,06/12/2024,Sale,-270.0,0.0,1,SUGAR DROP,Bag
VIDEXPORT,24E14113,06/11/2024,Entry,2160.0,2160.0,0,EARLY SWEET,Bag
VIDEXPORT,24E14113,06/12/2024,Sale,-720.0,1440.0,1,EARLY SWEET,Bag
VIDEXPORT,24E14113,06/12/2024,Sale,-90.0,1350.0,1,EARLY SWEET,Bag
VIDEXPORT,24E14113,06/12/2024,Sale,-180.0,1170.0,1,EARLY SWEET,Bag
VIDEXPORT,24E14113,06/12/2024,Sale,-1080.0,90.0,1,EARLY SWEET,Bag
VIDEXPORT,24E14113,06/13/2024,Sale,-90.0,0.0,2,EARLY SWEET,Bag
VIDEXPORT,24E14114,06/11/2024,Entry,2340.0,2340.0,0,SUGAR DROP,Bag
VIDEXPORT,24E14114,06/14/2024,Sale,-990.0,1350.0,3,SUGAR DROP,Bag
VIDEXPORT,24E14114,06/14/2024,Sale,-180.0,1170.0,3,SUGAR DROP,Bag
VIDEXPORT,24E14114,06/15/2024,Sale,-1170.0,0.0,4,SUGAR DROP,Bag
VIDEXPORT,24E14115,06/11/2024,Entry,2160.0,2160.0,0,EARLY SWEET,Bag
VIDEXPORT,24E14115,06/11/2024,Sale,-990.0,1170.0,0,EARLY SWEET,Bag
VIDEXPORT,24E14115,06/12/2024,Sale,-90.0,1080.0,1,EARLY SWEET,Bag
VIDEXPORT,24E14115,06/12/2024,Sale,-1080.0,0.0,1,EARLY SWEET,Bag
VIDEXPORT,24E14116,06/12/2024,Entry,1800.0,1800.0,0,SUGAR DROP,Bag
VIDEXPORT,24E14116,06/13/2024,Sale,-1350.0,450.0,1,SUGAR DROP,Bag
VIDEXPORT,24E14116,06/14/2024,Sale,-450.0,0.0,2,SUGAR DROP,Bag
VIDEXPORT,24E14117,06/11/2024,Entry,1797.0,1797.0,0,SUGAR DROP,Bag
VIDEXPORT,24E14117,06/12/2024,Sale,-1530.0,267.0,1,SUGAR DROP,Bag
VIDEXPORT,24E14117,06/12/2024,Sale,-180.0,87.0,1,SUGAR DROP,Bag
VIDEXPORT,24E14117,06/17/2024,Sale,-87.0,0.0,6,SUGAR DROP,Bag
VIDEXPORT,24E14118,06/11/2024,Entry,2040.0,2040.0,0,EARLY SWEET,Bag
VIDEXPORT,24E14118,06/12/2024,Sale,-510.0,1530.0,1,EARLY SWEET,Bag
VIDEXPORT,24E14118,06/14/2024,Sale,-85.0,1445.0,3,EARLY SWEET,Bag
VIDEXPORT,24E14118,06/14/2024,Sale,-255.0,1190.0,3,EARLY SWEET,Bag
VIDEXPORT,24E14118,06/15/2024,Sale,-425.0,765.0,4,EARLY SWEET,Bag
VIDEXPORT,24E14118,06/18/2024,Sale,-765.0,0.0,7,EARLY SWEET,Bag
VIDEXPORT,24E14119,06/11/2024,Entry,2160.0,2160.0,0,EARLY SWEET,Bag
VIDEXPORT,24E14119,06/12/2024,Sale,-1170.0,990.0,1,EARLY SWEET,Bag
VIDEXPORT,24E14119,06/12/2024,Sale,-900.0,90.0,1,EARLY SWEET,Bag
VIDEXPORT,24E14119,06/13/2024,Sale,-90.0,0.0,2,EARLY SWEET,Bag
VIDEXPORT,24E14120,06/11/2024,Entry,2520.0,2520.0,0,SUGAR DROP,Bag
VIDEXPORT,24E14120,06/11/2024,Sale,-990.0,1530.0,0,SUGAR DROP,Bag
VIDEXPORT,24E14120,06/11/2024,Sale,-180.0,1350.0,0,SUGAR DROP,Bag
VIDEXPORT,24E14120,06/12/2024,Sale,-630.0,720.0,1,SUGAR DROP,Bag
VIDEXPORT,24E14120,06/12/2024,Sale,-90.0,630.0,1,SUGAR DROP,Bag
VIDEXPORT,24E14120,06/12/2024,Sale,-540.0,90.0,1,SUGAR DROP,Bag
VIDEXPORT,24E14120,06/13/2024,Sale,-90.0,0.0,2,SUGAR DROP,Bag
VIDEXPORT,24E14121,06/11/2024,Entry,2520.0,2520.0,0,EARLY SWEET,Bag
VIDEXPORT,24E14121,06/12/2024,Sale,-180.0,2340.0,1,EARLY SWEET,Bag
VIDEXPORT,24E14121,06/12/2024,Sale,-900.0,1440.0,1,EARLY SWEET,Bag
VIDEXPORT,24E14121,06/12/2024,Sale,-1440.0,0.0,1,EARLY SWEET,Bag
VIDEXPORT,24E14122,06/11/2024,Entry,2520.0,2520.0,0,SUGAR DROP,Bag
VIDEXPORT,24E14122,06/14/2024,Sale,-1530.0,990.0,3,SUGAR DROP,Bag
VIDEXPORT,24E14122,06/14/2024,Sale,-810.0,180.0,3,SUGAR DROP,Bag
VIDEXPORT,24E14122,06/15/2024,Sale,-180.0,0.0,4,SUGAR DROP,Bag
VIDEXPORT,24E14123,06/11/2024,Entry,1500.0,1500.0,0,SUGAR DROP,Bag
VIDEXPORT,24E14123,06/14/2024,Sale,-75.0,1425.0,3,SUGAR DROP,Bag
VIDEXPORT,24E14123,06/15/2024,Sale,-225.0,1200.0,4,SUGAR DROP,Bag
VIDEXPORT,24E14123,06/15/2024,Sale,-375.0,825.0,4,SUGAR DROP,Bag
VIDEXPORT,24E14123,06/17/2024,Sale,-825.0,0.0,6,SUGAR DROP,Bag
VIDEXPORT,24E14124,06/11/2024,Entry,2340.0,2340.0,0,SUGAR DROP,Bag
VIDEXPORT,24E14124,06/12/2024,Sale,-180.0,2160.0,1,SUGAR DROP,Bag
VIDEXPORT,24E14124,06/12/2024,Sale,-1890.0,270.0,1,SUGAR DROP,Bag
VIDEXPORT,24E14124,06/13/2024,Sale,-90.0,180.0,2,SUGAR DROP,Bag
VIDEXPORT,24E14124,06/13/2024,Sale,-180.0,0.0,2,SUGAR DROP,Bag
VIDEXPORT,24E14125,06/11/2024,Entry,2340.0,2340.0,0,SUGAR DROP,Bag
VIDEXPORT,24E14125,06/11/2024,Sale,-90.0,2250.0,0,SUGAR DROP,Bag
VIDEXPORT,24E14125,06/11/2024,Sale,-90.0,2160.0,0,SUGAR DROP,Bag
VIDEXPORT,24E14125,06/11/2024,Sale,-180.0,1980.0,0,SUGAR DROP,Bag
VIDEXPORT,24E14125,06/11/2024,Sale,-1890.0,90.0,0,SUGAR DROP,Bag
VIDEXPORT,24E14125,06/12/2024,Sale,-90.0,0.0,1,SUGAR DROP,Bag
VIDEXPORT,24E14126,06/11/2024,Entry,1980.0,1980.0,0,SUGAR DROP,Bag
VIDEXPORT,24E14126,06/13/2024,Sale,-90.0,1890.0,2,SUGAR DROP,Bag
VIDEXPORT,24E14126,06/14/2024,Sale,-1890.0,0.0,3,SUGAR DROP,Bag
VIDEXPORT,24E14127,06/11/2024,Entry,1980.0,1980.0,0,SUGAR DROP,Bag
VIDEXPORT,24E14127,06/13/2024,Sale,-1890.0,90.0,2,SUGAR DROP,Bag
VIDEXPORT,24E14127,06/15/2024,Sale,-90.0,0.0,4,SUGAR DROP,Bag
VIDEXPORT,24E14128,06/11/2024,Entry,1975.0,1975.0,0,SUGAR DROP,Bag
VIDEXPORT,24E14128,06/11/2024,Sale,-990.0,985.0,0,SUGAR DROP,Bag
VIDEXPORT,24E14128,06/12/2024,Sale,-810.0,175.0,1,SUGAR DROP,Bag
VIDEXPORT,24E14128,06/15/2024,Sale,-175.0,0.0,4,SUGAR DROP,Bag
VIDEXPORT,24E14129,06/11/2024,Entry,2340.0,2340.0,0,SUGAR DROP,Bag
VIDEXPORT,24E14129,06/12/2024,Sale,-180.0,2160.0,1,SUGAR DROP,Bag
VIDEXPORT,24E14129,06/12/2024,Sale,-90.0,2070.0,1,SUGAR DROP,Bag
VIDEXPORT,24E14129,06/13/2024,Sale,-1980.0,90.0,2,SUGAR DROP,Bag
VIDEXPORT,24E14129,06/15/2024,Sale,-90.0,0.0,4,SUGAR DROP,Bag
VIDEXPORT,24E14130,06/12/2024,Entry,900.0,900.0,0,SUGAR DROP,Bag
VIDEXPORT,24E14130,06/12/2024,Entry,1125.0,2025.0,0,SUGAR DROP,Bag
VIDEXPORT,24E14130,06/12/2024,Sale,-810.0,1215.0,0,SUGAR DROP,Bag
VIDEXPORT,24E14130,06/13/2024,Sale,-90.0,1125.0,1,SUGAR DROP,Bag
VIDEXPORT,24E14130,06/13/2024,Sale,-150.0,975.0,1,SUGAR DROP,Bag
VIDEXPORT,24E14130,06/15/2024,Sale,-975.0,0.0,3,SUGAR DROP,Bag
VIDEXPORT,24E14131,06/12/2024,Entry,2040.0,2040.0,0,SUGAR DROP,Bag
VIDEXPORT,24E14131,06/12/2024,Sale,-1105.0,935.0,0,SUGAR DROP,Bag
VIDEXPORT,24E14131,06/13/2024,Sale,-935.0,0.0,1,SUGAR DROP,Bag
VIDEXPORT,24E14133,06/12/2024,Entry,2160.0,2160.0,0,EARLY SWEET,Bag
VIDEXPORT,24E14133,06/12/2024,Sale,-810.0,1350.0,0,EARLY SWEET,Bag
VIDEXPORT,24E14133,06/12/2024,Sale,-630.0,720.0,0,EARLY SWEET,Bag
VIDEXPORT,24E14133,06/13/2024,Sale,-450.0,270.0,1,EARLY SWEET,Bag
VIDEXPORT,24E14133,06/14/2024,Sale,-90.0,180.0,2,EARLY SWEET,Bag
VIDEXPORT,24E14133,06/14/2024,Sale,-90.0,90.0,2,EARLY SWEET,Bag
VIDEXPORT,24E14133,06/14/2024,Sale,-90.0,0.0,2,EARLY SWEET,Bag
VIDEXPORT,24E14134,06/12/2024,Entry,2160.0,2160.0,0,EARLY SWEET,Bag
VIDEXPORT,24E14134,06/12/2024,Sale,-720.0,1440.0,0,EARLY SWEET,Bag
VIDEXPORT,24E14134,06/12/2024,Sale,-1080.0,360.0,0,EARLY SWEET,Bag
VIDEXPORT,24E14134,06/12/2024,Sale,-180.0,180.0,0,EARLY SWEET,Bag
VIDEXPORT,24E14134,06/13/2024,Sale,-180.0,0.0,1,EARLY SWEET,Bag
VIDEXPORT,24E14135,06/12/2024,Entry,2160.0,2160.0,0,EARLY SWEET,Bag
VIDEXPORT,24E14135,06/13/2024,Sale,-630.0,1530.0,1,EARLY SWEET,Bag
VIDEXPORT,24E14135,06/13/2024,Sale,-1170.0,360.0,1,EARLY SWEET,Bag
VIDEXPORT,24E14135,06/13/2024,Sale,-360.0,0.0,1,EARLY SWEET,Bag
VIDEXPORT,24E14136,06/13/2024,Entry,2160.0,2160.0,0,EARLY SWEET,Bag
VIDEXPORT,24E14136,06/13/2024,Sale,-90.0,2070.0,0,EARLY SWEET,Bag
VIDEXPORT,24E14136,06/13/2024,Sale,-810.0,1260.0,0,EARLY SWEET,Bag
VIDEXPORT,24E14136,06/13/2024,Sale,-90.0,1170.0,0,EARLY SWEET,Bag
VIDEXPORT,24E14136,06/13/2024,Sale,-1080.0,90.0,0,EARLY SWEET,Bag
VIDEXPORT,24E14136,06/14/2024,Sale,-90.0,0.0,1,EARLY SWEET,Bag
VIDEXPORT,24E14137,06/12/2024,Entry,2340.0,2340.0,0,SUGAR DROP,Bag
VIDEXPORT,24E14137,06/13/2024,Sale,-1980.0,360.0,1,SUGAR DROP,Bag
VIDEXPORT,24E14137,06/13/2024,Sale,-360.0,0.0,1,SUGAR DROP,Bag
VIDEXPORT,24E14138,06/12/2024,Entry,2160.0,2160.0,0,EARLY SWEET,Bag
VIDEXPORT,24E14138,06/13/2024,Sale,-900.0,1260.0,1,EARLY SWEET,Bag
VIDEXPORT,24E14138,06/13/2024,Sale,-90.0,1170.0,1,EARLY SWEET,Bag
VIDEXPORT,24E14138,06/13/2024,Sale,-1170.0,0.0,1,EARLY SWEET,Bag
VIDEXPORT,24E14139,06/12/2024,Entry,1700.0,1700.0,0,SUGAR DROP,Bag
VIDEXPORT,24E14139,06/13/2024,Sale,-1700.0,0.0,1,SUGAR DROP,Bag
VIDEXPORT,24E14140,06/13/2024,Entry,1980.0,1980.0,0,EARLY SWEET,Bag
VIDEXPORT,24E14140,06/13/2024,Sale,-90.0,1890.0,0,EARLY SWEET,Bag
VIDEXPORT,24E14140,06/14/2024,Sale,-450.0,1440.0,1,EARLY SWEET,Bag
VIDEXPORT,24E14140,06/14/2024,Sale,-1080.0,360.0,1,EARLY SWEET,Bag
VIDEXPORT,24E14140,06/15/2024,Sale,-360.0,0.0,2,EARLY SWEET,Bag
VIDEXPORT,24E14142,06/12/2024,Entry,2520.0,2520.0,0,EARLY SWEET,Bag
VIDEXPORT,24E14142,06/12/2024,Sale,-270.0,2250.0,0,EARLY SWEET,Bag
VIDEXPORT,24E14142,06/12/2024,Sale,-1080.0,1170.0,0,EARLY SWEET,Bag
VIDEXPORT,24E14142,06/13/2024,Sale,-1170.0,0.0,1,EARLY SWEET,Bag
VIDEXPORT,24E14143,06/12/2024,Entry,2340.0,2340.0,0,SUGAR DROP,Bag
VIDEXPORT,24E14143,06/13/2024,Sale,-90.0,2250.0,1,SUGAR DROP,Bag
VIDEXPORT,24E14143,06/13/2024,Sale,-180.0,2070.0,1,SUGAR DROP,Bag
VIDEXPORT,24E14143,06/13/2024,Sale,-1980.0,90.0,1,SUGAR DROP,Bag
VIDEXPORT,24E14143,06/17/2024,Sale,-90.0,0.0,5,SUGAR DROP,Bag
VIDEXPORT,24E14146,06/12/2024,Entry,1800.0,1800.0,0,SUGAR DROP,Bag
VIDEXPORT,24E14146,06/13/2024,Sale,-270.0,1530.0,1,SUGAR DROP,Bag
VIDEXPORT,24E14146,06/13/2024,Sale,-1530.0,0.0,1,SUGAR DROP,Bag
VIDEXPORT,24E14148,06/12/2024,Entry,90.0,90.0,0,SUGAR DROP,Bag
VIDEXPORT,24E14148,06/12/2024,Entry,1530.0,1620.0,0,SUGAR DROP,Bag
VIDEXPORT,24E14148,06/13/2024,Sale,-1170.0,450.0,1,SUGAR DROP,Bag
VIDEXPORT,24E14148,06/13/2024,Sale,-360.0,90.0,1,SUGAR DROP,Bag
VIDEXPORT,24E14148,06/15/2024,Sale,-90.0,0.0,3,SUGAR DROP,Bag
VIDEXPORT,24E14149,06/12/2024,Entry,1800.0,1800.0,0,SUGAR DROP,Bag
VIDEXPORT,24E14149,06/13/2024,Sale,-450.0,1350.0,1,SUGAR DROP,Bag
VIDEXPORT,24E14149,06/13/2024,Sale,-1350.0,0.0,1,SUGAR DROP,Bag
VIDEXPORT,24E14150,06/12/2024,Entry,1500.0,1500.0,0,SUGAR DROP,Bag
VIDEXPORT,24E14150,06/13/2024,Sale,-1500.0,0.0,1,SUGAR DROP,Bag
VIDEXPORT,24E14151,06/12/2024,Entry,1650.0,1650.0,0,SUGAR DROP,Bag
VIDEXPORT,24E14151,06/14/2024,Sale,-600.0,1050.0,2,SUGAR DROP,Bag
VIDEXPORT,24E14151,06/15/2024,Sale,-600.0,450.0,3,SUGAR DROP,Bag
VIDEXPORT,24E14151,06/17/2024,Sale,-150.0,300.0,5,SUGAR DROP,Bag
VIDEXPORT,24E14151,06/17/2024,Sale,-300.0,0.0,5,SUGAR DROP,Bag
VIDEXPORT,24E14152,06/13/2024,Entry,1980.0,1980.0,0,EARLY SWEET,Bag
VIDEXPORT,24E14152,06/13/2024,Sale,-900.0,1080.0,0,EARLY SWEET,Bag
VIDEXPORT,24E14152,06/13/2024,Sale,-90.0,990.0,0,EARLY SWEET,Bag
VIDEXPORT,24E14152,06/13/2024,Sale,-720.0,270.0,0,EARLY SWEET,Bag
VIDEXPORT,24E14152,06/25/2024,Sale,-300.0,-30.0,12,EARLY SWEET,Clam
VIDEXPORT,24E14152,06/27/2024,Sale,-1725.0,-1755.0,14,EARLY SWEET,Clam
VIDEXPORT,24E14152,07/02/2024,Sale,-75.0,-1830.0,19,EARLY SWEET,Clam
VIDEXPORT,24E14153,06/13/2024,Entry,1980.0,1980.0,0,EARLY SWEET,Bag
VIDEXPORT,24E14153,06/14/2024,Sale,-180.0,1800.0,1,EARLY SWEET,Bag
VIDEXPORT,24E14153,06/15/2024,Sale,-90.0,1710.0,2,EARLY SWEET,Bag
VIDEXPORT,24E14153,06/24/2024,Sale,-90.0,1620.0,11,EARLY SWEET,Bag
VIDEXPORT,24E14153,06/27/2024,Sale,-90.0,1530.0,14,EARLY SWEET,Bag
VIDEXPORT,24E14153,07/29/2024,Sale,-30.0,1500.0,46,EARLY SWEET,Bag
VIDEXPORT,24E14154,06/14/2024,Entry,2340.0,2340.0,0,EARLY SWEET,Bag
VIDEXPORT,24E14154,06/14/2024,Sale,-900.0,1440.0,0,EARLY SWEET,Bag
VIDEXPORT,24E14154,06/14/2024,Sale,-630.0,810.0,0,EARLY SWEET,Bag
VIDEXPORT,24E14154,06/14/2024,Sale,-810.0,0.0,0,EARLY SWEET,Bag
VIDEXPORT,24E14155,06/13/2024,Entry,2160.0,2160.0,0,EARLY SWEET,Bag
VIDEXPORT,24E14155,06/14/2024,Sale,-540.0,1620.0,1,EARLY SWEET,Bag
VIDEXPORT,24E14155,06/14/2024,Sale,-900.0,720.0,1,EARLY SWEET,Bag
VIDEXPORT,24E14155,06/22/2024,Sale,-780.0,-60.0,9,BI-COLOR,Clam
VIDEXPORT,24E14155,06/22/2024,Sale,-45.0,-105.0,9,BI-COLOR,Clam
VIDEXPORT,24E14155,06/25/2024,Sale,-360.0,-465.0,12,EARLY SWEET,Bag
VIDEXPORT,24E14156,06/13/2024,Entry,2160.0,2160.0,0,EARLY SWEET,Bag
VIDEXPORT,24E14156,06/14/2024,Sale,-90.0,2070.0,1,EARLY SWEET,Bag
VIDEXPORT,24E14156,06/20/2024,Sale,-270.0,1800.0,7,EARLY SWEET,Bag
VIDEXPORT,24E14156,06/22/2024,Sale,-1260.0,540.0,9,EARLY SWEET,Bag
VIDEXPORT,24E14156,06/27/2024,Sale,-360.0,180.0,14,EARLY SWEET,Bag
VIDEXPORT,24E14156,06/27/2024,Sale,-45.0,135.0,14,EARLY SWEET,Bag
VIDEXPORT,24E14156,06/27/2024,Sale,-45.0,90.0,14,EARLY SWEET,Bag
VIDEXPORT,24E14156,06/27/2024,Sale,-45.0,45.0,14,EARLY SWEET,Bag
VIDEXPORT,24E14156,06/27/2024,Sale,-45.0,0.0,14,EARLY SWEET,Bag
VIDEXPORT,24E14157,06/13/2024,Entry,2160.0,2160.0,0,EARLY SWEET,Bag
VIDEXPORT,24E14157,06/14/2024,Sale,-990.0,1170.0,1,EARLY SWEET,Bag
VIDEXPORT,24E14157,06/14/2024,Sale,-1170.0,0.0,1,EARLY SWEET,Bag
VIDEXPORT,24E14158,06/13/2024,Entry,2340.0,2340.0,0,EARLY SWEET,Bag
VIDEXPORT,24E14158,06/13/2024,Sale,-630.0,1710.0,0,EARLY SWEET,Bag
VIDEXPORT,24E14158,06/14/2024,Sale,-540.0,1170.0,1,EARLY SWEET,Bag
VIDEXPORT,24E14158,06/14/2024,Sale,-180.0,990.0,1,EARLY SWEET,Bag
VIDEXPORT,24E14158,06/14/2024,Sale,-810.0,180.0,1,EARLY SWEET,Bag
VIDEXPORT,24E14158,06/21/2024,Sale,-180.0,0.0,8,EARLY SWEET,Bag
VIDEXPORT,24E14159,06/14/2024,Entry,2160.0,2160.0,0,SUGAR DROP,Bag
VIDEXPORT,24E14159,06/20/2024,Sale,-450.0,1710.0,6,SUGAR DROP,Bag
VIDEXPORT,24E14159,06/22/2024,Sale,-1710.0,0.0,8,SUGAR DROP,Bag
VIDEXPORT,24E14160,06/14/2024,Entry,2160.0,2160.0,0,SUGAR DROP,Bag
VIDEXPORT,24E14160,06/15/2024,Sale,-810.0,1350.0,1,SUGAR DROP,Bag
VIDEXPORT,24E14160,06/15/2024,Sale,-540.0,810.0,1,SUGAR DROP,Bag
VIDEXPORT,24E14160,06/15/2024,Sale,-630.0,180.0,1,SUGAR DROP,Bag
VIDEXPORT,24E14160,06/17/2024,Sale,-180.0,0.0,3,SUGAR DROP,Bag
VIDEXPORT,24E14161,06/13/2024,Entry,1800.0,1800.0,0,EARLY SWEET,Bag
VIDEXPORT,24E14161,06/14/2024,Sale,-630.0,1170.0,1,EARLY SWEET,Bag
VIDEXPORT,24E14161,06/14/2024,Sale,-90.0,1080.0,1,EARLY SWEET,Bag
VIDEXPORT,24E14161,06/14/2024,Sale,-720.0,360.0,1,EARLY SWEET,Bag
VIDEXPORT,24E14161,06/14/2024,Sale,-270.0,90.0,1,EARLY SWEET,Bag
VIDEXPORT,24E14161,06/25/2024,Sale,-90.0,0.0,12,EARLY SWEET,Bag
VIDEXPORT,24E14163,06/13/2024,Entry,2160.0,2160.0,0,SUGAR DROP,Bag
VIDEXPORT,24E14163,06/13/2024,Sale,-900.0,1260.0,0,SUGAR DROP,Bag
VIDEXPORT,24E14163,06/13/2024,Sale,-1080.0,180.0,0,SUGAR DROP,Bag
VIDEXPORT,24E14163,06/13/2024,Sale,-180.0,0.0,0,SUGAR DROP,Bag
VIDEXPORT,24E14164,06/13/2024,Entry,2070.0,2070.0,0,EARLY SWEET,Bag
VIDEXPORT,24E14164,06/24/2024,Sale,-990.0,1080.0,11,EARLY SWEET,Bag
VIDEXPORT,24E14164,06/25/2024,Sale,-540.0,540.0,12,EARLY SWEET,Bag
VIDEXPORT,24E14164,06/28/2024,Sale,-270.0,270.0,15,EARLY SWEET,Bag
VIDEXPORT,24E14164,07/01/2024,Sale,-90.0,180.0,18,EARLY SWEET,Bag
VIDEXPORT,24E14164,07/01/2024,Sale,-90.0,90.0,18,EARLY SWEET,Bag
VIDEXPORT,24E14164,07/10/2024,Sale,-90.0,0.0,27,EARLY SWEET,Bag
VIDEXPORT,24E14165,06/13/2024,Entry,2340.0,2340.0,0,SUGAR DROP,Bag
VIDEXPORT,24E14165,06/13/2024,Sale,-90.0,2250.0,0,SUGAR DROP,Bag
VIDEXPORT,24E14165,06/13/2024,Sale,-1980.0,270.0,0,SUGAR DROP,Bag
VIDEXPORT,24E14165,06/14/2024,Sale,-180.0,90.0,1,SUGAR DROP,Bag
VIDEXPORT,24E14165,06/14/2024,Sale,-90.0,0.0,1,SUGAR DROP,Bag
VIDEXPORT,24E14166,06/13/2024,Entry,2340.0,2340.0,0,SUGAR DROP,Bag
VIDEXPORT,24E14166,06/13/2024,Sale,-540.0,1800.0,0,SUGAR DROP,Bag
VIDEXPORT,24E14166,06/13/2024,Sale,-1710.0,90.0,0,SUGAR DROP,Bag
VIDEXPORT,24E14166,07/12/2024,Sale,-90.0,0.0,29,SUGAR DROP,Bag
VIDEXPORT,24E14168,06/14/2024,Entry,2340.0,2340.0,0,SUGAR DROP,Bag
VIDEXPORT,24E14168,06/14/2024,Sale,-270.0,2070.0,0,SUGAR DROP,Bag
VIDEXPORT,24E14168,06/14/2024,Sale,-990.0,1080.0,0,SUGAR DROP,Bag
VIDEXPORT,24E14168,06/14/2024,Sale,-180.0,900.0,0,SUGAR DROP,Bag
VIDEXPORT,24E14168,06/14/2024,Sale,-720.0,180.0,0,SUGAR DROP,Bag
VIDEXPORT,24E14168,06/15/2024,Sale,-180.0,0.0,1,SUGAR DROP,Bag
VIDEXPORT,24E14169,06/13/2024,Entry,2340.0,2340.0,0,SUGAR DROP,Bag
VIDEXPORT,24E14169,06/13/2024,Sale,-990.0,1350.0,0,SUGAR DROP,Bag
VIDEXPORT,24E14169,06/13/2024,Sale,-810.0,540.0,0,SUGAR DROP,Bag
VIDEXPORT,24E14169,06/13/2024,Sale,-90.0,450.0,0,SUGAR DROP,Bag
VIDEXPORT,24E14169,06/13/2024,Sale,-270.0,180.0,0,SUGAR DROP,Bag
VIDEXPORT,24E14169,06/13/2024,Sale,-180.0,0.0,0,SUGAR DROP,Bag
VIDEXPORT,24E14170,06/14/2024,Entry,1890.0,1890.0,0,EARLY SWEET,Bag
VIDEXPORT,24E14170,06/14/2024,Sale,-1890.0,0.0,0,EARLY SWEET,Bag
VIDEXPORT,24E14171,06/13/2024,Entry,1710.0,1710.0,0,EARLY SWEET,Bag
VIDEXPORT,24E14171,06/20/2024,Sale,-1710.0,0.0,7,EARLY SWEET,Bag
VIDEXPORT,24E14174,06/13/2024,Entry,1800.0,1800.0,0,SUGAR DROP,Bag
VIDEXPORT,24E14174,06/19/2024,Sale,-180.0,1620.0,6,SUGAR DROP,Bag
VIDEXPORT,24E14174,06/19/2024,Sale,-540.0,1080.0,6,SUGAR DROP,Bag
VIDEXPORT,24E14174,06/20/2024,Sale,-1080.0,0.0,7,SUGAR DROP,Bag
VIDEXPORT,24E14175,06/13/2024,Entry,2520.0,2520.0,0,SUGAR DROP,Bag
VIDEXPORT,24E14175,06/13/2024,Sale,-360.0,2160.0,0,SUGAR DROP,Bag
VIDEXPORT,24E14175,06/15/2024,Sale,-1980.0,180.0,2,SUGAR DROP,Bag
VIDEXPORT,24E14175,07/12/2024,Sale,-180.0,0.0,29,SUGAR DROP,Bag
VIDEXPORT,24E14177,06/13/2024,Entry,1710.0,1710.0,0,HONEY POP,Bag
VIDEXPORT,24E14177,06/14/2024,Sale,-1710.0,0.0,1,HONEY POP,Bag
VIDEXPORT,24E14178,06/13/2024,Entry,2340.0,2340.0,0,SUGAR DROP,Bag
VIDEXPORT,24E14178,06/13/2024,Sale,-1080.0,1260.0,0,SUGAR DROP,Bag
VIDEXPORT,24E14178,06/13/2024,Sale,-1170.0,90.0,0,SUGAR DROP,Bag
VIDEXPORT,24E14178,06/15/2024,Sale,-90.0,0.0,2,SUGAR DROP,Bag
VIDEXPORT,24E14179,06/13/2024,Entry,2070.0,2070.0,0,SUGAR DROP,Bag
VIDEXPORT,24E14179,06/13/2024,Entry,225.0,2295.0,0,SUGAR DROP,Bag
VIDEXPORT,24E14179,06/13/2024,Sale,-810.0,1485.0,0,SUGAR DROP,Bag
VIDEXPORT,24E14179,06/14/2024,Sale,-1260.0,225.0,1,SUGAR DROP,Bag
VIDEXPORT,24E14179,06/17/2024,Sale,-225.0,0.0,4,SUGAR DROP,Bag
VIDEXPORT,24E14180,06/13/2024,Entry,1710.0,1710.0,0,SUGAR DROP,Bag
VIDEXPORT,24E14180,06/19/2024,Sale,-900.0,810.0,6,SUGAR DROP,Bag
VIDEXPORT,24E14180,06/20/2024,Sale,-540.0,270.0,7,SUGAR DROP,Bag
VIDEXPORT,24E14180,06/22/2024,Sale,-270.0,0.0,9,SUGAR DROP,Bag
VIDEXPORT,24E14181,06/15/2024,Entry,2160.0,2160.0,0,EARLY SWEET,Bag
VIDEXPORT,24E14181,06/15/2024,Sale,-180.0,1980.0,0,EARLY SWEET,Bag
VIDEXPORT,24E14181,06/17/2024,Sale,-1800.0,180.0,2,EARLY SWEET,Bag
VIDEXPORT,24E14181,06/17/2024,Sale,-90.0,90.0,2,EARLY SWEET,Bag
VIDEXPORT,24E14181,06/18/2024,Sale,-90.0,0.0,3,EARLY SWEET,Bag
VIDEXPORT,24E14182,06/14/2024,Entry,2160.0,2160.0,0,EARLY SWEET,Bag
VIDEXPORT,24E14182,06/15/2024,Sale,-1440.0,720.0,1,EARLY SWEET,Bag
VIDEXPORT,24E14182,06/15/2024,Sale,-360.0,360.0,1,EARLY SWEET,Bag
VIDEXPORT,24E14182,06/17/2024,Sale,-180.0,180.0,3,EARLY SWEET,Bag
VIDEXPORT,24E14182,06/17/2024,Sale,-5.0,175.0,3,EARLY SWEET,Bag
VIDEXPORT,24E14182,06/20/2024,Sale,-90.0,85.0,6,EARLY SWEET,Bag
VIDEXPORT,24E14182,06/29/2024,Sale,-85.0,0.0,15,EARLY SWEET,Bag
VIDEXPORT,24E14183,06/14/2024,Entry,2160.0,2160.0,0,EARLY SWEET,Bag
VIDEXPORT,24E14183,06/14/2024,Sale,-90.0,2070.0,0,EARLY SWEET,Bag
VIDEXPORT,24E14183,06/14/2024,Sale,-360.0,1710.0,0,EARLY SWEET,Bag
VIDEXPORT,24E14183,06/15/2024,Sale,-90.0,1620.0,1,EARLY SWEET,Bag
VIDEXPORT,24E14183,06/15/2024,Sale,-90.0,1530.0,1,EARLY SWEET,Bag
VIDEXPORT,24E14183,06/15/2024,Sale,-180.0,1350.0,1,EARLY SWEET,Bag
VIDEXPORT,24E14183,06/15/2024,Sale,-1350.0,0.0,1,EARLY SWEET,Bag
VIDEXPORT,24E14184,06/14/2024,Entry,2160.0,2160.0,0,EARLY SWEET,Bag
VIDEXPORT,24E14184,06/14/2024,Sale,-90.0,2070.0,0,EARLY SWEET,Bag
VIDEXPORT,24E14184,06/15/2024,Sale,-900.0,1170.0,1,EARLY SWEET,Bag
VIDEXPORT,24E14184,06/15/2024,Sale,-810.0,360.0,1,EARLY SWEET,Bag
VIDEXPORT,24E14184,06/15/2024,Sale,-90.0,270.0,1,EARLY SWEET,Bag
VIDEXPORT,24E14184,06/15/2024,Sale,-270.0,0.0,1,EARLY SWEET,Bag
VIDEXPORT,24E14185,06/14/2024,Entry,2340.0,2340.0,0,SUGAR DROP,Bag
VIDEXPORT,24E14185,06/18/2024,Sale,-810.0,1530.0,4,SUGAR DROP,Bag
VIDEXPORT,24E14185,06/22/2024,Sale,-360.0,1170.0,8,SUGAR DROP,Bag
VIDEXPORT,24E14185,06/22/2024,Sale,-900.0,270.0,8,SUGAR DROP,Bag
VIDEXPORT,24E14185,06/22/2024,Sale,-270.0,0.0,8,SUGAR DROP,Bag
VIDEXPORT,24E14186,06/14/2024,Entry,1800.0,1800.0,0,EARLY SWEET,Bag
VIDEXPORT,24E14186,06/14/2024,Sale,-540.0,1260.0,0,EARLY SWEET,Bag
VIDEXPORT,24E14186,06/14/2024,Sale,-1080.0,180.0,0,EARLY SWEET,Bag
VIDEXPORT,24E14186,06/15/2024,Sale,-90.0,90.0,1,EARLY SWEET,Bag
VIDEXPORT,24E14186,06/15/2024,Sale,-90.0,0.0,1,EARLY SWEET,Bag
VIDEXPORT,24E14187,06/14/2024,Entry,2340.0,2340.0,0,SUGAR DROP,Bag
VIDEXPORT,24E14187,07/08/2024,Sale,-1980.0,360.0,24,SUGAR DROP,Bag
VIDEXPORT,24E14187,07/12/2024,Sale,-360.0,0.0,28,SUGAR DROP,Bag
VIDEXPORT,24E14188,06/14/2024,Entry,2340.0,2340.0,0,SUGAR DROP,Bag
VIDEXPORT,24E14188,06/17/2024,Sale,-270.0,2070.0,3,SUGAR DROP,Bag
VIDEXPORT,24E14188,06/17/2024,Sale,-900.0,1170.0,3,SUGAR DROP,Bag
VIDEXPORT,24E14188,06/18/2024,Sale,-1170.0,0.0,4,SUGAR DROP,Bag
VIDEXPORT,24E14189,06/14/2024,Entry,2160.0,2160.0,0,EARLY SWEET,Bag
VIDEXPORT,24E14189,06/14/2024,Sale,-360.0,1800.0,0,EARLY SWEET,Bag
VIDEXPORT,24E14189,06/15/2024,Sale,-1620.0,180.0,1,EARLY SWEET,Bag
VIDEXPORT,24E14189,06/17/2024,Sale,-180.0,0.0,3,EARLY SWEET,Bag
VIDEXPORT,24E14190,06/15/2024,Entry,1980.0,1980.0,0,EARLY SWEET,Bag
VIDEXPORT,24E14190,06/17/2024,Sale,-540.0,1440.0,2,EARLY SWEET,Bag
VIDEXPORT,24E14190,06/18/2024,Sale,-900.0,540.0,3,EARLY SWEET,Bag
VIDEXPORT,24E14190,06/18/2024,Sale,-270.0,270.0,3,EARLY SWEET,Bag
VIDEXPORT,24E14190,06/18/2024,Sale,-90.0,180.0,3,EARLY SWEET,Bag
VIDEXPORT,24E14190,06/18/2024,Sale,-180.0,0.0,3,EARLY SWEET,Bag
VIDEXPORT,24E14192,06/14/2024,Entry,2160.0,2160.0,0,EARLY SWEET,Bag
VIDEXPORT,24E14192,06/15/2024,Sale,-360.0,1800.0,1,EARLY SWEET,Bag
VIDEXPORT,24E14192,06/18/2024,Sale,-90.0,1710.0,4,EARLY SWEET,Bag
VIDEXPORT,24E14192,06/18/2024,Sale,-1260.0,450.0,4,EARLY SWEET,Bag
VIDEXPORT,24E14192,06/18/2024,Sale,-450.0,0.0,4,EARLY SWEET,Bag
VIDEXPORT,24E14193,06/14/2024,Entry,2340.0,2340.0,0,SUGAR DROP,Bag
VIDEXPORT,24E14193,06/14/2024,Sale,-1170.0,1170.0,0,SUGAR DROP,Bag
VIDEXPORT,24E14193,06/14/2024,Sale,-990.0,180.0,0,SUGAR DROP,Bag
VIDEXPORT,24E14193,06/15/2024,Sale,-90.0,90.0,1,SUGAR DROP,Bag
VIDEXPORT,24E14193,07/12/2024,Sale,-90.0,0.0,28,SUGAR DROP,Bag
VIDEXPORT,24E14194,06/14/2024,Entry,2160.0,2160.0,0,SUGAR DROP,Bag
VIDEXPORT,24E14194,06/15/2024,Sale,-450.0,1710.0,1,SUGAR DROP,Bag
VIDEXPORT,24E14194,06/15/2024,Sale,-630.0,1080.0,1,SUGAR DROP,Bag
VIDEXPORT,24E14194,06/15/2024,Sale,-720.0,360.0,1,SUGAR DROP,Bag
VIDEXPORT,24E14194,06/15/2024,Sale,-270.0,90.0,1,SUGAR DROP,Bag
VIDEXPORT,24E14194,06/28/2024,Sale,-90.0,0.0,14,SUGAR DROP,Bag
VIDEXPORT,24E14195,06/14/2024,Entry,2160.0,2160.0,0,SUGAR DROP,Bag
VIDEXPORT,24E14195,06/15/2024,Sale,-1980.0,180.0,1,SUGAR DROP,Bag
VIDEXPORT,24E14195,06/17/2024,Sale,-180.0,0.0,3,SUGAR DROP,Bag
VIDEXPORT,24E14196,06/15/2024,Entry,2160.0,2160.0,0,EARLY SWEET,Bag
VIDEXPORT,24E14196,06/15/2024,Sale,-1170.0,990.0,0,EARLY SWEET,Bag
VIDEXPORT,24E14196,06/15/2024,Sale,-810.0,180.0,0,EARLY SWEET,Bag
VIDEXPORT,24E14196,06/17/2024,Sale,-90.0,90.0,2,EARLY SWEET,Bag
VIDEXPORT,24E14196,06/18/2024,Sale,-90.0,0.0,3,EARLY SWEET,Bag
VIDEXPORT,24E14197,06/14/2024,Entry,1800.0,1800.0,0,SUGAR DROP,Bag
VIDEXPORT,24E14197,06/19/2024,Sale,-900.0,900.0,5,SUGAR DROP,Bag
VIDEXPORT,24E14197,06/19/2024,Sale,-810.0,90.0,5,SUGAR DROP,Bag
VIDEXPORT,24E14197,06/22/2024,Sale,-90.0,0.0,8,SUGAR DROP,Bag
VIDEXPORT,24E14198,06/14/2024,Entry,1800.0,1800.0,0,EARLY SWEET,Bag
VIDEXPORT,24E14198,06/19/2024,Sale,-1800.0,0.0,5,EARLY SWEET,Bag
VIDEXPORT,24E14200,06/15/2024,Entry,2520.0,2520.0,0,EARLY SWEET,Bag
VIDEXPORT,24E14200,06/15/2024,Sale,-900.0,1620.0,0,EARLY SWEET,Bag
VIDEXPORT,24E14200,06/15/2024,Sale,-990.0,630.0,0,EARLY SWEET,Bag
VIDEXPORT,24E14200,06/15/2024,Sale,-180.0,450.0,0,EARLY SWEET,Bag
VIDEXPORT,24E14200,06/18/2024,Sale,-450.0,0.0,3,EARLY SWEET,Bag
VIDEXPORT,24E14201,06/15/2024,Entry,1890.0,1890.0,0,SUGAR DROP,Bag
VIDEXPORT,24E14201,06/20/2024,Sale,-1890.0,0.0,5,SUGAR DROP,Bag
VIDEXPORT,24E14202,06/15/2024,Entry,810.0,810.0,0,SUGAR DROP,Bag
VIDEXPORT,24E14202,06/15/2024,Entry,1350.0,2160.0,0,SUGAR DROP,Bag
VIDEXPORT,24E14202,06/15/2024,Sale,-810.0,1350.0,0,SUGAR DROP,Bag
VIDEXPORT,24E14202,06/15/2024,Sale,-90.0,1260.0,0,SUGAR DROP,Bag
VIDEXPORT,24E14202,06/15/2024,Sale,-360.0,900.0,0,SUGAR DROP,Bag
VIDEXPORT,24E14202,06/17/2024,Sale,-810.0,90.0,2,SUGAR DROP,Bag
VIDEXPORT,24E14202,06/17/2024,Sale,-90.0,0.0,2,SUGAR DROP,Bag
VIDEXPORT,24E14203,06/14/2024,Entry,1980.0,1980.0,0,SUGAR DROP,Bag
VIDEXPORT,24E14203,06/15/2024,Sale,-180.0,1800.0,1,SUGAR DROP,Bag
VIDEXPORT,24E14203,06/15/2024,Sale,-180.0,1620.0,1,SUGAR DROP,Bag
VIDEXPORT,24E14203,06/15/2024,Sale,-90.0,1530.0,1,SUGAR DROP,Bag
VIDEXPORT,24E14203,06/15/2024,Sale,-360.0,1170.0,1,SUGAR DROP,Bag
VIDEXPORT,24E14203,06/15/2024,Sale,-180.0,990.0,1,SUGAR DROP,Bag
VIDEXPORT,24E14203,06/17/2024,Sale,-270.0,720.0,3,SUGAR DROP,Bag
VIDEXPORT,24E14203,06/18/2024,Sale,-630.0,90.0,4,SUGAR DROP,Bag
VIDEXPORT,24E14203,06/19/2024,Sale,-90.0,0.0,5,SUGAR DROP,Bag
VIDEXPORT,24E14204,06/14/2024,Entry,1800.0,1800.0,0,SUGAR DROP,Bag
VIDEXPORT,24E14204,06/14/2024,Sale,-1080.0,720.0,0,SUGAR DROP,Bag
VIDEXPORT,24E14204,06/17/2024,Sale,-720.0,0.0,3,SUGAR DROP,Bag
VIDEXPORT,24E14205,06/14/2024,Entry,2340.0,2340.0,0,SUGAR DROP,Bag
VIDEXPORT,24E14205,06/22/2024,Sale,-1350.0,990.0,8,SUGAR DROP,Bag
VIDEXPORT,24E14205,06/22/2024,Sale,-270.0,720.0,8,SUGAR DROP,Bag
VIDEXPORT,24E14205,06/22/2024,Sale,-180.0,540.0,8,SUGAR DROP,Bag
VIDEXPORT,24E14205,06/24/2024,Sale,-180.0,360.0,10,SUGAR DROP,Bag
VIDEXPORT,24E14205,06/26/2024,Sale,-180.0,180.0,12,SUGAR DROP,Bag
VIDEXPORT,24E14205,07/12/2024,Sale,-180.0,0.0,28,SUGAR DROP,Bag
VIDEXPORT,24E14206,06/14/2024,Entry,1980.0,1980.0,0,SUGAR DROP,Bag
VIDEXPORT,24E14206,06/15/2024,Sale,-990.0,990.0,1,SUGAR DROP,Bag
VIDEXPORT,24E14206,06/15/2024,Sale,-990.0,0.0,1,SUGAR DROP,Bag
VIDEXPORT,24E14207,06/14/2024,Entry,1620.0,1620.0,0,SUGAR DROP,Bag
VIDEXPORT,24E14207,06/21/2024,Sale,-990.0,630.0,7,SUGAR DROP,Bag
VIDEXPORT,24E14207,06/24/2024,Sale,-630.0,0.0,10,SUGAR DROP,Bag
VIDEXPORT,24E14212,06/15/2024,Entry,1680.0,1680.0,0,HONEY POP,Clam
VIDEXPORT,24E14212,06/15/2024,Sale,-1600.0,80.0,0,HONEY POP,Clam
VIDEXPORT,24E14212,06/20/2024,Sale,-80.0,0.0,5,HONEY POP,Clam
VIDEXPORT,24E14213,06/15/2024,Entry,2160.0,2160.0,0,EARLY SWEET,Bag
VIDEXPORT,24E14213,06/16/2024,Sale,-1980.0,180.0,1,EARLY SWEET,Bag
VIDEXPORT,24E14213,06/17/2024,Sale,-90.0,90.0,2,EARLY SWEET,Bag
VIDEXPORT,24E14213,06/18/2024,Sale,-90.0,0.0,3,EARLY SWEET,Bag
VIDEXPORT,24E14214,06/15/2024,Entry,1800.0,1800.0,0,EARLY SWEET,Bag
VIDEXPORT,24E14214,06/17/2024,Sale,-810.0,990.0,2,EARLY SWEET,Bag
VIDEXPORT,24E14214,06/18/2024,Sale,-180.0,810.0,3,EARLY SWEET,Bag
VIDEXPORT,24E14214,06/19/2024,Sale,-630.0,180.0,4,EARLY SWEET,Bag
VIDEXPORT,24E14214,06/20/2024,Sale,-180.0,0.0,5,EARLY SWEET,Bag
VIDEXPORT,24E14215,06/15/2024,Entry,2160.0,2160.0,0,EARLY SWEET,Bag
VIDEXPORT,24E14215,06/18/2024,Sale,-90.0,2070.0,3,EARLY SWEET,Bag
VIDEXPORT,24E14215,06/18/2024,Sale,-630.0,1440.0,3,EARLY SWEET,Bag
VIDEXPORT,24E14215,06/19/2024,Sale,-90.0,1350.0,4,EARLY SWEET,Bag
VIDEXPORT,24E14215,06/19/2024,Sale,-1350.0,0.0,4,EARLY SWEET,Bag
VIDEXPORT,24E14216,06/15/2024,Entry,2160.0,2160.0,0,EARLY SWEET,Bag
VIDEXPORT,24E14216,06/17/2024,Sale,-360.0,1800.0,2,EARLY SWEET,Bag
VIDEXPORT,24E14216,06/17/2024,Sale,-450.0,1350.0,2,EARLY SWEET,Bag
VIDEXPORT,24E14216,06/17/2024,Sale,-810.0,540.0,2,EARLY SWEET,Bag
VIDEXPORT,24E14216,06/18/2024,Sale,-180.0,360.0,3,EARLY SWEET,Bag
VIDEXPORT,24E14216,06/18/2024,Sale,-90.0,270.0,3,EARLY SWEET,Bag
VIDEXPORT,24E14216,06/18/2024,Sale,-270.0,0.0,3,EARLY SWEET,Bag
VIDEXPORT,24E14217,06/15/2024,Entry,2160.0,2160.0,0,EARLY SWEET,Bag
VIDEXPORT,24E14217,06/17/2024,Sale,-90.0,2070.0,2,EARLY SWEET,Bag
VIDEXPORT,24E14217,06/17/2024,Sale,-360.0,1710.0,2,EARLY SWEET,Bag
VIDEXPORT,24E14217,06/20/2024,Sale,-90.0,1620.0,5,EARLY SWEET,Bag
VIDEXPORT,24E14217,06/20/2024,Sale,-180.0,1440.0,5,EARLY SWEET,Bag
VIDEXPORT,24E14217,06/21/2024,Sale,-360.0,1080.0,6,EARLY SWEET,Bag
VIDEXPORT,24E14217,06/26/2024,Sale,-990.0,90.0,11,EARLY SWEET,Bag
VIDEXPORT,24E14218,06/15/2024,Entry,2160.0,2160.0,0,EARLY SWEET,Bag
VIDEXPORT,24E14218,06/18/2024,Sale,-90.0,2070.0,3,EARLY SWEET,Bag
VIDEXPORT,24E14218,06/18/2024,Sale,-90.0,1980.0,3,EARLY SWEET,Bag
VIDEXPORT,24E14218,06/20/2024,Sale,-360.0,1620.0,5,EARLY SWEET,Bag
VIDEXPORT,24E14218,06/20/2024,Sale,-540.0,1080.0,5,EARLY SWEET,Bag
VIDEXPORT,24E14218,06/20/2024,Sale,-990.0,90.0,5,EARLY SWEET,Bag
VIDEXPORT,24E14218,06/20/2024,Sale,-90.0,0.0,5,EARLY SWEET,Bag
VIDEXPORT,24E14219,06/15/2024,Entry,2160.0,2160.0,0,EARLY SWEET,Bag
VIDEXPORT,24E14219,06/18/2024,Sale,-180.0,1980.0,3,EARLY SWEET,Bag
VIDEXPORT,24E14219,06/18/2024,Sale,-270.0,1710.0,3,EARLY SWEET,Bag
VIDEXPORT,24E14219,06/22/2024,Sale,-990.0,720.0,7,EARLY SWEET,Bag
VIDEXPORT,24E14219,06/28/2024,Sale,-180.0,540.0,13,EARLY SWEET,Bag
VIDEXPORT,24E14220,06/17/2024,Entry,1700.0,1700.0,0,SUGAR DROP,Bag
VIDEXPORT,24E14220,06/17/2024,Sale,-1190.0,510.0,0,SUGAR DROP,Bag
VIDEXPORT,24E14220,06/18/2024,Sale,-510.0,0.0,1,SUGAR DROP,Bag
VIDEXPORT,24E14221,06/15/2024,Entry,2160.0,2160.0,0,EARLY SWEET,Bag
VIDEXPORT,24E14221,06/17/2024,Sale,-360.0,1800.0,2,EARLY SWEET,Bag
VIDEXPORT,24E14221,06/18/2024,Sale,-630.0,1170.0,3,EARLY SWEET,Bag
VIDEXPORT,24E14221,06/20/2024,Sale,-90.0,1080.0,5,EARLY SWEET,Bag
VIDEXPORT,24E14221,06/21/2024,Sale,-540.0,540.0,6,EARLY SWEET,Bag
VIDEXPORT,24E14221,06/27/2024,Sale,-540.0,0.0,12,EARLY SWEET,Bag
VIDEXPORT,24E14222,06/15/2024,Entry,2210.0,2210.0,0,SUGAR DROP,Bag
VIDEXPORT,24E14222,06/17/2024,Sale,-340.0,1870.0,2,SUGAR DROP,Bag
VIDEXPORT,24E14222,06/18/2024,Sale,-170.0,1700.0,3,SUGAR DROP,Bag
VIDEXPORT,24E14222,06/18/2024,Sale,-1615.0,85.0,3,SUGAR DROP,Bag
VIDEXPORT,24E14222,06/20/2024,Sale,-85.0,0.0,5,SUGAR DROP,Bag
VIDEXPORT,24E14223,06/15/2024,Entry,2210.0,2210.0,0,SUGAR DROP,Bag
VIDEXPORT,24E14223,06/17/2024,Sale,-595.0,1615.0,2,SUGAR DROP,Bag
VIDEXPORT,24E14223,06/17/2024,Sale,-1190.0,425.0,2,SUGAR DROP,Bag
VIDEXPORT,24E14223,06/17/2024,Sale,-425.0,0.0,2,SUGAR DROP,Bag
VIDEXPORT,24E14224,06/15/2024,Entry,1980.0,1980.0,0,EARLY SWEET,Bag
VIDEXPORT,24E14224,06/15/2024,Sale,-630.0,1350.0,0,EARLY SWEET,Bag
VIDEXPORT,24E14224,06/18/2024,Sale,-90.0,1260.0,3,EARLY SWEET,Bag
VIDEXPORT,24E14224,06/18/2024,Sale,-190.0,1070.0,3,EARLY SWEET,Bag
VIDEXPORT,24E14224,06/18/2024,Sale,-170.0,900.0,3,EARLY SWEET,Bag
VIDEXPORT,24E14224,06/20/2024,Sale,-810.0,90.0,5,EARLY SWEET,Bag
VIDEXPORT,24E14224,07/15/2024,Sale,-90.0,0.0,30,EARLY SWEET,Bag
VIDEXPORT,24E14225,06/15/2024,Entry,1700.0,1700.0,0,SUGAR DROP,Bag
VIDEXPORT,24E14225,06/15/2024,Sale,-1700.0,0.0,0,SUGAR DROP,Bag
VIDEXPORT,24E14226,06/15/2024,Entry,2340.0,2340.0,0,EARLY SWEET,Bag
VIDEXPORT,24E14226,06/17/2024,Sale,-180.0,2160.0,2,EARLY SWEET,Bag
VIDEXPORT,24E14226,06/18/2024,Sale,-270.0,1890.0,3,EARLY SWEET,Bag
VIDEXPORT,24E14226,06/18/2024,Sale,-990.0,900.0,3,EARLY SWEET,Bag
VIDEXPORT,24E14226,06/19/2024,Sale,-180.0,720.0,4,EARLY SWEET,Bag
VIDEXPORT,24E14226,06/20/2024,Sale,-630.0,90.0,5,EARLY SWEET,Bag
VIDEXPORT,24E14226,06/21/2024,Sale,-90.0,0.0,6,EARLY SWEET,Bag
VIDEXPORT,24E14227,06/17/2024,Entry,2210.0,2210.0,0,SUGAR DROP,Bag
VIDEXPORT,24E14227,06/19/2024,Sale,-1615.0,595.0,2,SUGAR DROP,Bag
VIDEXPORT,24E14227,06/19/2024,Sale,-595.0,0.0,2,SUGAR DROP,Bag
VIDEXPORT,24E14228,06/17/2024,Entry,2160.0,2160.0,0,EARLY SWEET,Bag
VIDEXPORT,24E14228,06/19/2024,Sale,-1260.0,900.0,2,EARLY SWEET,Bag
VIDEXPORT,24E14228,06/21/2024,Sale,-900.0,0.0,4,EARLY SWEET,Bag
VIDEXPORT,24E14230,06/15/2024,Entry,1800.0,1800.0,0,EARLY SWEET,Bag
VIDEXPORT,24E14230,06/18/2024,Sale,-90.0,1710.0,3,EARLY SWEET,Bag
VIDEXPORT,24E14230,06/20/2024,Sale,-180.0,1530.0,5,EARLY SWEET,Bag
VIDEXPORT,24E14230,06/20/2024,Sale,-360.0,1170.0,5,EARLY SWEET,Bag
VIDEXPORT,24E14230,06/20/2024,Sale,-90.0,1080.0,5,EARLY SWEET,Bag
VIDEXPORT,24E14230,06/21/2024,Sale,-1080.0,0.0,6,EARLY SWEET,Bag
VIDEXPORT,24E14232,06/15/2024,Entry,1890.0,1890.0,0,EARLY SWEET,Bag
VIDEXPORT,24E14232,06/18/2024,Sale,-450.0,1440.0,3,EARLY SWEET,Bag
VIDEXPORT,24E14232,06/20/2024,Sale,-360.0,1080.0,5,EARLY SWEET,Bag
VIDEXPORT,24E14232,06/20/2024,Sale,-270.0,810.0,5,EARLY SWEET,Bag
VIDEXPORT,24E14232,06/20/2024,Sale,-90.0,720.0,5,EARLY SWEET,Bag
VIDEXPORT,24E14232,06/20/2024,Sale,-90.0,630.0,5,EARLY SWEET,Bag
VIDEXPORT,24E14232,06/20/2024,Sale,-90.0,540.0,5,EARLY SWEET,Bag
VIDEXPORT,24E14232,06/21/2024,Sale,-540.0,0.0,6,EARLY SWEET,Bag
VIDEXPORT,24E14233,06/15/2024,Entry,1870.0,1870.0,0,SUGAR DROP,Bag
VIDEXPORT,24E14233,06/18/2024,Sale,-935.0,935.0,3,SUGAR DROP,Bag
VIDEXPORT,24E14233,06/21/2024,Sale,-170.0,765.0,6,SUGAR DROP,Bag
VIDEXPORT,24E14233,06/21/2024,Sale,-510.0,255.0,6,SUGAR DROP,Bag
VIDEXPORT,24E14233,06/24/2024,Sale,-85.0,170.0,9,SUGAR DROP,Bag
VIDEXPORT,24E14233,06/24/2024,Sale,-85.0,85.0,9,SUGAR DROP,Bag
VIDEXPORT,24E14233,06/24/2024,Sale,-85.0,0.0,9,SUGAR DROP,Bag
VIDEXPORT,24E14234,06/15/2024,Entry,2210.0,2210.0,0,SUGAR DROP,Bag
VIDEXPORT,24E14234,06/15/2024,Sale,-170.0,2040.0,0,SUGAR DROP,Bag
VIDEXPORT,24E14234,06/15/2024,Sale,-170.0,1870.0,0,SUGAR DROP,Bag
VIDEXPORT,24E14234,06/17/2024,Sale,-170.0,1700.0,2,SUGAR DROP,Bag
VIDEXPORT,24E14234,06/18/2024,Sale,-170.0,1530.0,3,SUGAR DROP,Bag
VIDEXPORT,24E14234,06/18/2024,Sale,-765.0,765.0,3,SUGAR DROP,Bag
VIDEXPORT,24E14234,06/18/2024,Sale,-255.0,510.0,3,SUGAR DROP,Bag
VIDEXPORT,24E14234,06/19/2024,Sale,-340.0,170.0,4,SUGAR DROP,Bag
VIDEXPORT,24E14234,06/19/2024,Sale,-170.0,0.0,4,SUGAR DROP,Bag
VIDEXPORT,24E14235,06/15/2024,Entry,2210.0,2210.0,0,SUGAR DROP,Bag
VIDEXPORT,24E14235,06/20/2024,Sale,-85.0,2125.0,5,SUGAR DROP,Bag
VIDEXPORT,24E14235,06/21/2024,Sale,-340.0,1785.0,6,SUGAR DROP,Bag
VIDEXPORT,24E14235,06/24/2024,Sale,-85.0,1700.0,9,SUGAR DROP,Bag
VIDEXPORT,24E14235,06/25/2024,Sale,-1105.0,595.0,10,SUGAR DROP,Bag
VIDEXPORT,24E14235,06/25/2024,Sale,-255.0,340.0,10,SUGAR DROP,Bag
VIDEXPORT,24E14235,06/26/2024,Sale,-170.0,170.0,11,SUGAR DROP,Bag
VIDEXPORT,24E14235,07/12/2024,Sale,-170.0,0.0,27,SUGAR DROP,Bag
VIDEXPORT,24E14236,06/15/2024,Entry,2040.0,2040.0,0,SUGAR DROP,Bag
VIDEXPORT,24E14236,06/20/2024,Sale,-1870.0,170.0,5,SUGAR DROP,Bag
VIDEXPORT,24E14236,06/21/2024,Sale,-170.0,0.0,6,SUGAR DROP,Bag
VIDEXPORT,24E14237,06/15/2024,Entry,2040.0,2040.0,0,SUGAR DROP,Bag
VIDEXPORT,24E14237,06/18/2024,Sale,-680.0,1360.0,3,SUGAR DROP,Bag
VIDEXPORT,24E14237,06/19/2024,Sale,-1360.0,0.0,4,SUGAR DROP,Bag
VIDEXPORT,24E14238,06/15/2024,Entry,1870.0,1870.0,0,SUGAR DROP,Bag
VIDEXPORT,24E14238,06/24/2024,Sale,-1190.0,680.0,9,SUGAR DROP,Bag
VIDEXPORT,24E14238,06/24/2024,Sale,-680.0,0.0,9,SUGAR DROP,Bag
VIDEXPORT,24E14240,06/15/2024,Entry,1785.0,1785.0,0,SUGAR DROP,Bag
VIDEXPORT,24E14240,06/15/2024,Entry,85.0,1870.0,0,SUGAR DROP,Bag
VIDEXPORT,24E14240,06/17/2024,Sale,-85.0,1785.0,2,SUGAR DROP,Bag
VIDEXPORT,24E14240,06/17/2024,Sale,-850.0,935.0,2,SUGAR DROP,Bag
VIDEXPORT,24E14240,06/18/2024,Sale,-765.0,170.0,3,SUGAR DROP,Bag
VIDEXPORT,24E14240,06/19/2024,Sale,-85.0,85.0,4,SUGAR DROP,Bag
VIDEXPORT,24E14240,06/24/2024,Sale,-85.0,0.0,9,SUGAR DROP,Bag
VIDEXPORT,24E14244,06/17/2024,Entry,2160.0,2160.0,0,EARLY SWEET,Bag
VIDEXPORT,24E14244,06/17/2024,Sale,-360.0,1800.0,0,EARLY SWEET,Bag
VIDEXPORT,24E14244,06/18/2024,Sale,-360.0,1440.0,1,EARLY SWEET,Bag
VIDEXPORT,24E14244,06/20/2024,Sale,-90.0,1350.0,3,EARLY SWEET,Bag
VIDEXPORT,24E14244,06/20/2024,Sale,-180.0,1170.0,3,EARLY SWEET,Bag
VIDEXPORT,24E14244,06/21/2024,Sale,-990.0,180.0,4,EARLY SWEET,Bag
VIDEXPORT,24E14244,06/28/2024,Sale,-180.0,0.0,11,EARLY SWEET,Bag
VIDEXPORT,24E14245,06/17/2024,Entry,2340.0,2340.0,0,EARLY SWEET,Bag
VIDEXPORT,24E14245,06/17/2024,Sale,-180.0,2160.0,0,EARLY SWEET,Bag
VIDEXPORT,24E14245,06/18/2024,Sale,-270.0,1890.0,1,EARLY SWEET,Bag
VIDEXPORT,24E14245,06/19/2024,Sale,-720.0,1170.0,2,EARLY SWEET,Bag
VIDEXPORT,24E14245,06/19/2024,Sale,-360.0,810.0,2,EARLY SWEET,Bag
VIDEXPORT,24E14245,06/20/2024,Sale,-630.0,180.0,3,EARLY SWEET,Bag
VIDEXPORT,24E14245,06/20/2024,Sale,-180.0,0.0,3,EARLY SWEET,Bag
VIDEXPORT,24E14246,06/17/2024,Entry,2340.0,2340.0,0,EARLY SWEET,Bag
VIDEXPORT,24E14246,06/20/2024,Sale,-1800.0,540.0,3,EARLY SWEET,Bag
VIDEXPORT,24E14246,06/20/2024,Sale,-180.0,360.0,3,EARLY SWEET,Bag
VIDEXPORT,24E14246,06/21/2024,Sale,-360.0,0.0,4,EARLY SWEET,Bag
VIDEXPORT,24E14247,06/17/2024,Entry,2340.0,2340.0,0,EARLY SWEET,Bag
VIDEXPORT,24E14247,06/18/2024,Sale,-540.0,1800.0,1,EARLY SWEET,Bag
VIDEXPORT,24E14247,06/19/2024,Sale,-1620.0,180.0,2,EARLY SWEET,Bag
VIDEXPORT,24E14247,06/20/2024,Sale,-90.0,90.0,3,EARLY SWEET,Bag
VIDEXPORT,24E14247,06/21/2024,Sale,-90.0,0.0,4,EARLY SWEET,Bag
VIDEXPORT,24E14248,06/17/2024,Entry,2340.0,2340.0,0,EARLY SWEET,Bag
VIDEXPORT,24E14248,06/28/2024,Sale,-450.0,1890.0,11,EARLY SWEET,Bag
VIDEXPORT,24E14248,06/29/2024,Sale,-270.0,1620.0,12,EARLY SWEET,Bag
VIDEXPORT,24E14248,07/10/2024,Sale,-1620.0,0.0,23,EARLY SWEET,Bag
VIDEXPORT,24E14249,06/17/2024,Entry,2340.0,2340.0,0,EARLY SWEET,Bag
VIDEXPORT,24E14249,06/18/2024,Sale,-90.0,2250.0,1,EARLY SWEET,Bag
VIDEXPORT,24E14249,06/21/2024,Sale,-90.0,2160.0,4,EARLY SWEET,Bag
VIDEXPORT,24E14249,06/27/2024,Sale,-270.0,1890.0,10,EARLY SWEET,Bag
VIDEXPORT,24E14249,06/27/2024,Sale,-180.0,1710.0,10,EARLY SWEET,Bag
VIDEXPORT,24E14249,06/27/2024,Sale,-90.0,1620.0,10,EARLY SWEET,Bag
VIDEXPORT,24E14249,06/27/2024,Sale,-990.0,630.0,10,EARLY SWEET,Bag
VIDEXPORT,24E14249,06/29/2024,Sale,-360.0,270.0,12,EARLY SWEET,Bag
VIDEXPORT,24E14250,06/18/2024,Entry,2210.0,2210.0,0,SUGAR DROP,Bag
VIDEXPORT,24E14250,06/20/2024,Sale,-85.0,2125.0,2,SUGAR DROP,Bag
VIDEXPORT,24E14250,06/20/2024,Sale,-765.0,1360.0,2,SUGAR DROP,Bag
VIDEXPORT,24E14250,06/20/2024,Sale,-340.0,1020.0,2,SUGAR DROP,Bag
VIDEXPORT,24E14250,06/20/2024,Sale,-510.0,510.0,2,SUGAR DROP,Bag
VIDEXPORT,24E14250,06/21/2024,Sale,-425.0,85.0,3,SUGAR DROP,Bag
VIDEXPORT,24E14250,06/21/2024,Sale,-85.0,0.0,3,SUGAR DROP,Bag
VIDEXPORT,24E14251,06/17/2024,Entry,2340.0,2340.0,0,EARLY SWEET,Bag
VIDEXPORT,24E14251,06/18/2024,Sale,-990.0,1350.0,1,EARLY SWEET,Bag
VIDEXPORT,24E14251,06/18/2024,Sale,-1170.0,180.0,1,EARLY SWEET,Bag
VIDEXPORT,24E14251,06/20/2024,Sale,-180.0,0.0,3,EARLY SWEET,Bag
VIDEXPORT,24E14252,06/17/2024,Entry,1975.0,1975.0,0,EARLY SWEET,Bag
VIDEXPORT,24E14252,06/22/2024,Sale,-900.0,1075.0,5,EARLY SWEET,Bag
VIDEXPORT,24E14252,06/24/2024,Sale,-900.0,175.0,7,EARLY SWEET,Bag
VIDEXPORT,24E14252,07/17/2024,Sale,-85.0,90.0,30,EARLY SWEET,Bag
VIDEXPORT,24E14253,06/17/2024,Entry,1920.0,1920.0,0,SUGAR DROP,Clam
VIDEXPORT,24E14253,06/18/2024,Sale,-480.0,1440.0,1,SUGAR DROP,Clam
VIDEXPORT,24E14253,06/18/2024,Sale,-880.0,560.0,1,SUGAR DROP,Clam
VIDEXPORT,24E14253,06/21/2024,Sale,-560.0,0.0,4,SUGAR DROP,Clam
VIDEXPORT,24E14255,06/17/2024,Entry,1920.0,1920.0,0,PASSION FIRE,Clam
VIDEXPORT,24E14255,06/29/2024,Sale,-1200.0,720.0,12,PASSION FIRE,Clam
VIDEXPORT,24E14255,07/12/2024,Sale,-450.0,270.0,25,PASSION FIRE,Bag
VIDEXPORT,24E14255,07/16/2024,Sale,-90.0,180.0,29,PASSION FIRE,Bag
VIDEXPORT,24E14257,06/17/2024,Entry,1760.0,1760.0,0,SUGAR DROP,Clam
VIDEXPORT,24E14257,06/17/2024,Sale,-880.0,880.0,0,SUGAR DROP,Clam
VIDEXPORT,24E14257,06/18/2024,Sale,-800.0,80.0,1,SUGAR DROP,Clam
VIDEXPORT,24E14257,06/21/2024,Sale,-80.0,0.0,4,SUGAR DROP,Clam
VIDEXPORT,24E14259,06/17/2024,Entry,2040.0,2040.0,0,SUGAR DROP,Bag
VIDEXPORT,24E14259,06/19/2024,Sale,-850.0,1190.0,2,SUGAR DROP,Bag
VIDEXPORT,24E14259,06/21/2024,Sale,-510.0,680.0,4,SUGAR DROP,Bag
VIDEXPORT,24E14259,06/22/2024,Sale,-425.0,255.0,5,SUGAR DROP,Bag
VIDEXPORT,24E14259,06/22/2024,Sale,-255.0,0.0,5,SUGAR DROP,Bag
VIDEXPORT,24E14260,06/17/2024,Entry,2340.0,2340.0,0,SUGAR DROP,Bag
VIDEXPORT,24E14260,06/21/2024,Sale,-270.0,2070.0,4,SUGAR DROP,Bag
VIDEXPORT,24E14260,06/21/2024,Sale,-1980.0,90.0,4,SUGAR DROP,Bag
VIDEXPORT,24E14260,06/21/2024,Sale,-90.0,0.0,4,SUGAR DROP,Bag
VIDEXPORT,24E14262,06/17/2024,Entry,2210.0,2210.0,0,SUGAR DROP,Bag
VIDEXPORT,24E14262,06/20/2024,Sale,-255.0,1955.0,3,SUGAR DROP,Bag
VIDEXPORT,24E14262,06/21/2024,Sale,-170.0,1785.0,4,SUGAR DROP,Bag
VIDEXPORT,24E14262,06/22/2024,Sale,-935.0,850.0,5,SUGAR DROP,Bag
VIDEXPORT,24E14262,06/27/2024,Sale,-850.0,0.0,10,SUGAR DROP,Bag
VIDEXPORT,24E14263,06/17/2024,Entry,1955.0,1955.0,0,SUGAR DROP,Bag
VIDEXPORT,24E14263,06/17/2024,Sale,-1955.0,0.0,0,SUGAR DROP,Bag
VIDEXPORT,24E14264,06/17/2024,Entry,1740.0,1740.0,0,SUGAR DROP,Bag
VIDEXPORT,24E14264,06/19/2024,Sale,-1740.0,0.0,2,SUGAR DROP,Bag
VIDEXPORT,24E14265,06/17/2024,Entry,1980.0,1980.0,0,EARLY SWEET,Bag
VIDEXPORT,24E14265,06/27/2024,Sale,-1980.0,0.0,10,EARLY SWEET,Bag
VIDEXPORT,24E14266,06/17/2024,Entry,1980.0,1980.0,0,EARLY SWEET,Bag
VIDEXPORT,24E14266,06/17/2024,Sale,-1980.0,0.0,0,EARLY SWEET,Bag
VIDEXPORT,24E14267,06/17/2024,Entry,1920.0,1920.0,0,SUGAR DROP,Clam
VIDEXPORT,24E14267,06/17/2024,Sale,-1920.0,0.0,0,SUGAR DROP,Clam
VIDEXPORT,24E14268,06/17/2024,Entry,2340.0,2340.0,0,EARLY SWEET,Bag
VIDEXPORT,24E14268,06/18/2024,Sale,-1980.0,360.0,1,EARLY SWEET,Bag
VIDEXPORT,24E14268,06/20/2024,Sale,-90.0,270.0,3,EARLY SWEET,Bag
VIDEXPORT,24E14268,06/20/2024,Sale,-90.0,180.0,3,EARLY SWEET,Bag
VIDEXPORT,24E14269,06/17/2024,Entry,2040.0,2040.0,0,SUGAR DROP,Bag
VIDEXPORT,24E14269,06/21/2024,Sale,-935.0,1105.0,4,SUGAR DROP,Bag
VIDEXPORT,24E14269,06/22/2024,Sale,-425.0,680.0,5,SUGAR DROP,Bag
VIDEXPORT,24E14269,06/28/2024,Sale,-680.0,0.0,11,SUGAR DROP,Bag
VIDEXPORT,24E14270,06/17/2024,Entry,2037.0,2037.0,0,PASSION FIRE,Bag
VIDEXPORT,24E14270,06/20/2024,Sale,-935.0,1102.0,3,PASSION FIRE,Bag
VIDEXPORT,24E14270,06/21/2024,Sale,-255.0,847.0,4,PASSION FIRE,Bag
VIDEXPORT,24E14270,06/24/2024,Sale,-765.0,82.0,7,PASSION FIRE,Bag
VIDEXPORT,24E14270,06/27/2024,Sale,-82.0,0.0,10,PASSION FIRE,Bag
VIDEXPORT,24E14272,06/18/2024,Entry,1870.0,1870.0,0,SUGAR DROP,Bag
VIDEXPORT,24E14272,06/27/2024,Sale,-765.0,1105.0,9,SUGAR DROP,Bag
VIDEXPORT,24E14272,06/28/2024,Sale,-510.0,595.0,10,SUGAR DROP,Bag
VIDEXPORT,24E14272,07/12/2024,Sale,-595.0,0.0,24,SUGAR DROP,Bag
VIDEXPORT,24E14273,06/18/2024,Entry,2120.0,2120.0,0,SUGAR DROP,Bag
VIDEXPORT,24E14273,06/19/2024,Sale,-170.0,1950.0,1,SUGAR DROP,Bag
VIDEXPORT,24E14273,06/19/2024,Sale,-890.0,1060.0,1,SUGAR DROP,Bag
VIDEXPORT,24E14273,06/19/2024,Sale,-90.0,970.0,1,SUGAR DROP,Bag
VIDEXPORT,24E14273,06/19/2024,Sale,-885.0,85.0,1,SUGAR DROP,Bag
VIDEXPORT,24E14273,06/21/2024,Sale,-85.0,0.0,3,SUGAR DROP,Bag
VIDEXPORT,24E14274,06/18/2024,Entry,90.0,90.0,0,EARLY SWEET,Bag
VIDEXPORT,24E14274,06/18/2024,Entry,1710.0,1800.0,0,EARLY SWEET,Bag
VIDEXPORT,24E14274,06/26/2024,Sale,-360.0,1440.0,8,EARLY SWEET,Bag
VIDEXPORT,24E14274,07/15/2024,Sale,-90.0,1350.0,27,EARLY SWEET,Bag
VIDEXPORT,24E14274,07/15/2024,Sale,-990.0,360.0,27,EARLY SWEET,Bag
VIDEXPORT,24E14274,07/23/2024,Sale,-360.0,0.0,35,EARLY SWEET,Bag
VIDEXPORT,24E14275,06/17/2024,Entry,610.0,610.0,0,PASSION FIRE,Clam
VIDEXPORT,24E14275,06/17/2024,Entry,1040.0,1650.0,0,PASSION FIRE,Clam
VIDEXPORT,24E14275,06/22/2024,Sale,-955.0,695.0,5,PASSION FIRE,Clam
VIDEXPORT,24E14275,06/22/2024,Sale,-5.0,690.0,5,PASSION FIRE,Clam
VIDEXPORT,24E14275,06/28/2024,Sale,-435.0,255.0,11,PASSION FIRE,Bag
VIDEXPORT,24E14275,07/10/2024,Sale,-170.0,85.0,23,PASSION FIRE,Bag
VIDEXPORT,24E14275,07/19/2024,Sale,-5.0,80.0,32,PASSION FIRE,Bag
VIDEXPORT,24E14275,07/19/2024,Sale,-80.0,0.0,32,PASSION FIRE,Clam
VIDEXPORT,24E14276,06/18/2024,Entry,255.0,255.0,0,SUGAR DROP,Bag
VIDEXPORT,24E14276,06/18/2024,Entry,1615.0,1870.0,0,SUGAR DROP,Bag
VIDEXPORT,24E14276,06/25/2024,Sale,-170.0,1700.0,7,SUGAR DROP,Bag
VIDEXPORT,24E14276,06/26/2024,Sale,-85.0,1615.0,8,SUGAR DROP,Bag
VIDEXPORT,24E14276,06/27/2024,Sale,-935.0,680.0,9,SUGAR DROP,Bag
VIDEXPORT,24E14276,07/02/2024,Sale,-245.0,435.0,14,SUGAR DROP,Bag
VIDEXPORT,24E14276,07/12/2024,Sale,-255.0,180.0,24,SUGAR DROP,Bag
VIDEXPORT,24E14276,07/12/2024,Sale,-180.0,0.0,24,SUGAR DROP,Bag
VIDEXPORT,24E14277,06/18/2024,Entry,1920.0,1920.0,0,SUGAR DROP,Clam
VIDEXPORT,24E14277,06/21/2024,Sale,-240.0,1680.0,3,SUGAR DROP,Clam
VIDEXPORT,24E14277,06/21/2024,Sale,-1600.0,80.0,3,SUGAR DROP,Clam
VIDEXPORT,24E14277,06/22/2024,Sale,-80.0,0.0,4,SUGAR DROP,Clam
VIDEXPORT,24E14278,06/18/2024,Entry,795.0,795.0,0,PASSION FIRE,Bag
VIDEXPORT,24E14278,06/18/2024,Entry,80.0,875.0,0,PASSION FIRE,Bag
VIDEXPORT,24E14278,06/18/2024,Entry,425.0,1300.0,0,SUGAR DROP,Bag
VIDEXPORT,24E14278,06/18/2024,Entry,560.0,1860.0,0,SUGAR DROP,Bag
VIDEXPORT,24E14278,06/19/2024,Sale,-170.0,1690.0,1,SUGAR DROP,Bag
VIDEXPORT,24E14278,06/20/2024,Sale,-85.0,1605.0,2,SUGAR DROP,Bag
VIDEXPORT,24E14278,06/21/2024,Sale,-170.0,1435.0,3,SUGAR DROP,Bag
VIDEXPORT,24E14278,06/24/2024,Sale,-710.0,725.0,6,PASSION FIRE,Bag
VIDEXPORT,24E14278,06/25/2024,Sale,-560.0,165.0,7,SUGAR DROP,Clam
VIDEXPORT,24E14278,06/27/2024,Sale,-85.0,80.0,9,PASSION FIRE,Bag
VIDEXPORT,24E14278,07/16/2024,Sale,-90.0,-10.0,28,PASSION FIRE,Bag
VIDEXPORT,24E14279,06/18/2024,Entry,1800.0,1800.0,0,EARLY SWEET,Bag
VIDEXPORT,24E14279,06/24/2024,Sale,-270.0,1530.0,6,EARLY SWEET,Bag
VIDEXPORT,24E14279,06/28/2024,Sale,-180.0,1350.0,10,EARLY SWEET,Bag
VIDEXPORT,24E14279,06/28/2024,Sale,-720.0,630.0,10,EARLY SWEET,Bag
VIDEXPORT,24E14279,06/28/2024,Sale,-360.0,270.0,10,EARLY SWEET,Bag
VIDEXPORT,24E14279,07/10/2024,Sale,-270.0,0.0,22,EARLY SWEET,Bag
VIDEXPORT,24E14280,06/18/2024,Entry,1075.0,1075.0,0,EARLY SWEET,Bag
VIDEXPORT,24E14280,06/18/2024,Entry,630.0,1705.0,0,EARLY SWEET,Bag
VIDEXPORT,24E14280,06/18/2024,Entry,90.0,1795.0,0,HONEY POP,Bag
VIDEXPORT,24E14280,06/18/2024,Sale,-630.0,1165.0,0,EARLY SWEET,Bag
VIDEXPORT,24E14280,06/22/2024,Sale,-90.0,1075.0,4,EARLY SWEET,Bag
VIDEXPORT,24E14280,07/12/2024,Sale,-900.0,175.0,24,EARLY SWEET,Bag
VIDEXPORT,24E14280,07/15/2024,Sale,-90.0,85.0,27,HONEY POP,Bag
VIDEXPORT,24E14280,07/17/2024,Sale,-85.0,0.0,29,EARLY SWEET,Bag
VIDEXPORT,24E14281,06/18/2024,Entry,2160.0,2160.0,0,EARLY SWEET,Bag
VIDEXPORT,24E14281,06/26/2024,Sale,-1980.0,180.0,8,EARLY SWEET,Bag
VIDEXPORT,24E14281,07/15/2024,Sale,-180.0,0.0,27,EARLY SWEET,Bag
VIDEXPORT,24E14282,06/18/2024,Entry,2160.0,2160.0,0,EARLY SWEET,Bag
VIDEXPORT,24E14282,06/29/2024,Sale,-810.0,1350.0,11,EARLY SWEET,Bag
VIDEXPORT,24E14282,06/29/2024,Sale,-270.0,1080.0,11,EARLY SWEET,Bag
VIDEXPORT,24E14282,07/02/2024,Sale,-90.0,990.0,14,EARLY SWEET,Bag
VIDEXPORT,24E14282,07/15/2024,Sale,-990.0,0.0,27,EARLY SWEET,Bag
VIDEXPORT,24E14283,06/18/2024,Entry,1920.0,1920.0,0,SUGAR DROP,Clam
VIDEXPORT,24E14283,06/18/2024,Sale,-1200.0,720.0,0,SUGAR DROP,Clam
VIDEXPORT,24E14283,06/21/2024,Sale,-720.0,0.0,3,SUGAR DROP,Clam
VIDEXPORT,24E14284,06/18/2024,Entry,2340.0,2340.0,0,EARLY SWEET,Bag
VIDEXPORT,24E14284,06/25/2024,Sale,-1080.0,1260.0,7,EARLY SWEET,Bag
VIDEXPORT,24E14284,06/25/2024,Sale,-1260.0,0.0,7,EARLY SWEET,Bag
VIDEXPORT,24E14285,06/19/2024,Entry,1710.0,1710.0,0,EARLY SWEET,Bag
VIDEXPORT,24E14285,06/26/2024,Sale,-270.0,1440.0,7,EARLY SWEET,Bag
VIDEXPORT,24E14285,07/23/2024,Sale,-1440.0,0.0,34,EARLY SWEET,Bag
VIDEXPORT,24E14286,06/19/2024,Entry,2155.0,2155.0,0,EARLY SWEET,Bag
VIDEXPORT,24E14286,06/21/2024,Sale,-990.0,1165.0,2,EARLY SWEET,Bag
VIDEXPORT,24E14286,06/24/2024,Sale,-450.0,715.0,5,EARLY SWEET,Bag
VIDEXPORT,24E14286,06/24/2024,Sale,-180.0,535.0,5,EARLY SWEET,Bag
VIDEXPORT,24E14286,06/24/2024,Sale,-90.0,445.0,5,EARLY SWEET,Bag
VIDEXPORT,24E14286,07/11/2024,Sale,-300.0,145.0,22,EARLY SWEET,Clam
VIDEXPORT,24E14286,07/12/2024,Sale,-85.0,60.0,23,EARLY SWEET,Bag
VIDEXPORT,24E14286,07/17/2024,Sale,-42.0,18.0,28,EARLY SWEET,Bag
VIDEXPORT,24E14287,06/17/2024,Entry,2340.0,2340.0,0,SUGAR DROP,Bag
VIDEXPORT,24E14287,06/29/2024,Sale,-900.0,1440.0,12,SUGAR DROP,Bag
VIDEXPORT,24E14287,06/29/2024,Sale,-900.0,540.0,12,SUGAR DROP,Bag
VIDEXPORT,24E14287,07/23/2024,Sale,-540.0,0.0,36,SUGAR DROP,Bag
VIDEXPORT,24E14288,06/18/2024,Entry,1800.0,1800.0,0,SUGAR DROP,Bag
VIDEXPORT,24E14288,06/21/2024,Sale,-375.0,1425.0,3,SUGAR DROP,Bag
VIDEXPORT,24E14288,06/22/2024,Sale,-750.0,675.0,4,SUGAR DROP,Bag
VIDEXPORT,24E14288,06/25/2024,Sale,-150.0,525.0,7,SUGAR DROP,Bag
VIDEXPORT,24E14288,06/26/2024,Sale,-525.0,0.0,8,SUGAR DROP,Bag
VIDEXPORT,24E14289,06/18/2024,Entry,2250.0,2250.0,0,EARLY SWEET,Clam
VIDEXPORT,24E14289,06/24/2024,Sale,-300.0,1950.0,6,EARLY SWEET,Clam
VIDEXPORT,24E14289,06/26/2024,Sale,-1710.0,240.0,8,EARLY SWEET,Bag
VIDEXPORT,24E14291,06/18/2024,Entry,2000.0,2000.0,0,SUGAR DROP,Clam
VIDEXPORT,24E14291,06/22/2024,Sale,-1520.0,480.0,4,SUGAR DROP,Clam
VIDEXPORT,24E14291,06/25/2024,Sale,-480.0,0.0,7,SUGAR DROP,Clam
VIDEXPORT,24E14292,06/18/2024,Entry,2040.0,2040.0,0,PASSION FIRE,Bag
VIDEXPORT,24E14292,06/27/2024,Sale,-1530.0,510.0,9,PASSION FIRE,Bag
VIDEXPORT,24E14292,06/27/2024,Sale,-510.0,0.0,9,PASSION FIRE,Bag
VIDEXPORT,24E14293,06/17/2024,Entry,2340.0,2340.0,0,SUGAR DROP,Bag
VIDEXPORT,24E14293,07/18/2024,Sale,-1080.0,1260.0,31,SUGAR DROP,Bag
VIDEXPORT,24E14293,07/23/2024,Sale,-540.0,720.0,36,SUGAR DROP,Bag
VIDEXPORT,24E14293,07/29/2024,Sale,-307.0,413.0,42,SUGAR DROP,Bag
VIDEXPORT,24E14293,07/30/2024,Sale,-413.0,0.0,43,SUGAR DROP,Bag
VIDEXPORT,24E14294,06/18/2024,Entry,630.0,630.0,0,SUGAR DROP,Bag
VIDEXPORT,24E14294,06/18/2024,Entry,1575.0,2205.0,0,SUGAR DROP,Bag
VIDEXPORT,24E14294,06/20/2024,Sale,-630.0,1575.0,2,SUGAR DROP,Bag
VIDEXPORT,24E14294,06/21/2024,Sale,-450.0,1125.0,3,SUGAR DROP,Bag
VIDEXPORT,24E14294,06/21/2024,Sale,-375.0,750.0,3,SUGAR DROP,Bag
VIDEXPORT,24E14294,06/22/2024,Sale,-450.0,300.0,4,SUGAR DROP,Bag
VIDEXPORT,24E14294,06/22/2024,Sale,-300.0,0.0,4,SUGAR DROP,Bag
VIDEXPORT,24E14295,06/18/2024,Entry,2340.0,2340.0,0,EARLY SWEET,Bag
VIDEXPORT,24E14295,06/19/2024,Sale,-180.0,2160.0,1,EARLY SWEET,Bag
VIDEXPORT,24E14295,06/21/2024,Sale,-1890.0,270.0,3,EARLY SWEET,Bag
VIDEXPORT,24E14295,06/24/2024,Sale,-270.0,0.0,6,EARLY SWEET,Bag
VIDEXPORT,24E14296,06/17/2024,Entry,2520.0,2520.0,0,PASSION FIRE,Bag
VIDEXPORT,24E14296,06/22/2024,Sale,-630.0,1890.0,5,PASSION FIRE,Bag
VIDEXPORT,24E14296,06/22/2024,Sale,-810.0,1080.0,5,PASSION FIRE,Bag
VIDEXPORT,24E14296,06/22/2024,Sale,-720.0,360.0,5,PASSION FIRE,Bag
VIDEXPORT,24E14296,06/25/2024,Sale,-270.0,90.0,8,PASSION FIRE,Bag
VIDEXPORT,24E14296,07/10/2024,Sale,-90.0,0.0,23,PASSION FIRE,Bag
VIDEXPORT,24E14297,06/18/2024,Entry,450.0,450.0,0,PASSION FIRE,Bag
VIDEXPORT,24E14297,06/18/2024,Entry,1275.0,1725.0,0,SUGAR DROP,Bag
VIDEXPORT,24E14297,06/24/2024,Sale,-450.0,1275.0,6,PASSION FIRE,Bag
VIDEXPORT,24E14297,06/25/2024,Sale,-75.0,1200.0,7,SUGAR DROP,Unknown
VIDEXPORT,24E14297,06/27/2024,Sale,-75.0,1125.0,9,SUGAR DROP,Unknown
VIDEXPORT,24E14297,06/28/2024,Sale,-150.0,975.0,10,SUGAR DROP,Unknown
VIDEXPORT,24E14297,06/28/2024,Sale,-150.0,825.0,10,SUGAR DROP,Unknown
VIDEXPORT,24E14297,06/29/2024,Sale,-75.0,750.0,11,SUGAR DROP,Unknown
VIDEXPORT,24E14297,07/01/2024,Sale,-75.0,675.0,13,SUGAR DROP,Unknown
VIDEXPORT,24E14297,07/01/2024,Sale,-75.0,600.0,13,SUGAR DROP,Unknown
VIDEXPORT,24E14297,07/01/2024,Sale,-150.0,450.0,13,SUGAR DROP,Unknown
VIDEXPORT,24E14297,07/02/2024,Sale,-75.0,375.0,14,SUGAR DROP,Unknown
VIDEXPORT,24E14297,07/02/2024,Sale,-75.0,300.0,14,SUGAR DROP,Unknown
VIDEXPORT,24E14297,07/02/2024,Sale,-75.0,225.0,14,SUGAR DROP,Unknown
VIDEXPORT,24E14297,07/03/2024,Sale,-150.0,75.0,15,SUGAR DROP,Unknown
VIDEXPORT,24E14297,07/05/2024,Sale,-75.0,0.0,17,SUGAR DROP,Unknown
VIDEXPORT,24E14298,06/17/2024,Entry,270.0,270.0,0,SUGAR DROP,Bag
VIDEXPORT,24E14298,06/17/2024,Entry,1350.0,1620.0,0,SUGAR DROP,Bag
VIDEXPORT,24E14298,06/29/2024,Sale,-270.0,1350.0,12,SUGAR DROP,Bag
VIDEXPORT,24E14298,06/29/2024,Sale,-990.0,360.0,12,SUGAR DROP,Bag
VIDEXPORT,24E14298,07/04/2024,Sale,-90.0,270.0,17,SUGAR DROP,Bag
VIDEXPORT,24E14298,07/23/2024,Sale,-180.0,90.0,36,SUGAR DROP,Bag
VIDEXPORT,24E14298,07/30/2024,Sale,-90.0,0.0,43,SUGAR DROP,Bag
VIDEXPORT,24E14300,06/18/2024,Entry,445.0,445.0,0,EARLY SWEET,Bag
VIDEXPORT,24E14300,06/18/2024,Entry,360.0,805.0,0,EARLY SWEET,Bag
VIDEXPORT,24E14300,06/18/2024,Entry,300.0,1105.0,0,EARLY SWEET,Bag
VIDEXPORT,24E14300,06/18/2024,Entry,510.0,1615.0,0,SUGAR DROP,Bag
VIDEXPORT,24E14300,06/20/2024,Sale,-180.0,1435.0,2,EARLY SWEET,Bag
VIDEXPORT,24E14300,06/21/2024,Sale,-300.0,1135.0,3,EARLY SWEET,Unknown
VIDEXPORT,24E14300,06/22/2024,Sale,-445.0,690.0,4,EARLY SWEET,Bag
VIDEXPORT,24E14300,06/22/2024,Sale,-255.0,435.0,4,SUGAR DROP,Bag
VIDEXPORT,24E14300,06/22/2024,Sale,-170.0,265.0,4,SUGAR DROP,Bag
VIDEXPORT,24E14300,07/02/2024,Sale,-85.0,180.0,14,SUGAR DROP,Bag
VIDEXPORT,24E14300,07/17/2024,Sale,-54.0,126.0,29,EARLY SWEET,Bag
VIDEXPORT,24E14302,06/20/2024,Entry,2160.0,2160.0,0,EARLY SWEET,Bag
VIDEXPORT,24E14302,06/28/2024,Sale,-90.0,2070.0,8,EARLY SWEET,Bag
VIDEXPORT,24E14302,06/28/2024,Sale,-180.0,1890.0,8,EARLY SWEET,Bag
VIDEXPORT,24E14302,06/28/2024,Sale,-90.0,1800.0,8,EARLY SWEET,Bag
VIDEXPORT,24E14302,07/02/2024,Sale,-810.0,990.0,12,EARLY SWEET,Bag
VIDEXPORT,24E14302,07/02/2024,Sale,-225.0,765.0,12,EARLY SWEET,Clam
VIDEXPORT,24E14302,07/05/2024,Sale,-360.0,405.0,15,EARLY SWEET,Bag
VIDEXPORT,24E14302,07/09/2024,Sale,-270.0,135.0,19,EARLY SWEET,Bag
VIDEXPORT,24E14302,07/17/2024,Sale,-227.0,-92.0,27,EARLY SWEET,Bag
VIDEXPORT,24E14303,06/20/2024,Entry,2160.0,2160.0,0,EARLY SWEET,Bag
VIDEXPORT,24E14303,07/01/2024,Sale,-1170.0,990.0,11,EARLY SWEET,Bag
VIDEXPORT,24E14303,07/03/2024,Sale,-990.0,0.0,13,EARLY SWEET,Bag
VIDEXPORT,24E14304,06/20/2024,Entry,2160.0,2160.0,0,EARLY SWEET,Bag
VIDEXPORT,24E14304,07/02/2024,Sale,-1170.0,990.0,12,EARLY SWEET,Bag
VIDEXPORT,24E14304,07/03/2024,Sale,-990.0,0.0,13,EARLY SWEET,Bag
VIDEXPORT,24E14305,06/19/2024,Entry,1530.0,1530.0,0,PASSION FIRE,Bag
VIDEXPORT,24E14305,06/19/2024,Entry,175.0,1705.0,0,SUGAR DROP,Bag
VIDEXPORT,24E14305,06/19/2024,Entry,350.0,2055.0,0,SUGAR DROP,Bag
VIDEXPORT,24E14305,06/21/2024,Sale,-85.0,1970.0,2,PASSION FIRE,Bag
VIDEXPORT,24E14305,06/21/2024,Sale,-175.0,1795.0,2,SUGAR DROP,Bag
VIDEXPORT,24E14305,06/28/2024,Sale,-1105.0,690.0,9,PASSION FIRE,Bag
VIDEXPORT,24E14305,06/28/2024,Sale,-340.0,350.0,9,PASSION FIRE,Bag
VIDEXPORT,24E14305,07/12/2024,Sale,-350.0,0.0,23,SUGAR DROP,Bag
VIDEXPORT,24E14306,06/20/2024,Entry,1800.0,1800.0,0,EARLY SWEET,Bag
VIDEXPORT,24E14306,07/01/2024,Sale,-1170.0,630.0,11,EARLY SWEET,Bag
VIDEXPORT,24E14306,07/02/2024,Sale,-270.0,360.0,12,EARLY SWEET,Bag
VIDEXPORT,24E14306,07/04/2024,Sale,-360.0,0.0,14,EARLY SWEET,Bag
VIDEXPORT,24E14307,06/20/2024,Entry,2160.0,2160.0,0,EARLY SWEET,Bag
VIDEXPORT,24E14307,07/03/2024,Sale,-1890.0,270.0,13,EARLY SWEET,Bag
VIDEXPORT,24E14307,07/04/2024,Sale,-270.0,0.0,14,EARLY SWEET,Bag
VIDEXPORT,24E14308,06/20/2024,Entry,2160.0,2160.0,0,EARLY SWEET,Bag
VIDEXPORT,24E14308,07/03/2024,Sale,-90.0,2070.0,13,EARLY SWEET,Bag
VIDEXPORT,24E14308,07/03/2024,Sale,-1980.0,90.0,13,EARLY SWEET,Bag
VIDEXPORT,24E14308,07/04/2024,Sale,-90.0,0.0,14,EARLY SWEET,Bag
VIDEXPORT,24E14309,06/20/2024,Entry,2340.0,2340.0,0,SUGAR DROP,Bag
VIDEXPORT,24E14309,06/29/2024,Sale,-1710.0,630.0,9,SUGAR DROP,Bag
VIDEXPORT,24E14309,07/01/2024,Sale,-90.0,540.0,11,SUGAR DROP,Bag
VIDEXPORT,24E14309,07/02/2024,Sale,-450.0,90.0,12,SUGAR DROP,Bag
VIDEXPORT,24E14309,07/04/2024,Sale,-90.0,0.0,14,SUGAR DROP,Bag
VIDEXPORT,24E14310,06/20/2024,Entry,1800.0,1800.0,0,EARLY SWEET,Bag
VIDEXPORT,24E14310,07/06/2024,Sale,-990.0,810.0,16,EARLY SWEET,Bag
VIDEXPORT,24E14310,07/22/2024,Sale,-810.0,0.0,32,EARLY SWEET,Bag
VIDEXPORT,24E14311,06/20/2024,Entry,1980.0,1980.0,0,SUGAR DROP,Bag
VIDEXPORT,24E14311,07/01/2024,Sale,-990.0,990.0,11,SUGAR DROP,Bag
VIDEXPORT,24E14311,07/02/2024,Sale,-990.0,0.0,12,SUGAR DROP,Bag
VIDEXPORT,24E14312,06/20/2024,Entry,1710.0,1710.0,0,EARLY SWEET,Bag
VIDEXPORT,24E14312,07/05/2024,Sale,-990.0,720.0,15,EARLY SWEET,Bag
VIDEXPORT,24E14312,07/22/2024,Sale,-720.0,0.0,32,EARLY SWEET,Bag
VIDEXPORT,24E14313,06/20/2024,Entry,1980.0,1980.0,0,EARLY SWEET,Bag
VIDEXPORT,24E14313,07/03/2024,Sale,-1890.0,90.0,13,EARLY SWEET,Bag
VIDEXPORT,24E14313,07/04/2024,Sale,-90.0,0.0,14,EARLY SWEET,Bag
VIDEXPORT,24E14314,06/19/2024,Entry,2040.0,2040.0,0,PASSION FIRE,Bag
VIDEXPORT,24E14314,06/25/2024,Sale,-170.0,1870.0,6,PASSION FIRE,Bag
VIDEXPORT,24E14314,06/26/2024,Sale,-85.0,1785.0,7,PASSION FIRE,Bag
VIDEXPORT,24E14314,06/27/2024,Sale,-935.0,850.0,8,PASSION FIRE,Bag
VIDEXPORT,24E14314,06/28/2024,Sale,-85.0,765.0,9,PASSION FIRE,Bag
VIDEXPORT,24E14314,06/29/2024,Sale,-680.0,85.0,10,PASSION FIRE,Bag
VIDEXPORT,24E14314,07/02/2024,Sale,-75.0,10.0,13,PASSION FIRE,Bag
VIDEXPORT,24E14314,07/10/2024,Sale,-9.0,1.0,21,PASSION FIRE,Bag
VIDEXPORT,24E14315,06/20/2024,Entry,2335.0,2335.0,0,SUGAR DROP,Bag
VIDEXPORT,24E14315,06/29/2024,Sale,-1980.0,355.0,9,SUGAR DROP,Bag
VIDEXPORT,24E14315,07/02/2024,Sale,-270.0,85.0,12,SUGAR DROP,Bag
VIDEXPORT,24E14315,07/04/2024,Sale,-85.0,0.0,14,SUGAR DROP,Bag
VIDEXPORT,24E14317,06/20/2024,Entry,2250.0,2250.0,0,SUGAR DROP,Bag
VIDEXPORT,24E14317,07/01/2024,Sale,-1350.0,900.0,11,SUGAR DROP,Bag
VIDEXPORT,24E14317,07/01/2024,Sale,-900.0,0.0,11,SUGAR DROP,Bag
VIDEXPORT,24E14318,06/19/2024,Entry,1500.0,1500.0,0,SUGAR DROP,Bag
VIDEXPORT,24E14318,06/22/2024,Sale,-750.0,750.0,3,SUGAR DROP,Bag
VIDEXPORT,24E14318,06/25/2024,Sale,-450.0,300.0,6,SUGAR DROP,Bag
VIDEXPORT,24E14318,06/25/2024,Sale,-300.0,0.0,6,SUGAR DROP,Bag
VIDEXPORT,24E14320,06/19/2024,Entry,1650.0,1650.0,0,SUGAR DROP,Bag
VIDEXPORT,24E14320,06/21/2024,Sale,-675.0,975.0,2,SUGAR DROP,Bag
VIDEXPORT,24E14320,06/22/2024,Sale,-150.0,825.0,3,SUGAR DROP,Bag
VIDEXPORT,24E14320,06/24/2024,Sale,-750.0,75.0,5,SUGAR DROP,Bag
VIDEXPORT,24E14320,07/12/2024,Sale,-75.0,0.0,23,SUGAR DROP,Bag
VIDEXPORT,24E14321,06/20/2024,Entry,180.0,180.0,0,PASSION FIRE,Bag
VIDEXPORT,24E14321,06/20/2024,Entry,1170.0,1350.0,0,SUGAR DROP,Bag
VIDEXPORT,24E14321,06/22/2024,Sale,-270.0,1080.0,2,SUGAR DROP,Bag
VIDEXPORT,24E14321,06/25/2024,Sale,-450.0,630.0,5,SUGAR DROP,Bag
VIDEXPORT,24E14321,06/25/2024,Sale,-450.0,180.0,5,SUGAR DROP,Bag
VIDEXPORT,24E14321,07/10/2024,Sale,-180.0,0.0,20,PASSION FIRE,Bag
VIDEXPORT,24E14322,06/20/2024,Entry,90.0,90.0,0,SUGAR DROP,Bag
VIDEXPORT,24E14322,06/20/2024,Entry,1620.0,1710.0,0,SUGAR DROP,Bag
VIDEXPORT,24E14322,07/04/2024,Sale,-1620.0,90.0,14,SUGAR DROP,Bag
VIDEXPORT,24E14322,07/18/2024,Sale,-90.0,0.0,28,SUGAR DROP,Bag
VIDEXPORT,24E14323,06/19/2024,Entry,1615.0,1615.0,0,PASSION FIRE,Bag
VIDEXPORT,24E14323,06/29/2024,Sale,-170.0,1445.0,10,PASSION FIRE,Bag
VIDEXPORT,24E14323,07/01/2024,Sale,-510.0,935.0,12,PASSION FIRE,Bag
VIDEXPORT,24E14323,07/01/2024,Sale,-765.0,170.0,12,PASSION FIRE,Bag
VIDEXPORT,24E14323,07/10/2024,Sale,-170.0,0.0,21,PASSION FIRE,Bag
VIDEXPORT,24E14324,06/20/2024,Entry,2160.0,2160.0,0,EARLY SWEET,Bag
VIDEXPORT,24E14324,07/04/2024,Sale,-1440.0,720.0,14,EARLY SWEET,Bag
VIDEXPORT,24E14324,07/05/2024,Sale,-720.0,0.0,15,EARLY SWEET,Bag
VIDEXPORT,24E14325,06/20/2024,Entry,1800.0,1800.0,0,EARLY SWEET,Bag
VIDEXPORT,24E14325,07/04/2024,Sale,-720.0,1080.0,14,EARLY SWEET,Bag
VIDEXPORT,24E14325,07/06/2024,Sale,-1080.0,0.0,16,EARLY SWEET,Bag
VIDEXPORT,24E14326,06/20/2024,Entry,2160.0,2160.0,0,EARLY SWEET,Bag
VIDEXPORT,24E14326,07/05/2024,Sale,-1080.0,1080.0,15,EARLY SWEET,Bag
VIDEXPORT,24E14326,07/05/2024,Sale,-900.0,180.0,15,EARLY SWEET,Bag
VIDEXPORT,24E14326,07/06/2024,Sale,-180.0,0.0,16,EARLY SWEET,Bag
VIDEXPORT,24E14328,06/20/2024,Entry,2160.0,2160.0,0,EARLY SWEET,Bag
VIDEXPORT,24E14328,07/05/2024,Sale,-90.0,2070.0,15,EARLY SWEET,Bag
VIDEXPORT,24E14328,07/05/2024,Sale,-1260.0,810.0,15,EARLY SWEET,Bag
VIDEXPORT,24E14328,07/06/2024,Sale,-270.0,540.0,16,EARLY SWEET,Bag
VIDEXPORT,24E14328,07/06/2024,Sale,-540.0,0.0,16,EARLY SWEET,Bag
VIDEXPORT,24E14329,06/20/2024,Entry,2340.0,2340.0,0,EARLY SWEET,Bag
VIDEXPORT,24E14329,07/06/2024,Sale,-360.0,1980.0,16,EARLY SWEET,Bag
VIDEXPORT,24E14329,07/08/2024,Sale,-1980.0,0.0,18,EARLY SWEET,Bag
VIDEXPORT,24E14330,06/20/2024,Entry,1700.0,1700.0,0,PASSION FIRE,Bag
VIDEXPORT,24E14330,06/28/2024,Sale,-595.0,1105.0,8,PASSION FIRE,Bag
VIDEXPORT,24E14330,06/28/2024,Sale,-850.0,255.0,8,PASSION FIRE,Bag
VIDEXPORT,24E14330,06/28/2024,Sale,-75.0,180.0,8,PASSION FIRE,Unknown
VIDEXPORT,24E14330,06/28/2024,Sale,-225.0,-45.0,8,PASSION FIRE,Unknown
VIDEXPORT,24E14330,06/28/2024,Sale,-75.0,-120.0,8,PASSION FIRE,Unknown
VIDEXPORT,24E14331,06/22/2024,Entry,1800.0,1800.0,0,SUGAR DROP,Bag
VIDEXPORT,24E14331,07/04/2024,Sale,-360.0,1440.0,12,SUGAR DROP,Bag
VIDEXPORT,24E14331,07/11/2024,Sale,-1440.0,0.0,19,SUGAR DROP,Bag
VIDEXPORT,24E14332,06/22/2024,Entry,2340.0,2340.0,0,SUGAR DROP,Bag
VIDEXPORT,24E14332,07/03/2024,Sale,-90.0,2250.0,11,SUGAR DROP,Bag
VIDEXPORT,24E14332,07/04/2024,Sale,-1350.0,900.0,12,SUGAR DROP,Bag
VIDEXPORT,24E14332,07/05/2024,Sale,-540.0,360.0,13,SUGAR DROP,Bag
VIDEXPORT,24E14332,07/05/2024,Sale,-360.0,0.0,13,SUGAR DROP,Bag
VIDEXPORT,24E14333,06/20/2024,Entry,2160.0,2160.0,0,SUGAR DROP,Bag
VIDEXPORT,24E14333,07/10/2024,Sale,-1890.0,270.0,20,SUGAR DROP,Bag
VIDEXPORT,24E14333,07/11/2024,Sale,-270.0,0.0,21,SUGAR DROP,Bag
VIDEXPORT,24E14334,06/20/2024,Entry,270.0,270.0,0,EARLY SWEET,Bag
VIDEXPORT,24E14334,06/20/2024,Entry,1020.0,1290.0,0,PASSION FIRE,Bag
VIDEXPORT,24E14334,06/20/2024,Entry,675.0,1965.0,0,SUGAR DROP,Bag
VIDEXPORT,24E14334,06/20/2024,Sale,-45.0,1920.0,0,EARLY SWEET,Bag
VIDEXPORT,24E14334,06/20/2024,Sale,-45.0,1875.0,0,EARLY SWEET,Bag
VIDEXPORT,24E14334,06/21/2024,Sale,-595.0,1280.0,1,PASSION FIRE,Bag
VIDEXPORT,24E14334,06/21/2024,Sale,-75.0,1205.0,1,SUGAR DROP,Bag
VIDEXPORT,24E14334,06/22/2024,Sale,-600.0,605.0,2,SUGAR DROP,Bag
VIDEXPORT,24E14334,06/24/2024,Sale,-90.0,515.0,4,EARLY SWEET,Bag
VIDEXPORT,24E14334,06/27/2024,Sale,-90.0,425.0,7,EARLY SWEET,Bag
VIDEXPORT,24E14334,06/28/2024,Sale,-85.0,340.0,8,PASSION FIRE,Bag
VIDEXPORT,24E14334,06/28/2024,Sale,-170.0,170.0,8,PASSION FIRE,Bag
VIDEXPORT,24E14336,06/21/2024,Entry,990.0,990.0,0,SUGAR DROP,Bag
VIDEXPORT,24E14336,06/21/2024,Entry,1350.0,2340.0,0,SUGAR DROP,Bag
VIDEXPORT,24E14336,06/25/2024,Sale,-720.0,1620.0,4,SUGAR DROP,Bag
VIDEXPORT,24E14336,07/02/2024,Sale,-360.0,1260.0,11,SUGAR DROP,Bag
VIDEXPORT,24E14336,07/03/2024,Sale,-990.0,270.0,12,SUGAR DROP,Bag
VIDEXPORT,24E14336,07/12/2024,Sale,-270.0,0.0,21,SUGAR DROP,Bag
VIDEXPORT,24E14338,06/20/2024,Entry,1700.0,1700.0,0,PASSION FIRE,Bag
VIDEXPORT,24E14338,06/28/2024,Sale,-85.0,1615.0,8,PASSION FIRE,Bag
VIDEXPORT,24E14338,06/28/2024,Sale,-85.0,1530.0,8,PASSION FIRE,Bag
VIDEXPORT,24E14338,06/28/2024,Sale,-595.0,935.0,8,PASSION FIRE,Bag
VIDEXPORT,24E14338,07/01/2024,Sale,-340.0,595.0,11,PASSION FIRE,Bag
VIDEXPORT,24E14338,07/01/2024,Sale,-85.0,510.0,11,PASSION FIRE,Bag
VIDEXPORT,24E14338,07/02/2024,Sale,-492.0,18.0,12,PASSION FIRE,Bag
VIDEXPORT,24E14340,06/22/2024,Entry,1800.0,1800.0,0,SUGAR DROP,Bag
VIDEXPORT,24E14340,07/05/2024,Sale,-1080.0,720.0,13,SUGAR DROP,Bag
VIDEXPORT,24E14340,07/05/2024,Sale,-720.0,0.0,13,SUGAR DROP,Bag
VIDEXPORT,24E14342,06/22/2024,Entry,2160.0,2160.0,0,EARLY SWEET,Bag
VIDEXPORT,24E14342,07/05/2024,Sale,-270.0,1890.0,13,EARLY SWEET,Bag
VIDEXPORT,24E14342,07/06/2024,Sale,-1890.0,0.0,14,EARLY SWEET,Bag
VIDEXPORT,24E14344,06/22/2024,Entry,2520.0,2520.0,0,SUGAR DROP,Bag
VIDEXPORT,24E14344,07/04/2024,Sale,-630.0,1890.0,12,SUGAR DROP,Bag
VIDEXPORT,24E14344,07/05/2024,Sale,-900.0,990.0,13,SUGAR DROP,Bag
VIDEXPORT,24E14344,07/05/2024,Sale,-720.0,270.0,13,SUGAR DROP,Bag
VIDEXPORT,24E14344,07/05/2024,Sale,-270.0,0.0,13,SUGAR DROP,Bag
VIDEXPORT,24E14348,06/22/2024,Entry,2160.0,2160.0,0,EARLY SWEET,Bag
VIDEXPORT,24E14348,07/06/2024,Sale,-90.0,2070.0,14,EARLY SWEET,Bag
VIDEXPORT,24E14348,07/09/2024,Sale,-540.0,1530.0,17,EARLY SWEET,Bag
VIDEXPORT,24E14348,07/09/2024,Sale,-1440.0,90.0,17,EARLY SWEET,Bag
VIDEXPORT,24E14348,07/29/2024,Sale,-90.0,0.0,37,EARLY SWEET,Bag
VIDEXPORT,24E14349,06/22/2024,Entry,2160.0,2160.0,0,EARLY SWEET,Bag
VIDEXPORT,24E14349,07/05/2024,Sale,-1350.0,810.0,13,EARLY SWEET,Bag
VIDEXPORT,24E14349,07/06/2024,Sale,-720.0,90.0,14,EARLY SWEET,Bag
VIDEXPORT,24E14349,07/09/2024,Sale,-90.0,0.0,17,EARLY SWEET,Bag
VIDEXPORT,24E14351,06/22/2024,Entry,1800.0,1800.0,0,SUGAR DROP,Bag
VIDEXPORT,24E14351,07/04/2024,Sale,-1170.0,630.0,12,SUGAR DROP,Bag
VIDEXPORT,24E14351,07/06/2024,Sale,-630.0,0.0,14,SUGAR DROP,Bag
VIDEXPORT,24E14352,06/22/2024,Entry,2160.0,2160.0,0,EARLY SWEET,Bag
VIDEXPORT,24E14352,07/06/2024,Sale,-810.0,1350.0,14,EARLY SWEET,Bag
VIDEXPORT,24E14352,07/09/2024,Sale,-1350.0,0.0,17,EARLY SWEET,Bag
VIDEXPORT,24E14354,06/22/2024,Entry,2250.0,2250.0,0,SUGAR DROP,Bag
VIDEXPORT,24E14354,07/09/2024,Sale,-2070.0,180.0,17,SUGAR DROP,Bag
VIDEXPORT,24E14354,07/11/2024,Sale,-180.0,0.0,19,SUGAR DROP,Bag
VIDEXPORT,24E14357,06/22/2024,Entry,2520.0,2520.0,0,EARLY SWEET,Bag
VIDEXPORT,24E14357,07/09/2024,Sale,-540.0,1980.0,17,EARLY SWEET,Bag
VIDEXPORT,24E14357,07/11/2024,Sale,-1980.0,0.0,19,EARLY SWEET,Bag
VIDEXPORT,24E14358,06/22/2024,Entry,1620.0,1620.0,0,SUGAR DROP,Bag
VIDEXPORT,24E14358,07/06/2024,Sale,-1350.0,270.0,14,SUGAR DROP,Bag
VIDEXPORT,24E14358,07/11/2024,Sale,-180.0,90.0,19,SUGAR DROP,Bag
VIDEXPORT,24E14358,07/23/2024,Sale,-90.0,0.0,31,SUGAR DROP,Bag
VIDEXPORT,24E14361,06/24/2024,Entry,2160.0,2160.0,0,EARLY SWEET,Bag
VIDEXPORT,24E14361,07/17/2024,Sale,-720.0,1440.0,23,EARLY SWEET,Bag
VIDEXPORT,24E14361,07/17/2024,Sale,-990.0,450.0,23,EARLY SWEET,Bag
VIDEXPORT,24E14361,07/29/2024,Sale,-450.0,0.0,35,EARLY SWEET,Bag
VIDEXPORT,24E14363,06/25/2024,Entry,1800.0,1800.0,0,EARLY SWEET,Bag
VIDEXPORT,24E14363,07/17/2024,Sale,-270.0,1530.0,22,EARLY SWEET,Bag
VIDEXPORT,24E14363,07/18/2024,Sale,-682.0,848.0,23,EARLY SWEET,Bag
VIDEXPORT,24E14363,07/18/2024,Sale,-38.0,810.0,23,EARLY SWEET,Bag
VIDEXPORT,24E14363,07/29/2024,Sale,-810.0,0.0,34,EARLY SWEET,Bag
VIDEXPORT,24E14364,06/25/2024,Entry,900.0,900.0,0,SUGAR DROP,Bag
VIDEXPORT,24E14364,07/16/2024,Sale,-180.0,720.0,21,SUGAR DROP,Bag
VIDEXPORT,24E14364,07/17/2024,Sale,-565.0,155.0,22,SUGAR DROP,Bag
VIDEXPORT,24E14364,07/23/2024,Sale,-155.0,0.0,28,SUGAR DROP,Bag
VIDEXPORT,24E14369,06/25/2024,Entry,1800.0,1800.0,0,SUGAR DROP,Bag
VIDEXPORT,24E14369,07/16/2024,Sale,-1800.0,0.0,21,SUGAR DROP,Bag
VIDEXPORT,24E14380,06/24/2024,Entry,1505.0,1505.0,0,SUGAR DROP,Bag
VIDEXPORT,24E14380,07/17/2024,Sale,-1485.0,20.0,23,SUGAR DROP,Bag
VIDEXPORT,24E14380,07/23/2024,Sale,-20.0,0.0,29,SUGAR DROP,Bag
VIDEXPORT,24E17367,05/13/2024,Entry,960.0,960.0,0,EARLY SWEET,Clam
VIDEXPORT,24E17367,05/14/2024,Sale,-720.0,240.0,1,EARLY SWEET,Clam
VIDEXPORT,24E17367,05/15/2024,Sale,-240.0,0.0,2,EARLY SWEET,Clam
VIDEXPORT,24E17371,05/13/2024,Entry,2250.0,2250.0,0,EARLY SWEET,Bag
VIDEXPORT,24E17371,05/13/2024,Entry,90.0,2340.0,0,EARLY SWEET,Bag
VIDEXPORT,24E17371,05/15/2024,Sale,-450.0,1890.0,2,EARLY SWEET,Bag
VIDEXPORT,24E17371,05/15/2024,Sale,-540.0,1350.0,2,EARLY SWEET,Bag
VIDEXPORT,24E17371,05/15/2024,Sale,-90.0,1260.0,2,EARLY SWEET,Bag
VIDEXPORT,24E17371,05/18/2024,Sale,-990.0,270.0,5,EARLY SWEET,Bag
VIDEXPORT,24E17371,05/18/2024,Sale,-180.0,90.0,5,EARLY SWEET,Bag
VIDEXPORT,24E17371,07/15/2024,Sale,-90.0,0.0,63,EARLY SWEET,Bag
VIDEXPORT,24E17373,05/14/2024,Entry,1120.0,1120.0,0,EARLY SWEET,Clam
VIDEXPORT,24E17373,05/15/2024,Sale,-720.0,400.0,1,EARLY SWEET,Clam
VIDEXPORT,24E17373,05/16/2024,Sale,-400.0,0.0,2,EARLY SWEET,Clam
VIDEXPORT,24E17375,05/14/2024,Entry,2340.0,2340.0,0,EARLY SWEET,Bag
VIDEXPORT,24E17375,05/15/2024,Sale,-270.0,2070.0,1,EARLY SWEET,Bag
VIDEXPORT,24E17375,05/15/2024,Sale,-900.0,1170.0,1,EARLY SWEET,Bag
VIDEXPORT,24E17375,05/15/2024,Sale,-630.0,540.0,1,EARLY SWEET,Bag
VIDEXPORT,24E17375,05/18/2024,Sale,-270.0,270.0,4,EARLY SWEET,Bag
VIDEXPORT,24E17375,05/18/2024,Sale,-90.0,180.0,4,EARLY SWEET,Bag
VIDEXPORT,24E17375,06/19/2024,Sale,-180.0,0.0,36,EARLY SWEET,Bag
VIDEXPORT,24E17376,05/14/2024,Entry,630.0,630.0,0,EARLY SWEET,Bag
VIDEXPORT,24E17376,05/14/2024,Entry,1710.0,2340.0,0,EARLY SWEET,Bag
VIDEXPORT,24E17376,05/16/2024,Sale,-630.0,1710.0,2,EARLY SWEET,Bag
VIDEXPORT,24E17376,05/20/2024,Sale,-1530.0,180.0,6,EARLY SWEET,Bag
VIDEXPORT,24E17376,05/20/2024,Sale,-180.0,0.0,6,EARLY SWEET,Bag
VIDEXPORT,24E17378,05/14/2024,Entry,2340.0,2340.0,0,EARLY SWEET,Bag
VIDEXPORT,24E17378,05/20/2024,Sale,-540.0,1800.0,6,EARLY SWEET,Bag
VIDEXPORT,24E17378,05/20/2024,Sale,-360.0,1440.0,6,EARLY SWEET,Bag
VIDEXPORT,24E17378,05/21/2024,Sale,-360.0,1080.0,7,EARLY SWEET,Bag
VIDEXPORT,24E17378,05/21/2024,Sale,-360.0,720.0,7,EARLY SWEET,Bag
VIDEXPORT,24E17378,05/22/2024,Sale,-630.0,90.0,8,EARLY SWEET,Bag
VIDEXPORT,24E17378,05/24/2024,Sale,-90.0,0.0,10,EARLY SWEET,Bag
VIDEXPORT,24E17379,05/14/2024,Entry,2520.0,2520.0,0,EARLY SWEET,Bag
VIDEXPORT,24E17379,05/20/2024,Sale,-1980.0,540.0,6,EARLY SWEET,Bag
VIDEXPORT,24E17379,05/20/2024,Sale,-450.0,90.0,6,EARLY SWEET,Bag
VIDEXPORT,24E17379,05/25/2024,Sale,-88.0,2.0,11,EARLY SWEET,Bag
VIDEXPORT,24E17380,05/14/2024,Entry,2340.0,2340.0,0,EARLY SWEET,Bag
VIDEXPORT,24E17380,05/15/2024,Sale,-1980.0,360.0,1,EARLY SWEET,Bag
VIDEXPORT,24E17380,05/16/2024,Sale,-360.0,0.0,2,EARLY SWEET,Bag
VIDEXPORT,24E17383,05/14/2024,Entry,2340.0,2340.0,0,EARLY SWEET,Bag
VIDEXPORT,24E17383,05/17/2024,Sale,-630.0,1710.0,3,EARLY SWEET,Bag
VIDEXPORT,24E17383,05/18/2024,Sale,-1710.0,0.0,4,EARLY SWEET,Bag
VIDEXPORT,24E17388,05/17/2024,Entry,2340.0,2340.0,0,EARLY SWEET,Bag
VIDEXPORT,24E17388,05/21/2024,Sale,-540.0,1800.0,4,EARLY SWEET,Bag
VIDEXPORT,24E17388,05/22/2024,Sale,-270.0,1530.0,5,EARLY SWEET,Bag
VIDEXPORT,24E17388,05/22/2024,Sale,-990.0,540.0,5,EARLY SWEET,Bag
VIDEXPORT,24E17388,05/23/2024,Sale,-90.0,450.0,6,EARLY SWEET,Bag
VIDEXPORT,24E17388,05/24/2024,Sale,-450.0,0.0,7,EARLY SWEET,Bag
VIDEXPORT,24E17389,05/17/2024,Entry,2160.0,2160.0,0,EARLY SWEET,Bag
VIDEXPORT,24E17389,05/17/2024,Entry,180.0,2340.0,0,EARLY SWEET,Bag
VIDEXPORT,24E17389,05/18/2024,Sale,-90.0,2250.0,1,EARLY SWEET,Bag
VIDEXPORT,24E17389,05/20/2024,Sale,-90.0,2160.0,3,EARLY SWEET,Bag
VIDEXPORT,24E17389,05/20/2024,Sale,-1080.0,1080.0,3,EARLY SWEET,Bag
VIDEXPORT,24E17389,05/21/2024,Sale,-720.0,360.0,4,EARLY SWEET,Bag
VIDEXPORT,24E17389,05/21/2024,Sale,-90.0,270.0,4,EARLY SWEET,Bag
VIDEXPORT,24E17389,05/21/2024,Sale,-75.0,195.0,4,EARLY SWEET,Clam
VIDEXPORT,24E17389,05/22/2024,Sale,-90.0,105.0,5,EARLY SWEET,Bag
VIDEXPORT,24E17389,05/23/2024,Sale,-90.0,15.0,6,EARLY SWEET,Bag
VIDEXPORT,24E17390,05/17/2024,Entry,2340.0,2340.0,0,EARLY SWEET,Bag
VIDEXPORT,24E17390,05/22/2024,Sale,-450.0,1890.0,5,EARLY SWEET,Bag
VIDEXPORT,24E17390,05/22/2024,Sale,-630.0,1260.0,5,EARLY SWEET,Bag
VIDEXPORT,24E17390,05/22/2024,Sale,-180.0,1080.0,5,EARLY SWEET,Bag
VIDEXPORT,24E17390,05/22/2024,Sale,-360.0,720.0,5,EARLY SWEET,Bag
VIDEXPORT,24E17390,05/23/2024,Sale,-720.0,0.0,6,EARLY SWEET,Bag
VIDEXPORT,24E17392,05/17/2024,Entry,2340.0,2340.0,0,EARLY SWEET,Bag
VIDEXPORT,24E17392,05/22/2024,Sale,-360.0,1980.0,5,EARLY SWEET,Bag
VIDEXPORT,24E17392,05/22/2024,Sale,-1980.0,0.0,5,EARLY SWEET,Bag
VIDEXPORT,24E17393,05/17/2024,Entry,900.0,900.0,0,EARLY SWEET,Bag
VIDEXPORT,24E17393,05/17/2024,Entry,630.0,1530.0,0,EARLY SWEET,Bag
VIDEXPORT,24E17393,05/17/2024,Entry,180.0,1710.0,0,EARLY SWEET,Bag
VIDEXPORT,24E17393,05/20/2024,Sale,-180.0,1530.0,3,EARLY SWEET,Bag
VIDEXPORT,24E17393,05/21/2024,Sale,-180.0,1350.0,4,EARLY SWEET,Bag
VIDEXPORT,24E17393,05/21/2024,Sale,-225.0,1125.0,4,EARLY SWEET,Clam
VIDEXPORT,24E17393,05/22/2024,Sale,-630.0,495.0,5,EARLY SWEET,Bag
VIDEXPORT,24E17393,05/23/2024,Sale,-975.0,-480.0,6,EARLY SWEET,Clam
VIDEXPORT,24E17393,05/23/2024,Sale,-600.0,-1080.0,6,EARLY SWEET,Clam
VIDEXPORT,24E17393,05/25/2024,Sale,-240.0,-1320.0,8,EARLY SWEET,Clam
VIDEXPORT,24E17393,06/01/2024,Sale,-320.0,-1640.0,15,FLAME,Clam
VIDEXPORT,24E17393,06/13/2024,Sale,-12.0,-1652.0,27,EARLY SWEET,Clam
VIDEXPORT,24E17395,05/18/2024,Entry,2340.0,2340.0,0,EARLY SWEET,Bag
VIDEXPORT,24E17395,05/22/2024,Sale,-1440.0,900.0,4,EARLY SWEET,Bag
VIDEXPORT,24E17395,05/23/2024,Sale,-900.0,0.0,5,EARLY SWEET,Bag
VIDEXPORT,24E17397,05/18/2024,Entry,2340.0,2340.0,0,EARLY SWEET,Bag
VIDEXPORT,24E17397,05/22/2024,Sale,-270.0,2070.0,4,EARLY SWEET,Bag
VIDEXPORT,24E17397,05/22/2024,Sale,-270.0,1800.0,4,EARLY SWEET,Bag
VIDEXPORT,24E17397,05/22/2024,Sale,-1800.0,0.0,4,EARLY SWEET,Bag
VIDEXPORT,24E17399,05/20/2024,Entry,1890.0,1890.0,0,EARLY SWEET,Bag
VIDEXPORT,24E17399,05/20/2024,Entry,450.0,2340.0,0,EARLY SWEET,Bag
VIDEXPORT,24E17399,05/22/2024,Sale,-450.0,1890.0,2,EARLY SWEET,Bag
VIDEXPORT,24E17399,05/22/2024,Sale,-1440.0,450.0,2,EARLY SWEET,Bag
VIDEXPORT,24E17399,05/22/2024,Sale,-450.0,0.0,2,EARLY SWEET,Bag
VIDEXPORT,24E17400,05/19/2024,Entry,450.0,450.0,0,EARLY SWEET,Bag
VIDEXPORT,24E17400,05/19/2024,Entry,1890.0,2340.0,0,EARLY SWEET,Bag
VIDEXPORT,24E17400,05/22/2024,Sale,-1890.0,450.0,3,EARLY SWEET,Bag
VIDEXPORT,24E17400,05/28/2024,Sale,-270.0,180.0,9,EARLY SWEET,Bag
VIDEXPORT,24E17400,06/07/2024,Sale,-450.0,-270.0,19,EARLY SWEET,Clam
VIDEXPORT,24E17404,05/19/2024,Entry,2340.0,2340.0,0,EARLY SWEET,Bag
VIDEXPORT,24E17404,05/22/2024,Sale,-1800.0,540.0,3,EARLY SWEET,Bag
VIDEXPORT,24E17404,05/23/2024,Sale,-540.0,0.0,4,EARLY SWEET,Bag
VIDEXPORT,24E17405,05/19/2024,Entry,2340.0,2340.0,0,EARLY SWEET,Bag
VIDEXPORT,24E17405,06/01/2024,Sale,-1710.0,630.0,13,EARLY SWEET,Bag
VIDEXPORT,24E17405,06/03/2024,Sale,-630.0,0.0,15,EARLY SWEET,Bag
VIDEXPORT,24E17408,05/20/2024,Entry,2160.0,2160.0,0,EARLY SWEET,Bag
VIDEXPORT,24E17408,05/20/2024,Sale,-720.0,1440.0,0,EARLY SWEET,Bag
VIDEXPORT,24E17408,05/22/2024,Sale,-180.0,1260.0,2,EARLY SWEET,Bag
VIDEXPORT,24E17408,05/24/2024,Sale,-990.0,270.0,4,EARLY SWEET,Bag
VIDEXPORT,24E17408,05/25/2024,Sale,-270.0,0.0,5,EARLY SWEET,Bag
VIDEXPORT,24E17409,05/19/2024,Entry,2250.0,2250.0,0,EARLY SWEET,Bag
VIDEXPORT,24E17409,05/22/2024,Sale,-90.0,2160.0,3,EARLY SWEET,Bag
VIDEXPORT,24E17409,05/23/2024,Sale,-1440.0,720.0,4,EARLY SWEET,Bag
VIDEXPORT,24E17409,05/24/2024,Sale,-450.0,270.0,5,EARLY SWEET,Bag
VIDEXPORT,24E17409,05/24/2024,Sale,-270.0,0.0,5,EARLY SWEET,Bag
VIDEXPORT,24E17411,05/21/2024,Entry,1980.0,1980.0,0,EARLY SWEET,Bag
VIDEXPORT,24E17411,05/25/2024,Sale,-990.0,990.0,4,EARLY SWEET,Bag
VIDEXPORT,24E17411,05/28/2024,Sale,-90.0,900.0,7,EARLY SWEET,Bag
VIDEXPORT,24E17411,06/01/2024,Sale,-540.0,360.0,11,EARLY SWEET,Bag
VIDEXPORT,24E17411,07/17/2024,Sale,-56.0,304.0,57,EARLY SWEET,Bag
VIDEXPORT,24E17416,05/20/2024,Entry,360.0,360.0,0,EARLY SWEET,Bag
VIDEXPORT,24E17416,05/25/2024,Sale,-360.0,0.0,5,EARLY SWEET,Bag
VIDEXPORT,24E17417,05/20/2024,Entry,2340.0,2340.0,0,EARLY SWEET,Bag
VIDEXPORT,24E17417,05/22/2024,Sale,-900.0,1440.0,2,EARLY SWEET,Bag
VIDEXPORT,24E17417,05/22/2024,Sale,-540.0,900.0,2,EARLY SWEET,Bag
VIDEXPORT,24E17417,05/23/2024,Sale,-900.0,0.0,3,EARLY SWEET,Bag
VIDEXPORT,24E17423,05/20/2024,Entry,1800.0,1800.0,0,EARLY SWEET,Bag
VIDEXPORT,24E17423,05/24/2024,Sale,-1800.0,0.0,4,EARLY SWEET,Bag
VIDEXPORT,24E17424,05/21/2024,Entry,1800.0,1800.0,0,EARLY SWEET,Bag
VIDEXPORT,24E17424,05/22/2024,Sale,-270.0,1530.0,1,EARLY SWEET,Bag
VIDEXPORT,24E17424,05/23/2024,Sale,-1350.0,180.0,2,EARLY SWEET,Bag
VIDEXPORT,24E17424,05/23/2024,Sale,-180.0,0.0,2,EARLY SWEET,Bag
VIDEXPORT,24E17427,05/21/2024,Entry,900.0,900.0,0,EARLY SWEET,Bag
VIDEXPORT,24E17427,05/21/2024,Entry,360.0,1260.0,0,EARLY SWEET,Bag
VIDEXPORT,24E17427,05/21/2024,Entry,450.0,1710.0,0,EARLY SWEET,Bag
VIDEXPORT,24E17427,05/22/2024,Sale,-180.0,1530.0,1,EARLY SWEET,Bag
VIDEXPORT,24E17427,05/23/2024,Sale,-360.0,1170.0,2,EARLY SWEET,Bag
VIDEXPORT,24E17427,05/23/2024,Sale,-450.0,720.0,2,EARLY SWEET,Bag
VIDEXPORT,24E17427,05/25/2024,Sale,-90.0,630.0,4,EARLY SWEET,Bag
VIDEXPORT,24E17427,05/25/2024,Sale,-630.0,0.0,4,EARLY SWEET,Bag
VIDEXPORT,24E17433,05/21/2024,Entry,1530.0,1530.0,0,EARLY SWEET,Bag
VIDEXPORT,24E17433,05/23/2024,Sale,-450.0,1080.0,2,EARLY SWEET,Bag
VIDEXPORT,24E17433,05/24/2024,Sale,-540.0,540.0,3,EARLY SWEET,Bag
VIDEXPORT,24E17433,05/25/2024,Sale,-180.0,360.0,4,EARLY SWEET,Bag
VIDEXPORT,24E17433,05/25/2024,Sale,-90.0,270.0,4,EARLY SWEET,Bag
VIDEXPORT,24E17433,05/25/2024,Sale,-270.0,0.0,4,EARLY SWEET,Bag
VIDEXPORT,24E17434,05/21/2024,Entry,990.0,990.0,0,EARLY SWEET,Bag
VIDEXPORT,24E17434,05/21/2024,Entry,540.0,1530.0,0,EARLY SWEET,Bag
VIDEXPORT,24E17434,05/22/2024,Sale,-540.0,990.0,1,EARLY SWEET,Bag
VIDEXPORT,24E17434,05/24/2024,Sale,-990.0,0.0,3,EARLY SWEET,Bag
VIDEXPORT,24E17440,05/23/2024,Entry,1620.0,1620.0,0,EARLY SWEET,Bag
VIDEXPORT,24E17440,05/24/2024,Sale,-1530.0,90.0,1,EARLY SWEET,Bag
VIDEXPORT,24E17440,05/25/2024,Sale,-90.0,0.0,2,EARLY SWEET,Bag
VIDEXPORT,24E17446,05/26/2024,Entry,1080.0,1080.0,0,EARLY SWEET,Bag
VIDEXPORT,24E17446,05/26/2024,Entry,810.0,1890.0,0,EARLY SWEET,Bag
VIDEXPORT,24E17446,05/28/2024,Sale,-90.0,1800.0,2,EARLY SWEET,Bag
VIDEXPORT,24E17446,05/28/2024,Sale,-90.0,1710.0,2,EARLY SWEET,Bag
VIDEXPORT,24E17446,05/28/2024,Sale,-630.0,1080.0,2,EARLY SWEET,Bag
VIDEXPORT,24E17446,06/03/2024,Sale,-1080.0,0.0,8,EARLY SWEET,Bag
VIDEXPORT,24E17454,05/28/2024,Entry,2340.0,2340.0,0,HONEY POP,Bag
VIDEXPORT,24E17454,05/29/2024,Sale,-1890.0,450.0,1,HONEY POP,Bag
VIDEXPORT,24E17454,06/01/2024,Sale,-450.0,0.0,4,HONEY POP,Bag
VIDEXPORT,24E17457,05/29/2024,Entry,630.0,630.0,0,HONEY POP,Bag
VIDEXPORT,24E17457,05/29/2024,Entry,90.0,720.0,0,HONEY POP,Bag
VIDEXPORT,24E17457,05/29/2024,Entry,990.0,1710.0,0,HONEY POP,Bag
VIDEXPORT,24E17457,05/30/2024,Sale,-540.0,1170.0,1,HONEY POP,Bag
VIDEXPORT,24E17457,05/30/2024,Sale,-630.0,540.0,1,HONEY POP,Bag
VIDEXPORT,24E17457,05/31/2024,Sale,-360.0,180.0,2,HONEY POP,Bag
VIDEXPORT,24E17457,06/01/2024,Sale,-90.0,90.0,3,HONEY POP,Bag
VIDEXPORT,24E17457,07/10/2024,Sale,-90.0,0.0,42,HONEY POP,Bag
VIDEXPORT,24E17458,05/29/2024,Entry,2340.0,2340.0,0,HONEY POP,Bag
VIDEXPORT,24E17458,05/29/2024,Sale,-1980.0,360.0,0,HONEY POP,Bag
VIDEXPORT,24E17458,05/29/2024,Sale,-90.0,270.0,0,HONEY POP,Bag
VIDEXPORT,24E17458,05/30/2024,Sale,-180.0,90.0,1,HONEY POP,Bag
VIDEXPORT,24E17458,06/03/2024,Sale,-90.0,0.0,5,HONEY POP,Bag
VIDEXPORT,24E17459,05/27/2024,Entry,90.0,90.0,0,EARLY SWEET,Bag
VIDEXPORT,24E17459,05/29/2024,Sale,-90.0,0.0,2,EARLY SWEET,Bag
VIDEXPORT,24E17460,05/29/2024,Entry,2160.0,2160.0,0,HONEY POP,Bag
VIDEXPORT,24E17460,05/29/2024,Sale,-180.0,1980.0,0,HONEY POP,Bag
VIDEXPORT,24E17460,05/30/2024,Sale,-1080.0,900.0,1,HONEY POP,Bag
VIDEXPORT,24E17460,05/30/2024,Sale,-90.0,810.0,1,HONEY POP,Bag
VIDEXPORT,24E17460,05/30/2024,Sale,-180.0,630.0,1,HONEY POP,Bag
VIDEXPORT,24E17460,06/03/2024,Sale,-630.0,0.0,5,HONEY POP,Bag
VIDEXPORT,24E17461,05/29/2024,Entry,1710.0,1710.0,0,HONEY POP,Bag
VIDEXPORT,24E17461,05/29/2024,Sale,-900.0,810.0,0,HONEY POP,Bag
VIDEXPORT,24E17461,05/31/2024,Sale,-810.0,0.0,2,HONEY POP,Bag
VIDEXPORT,24E17462,05/29/2024,Entry,2160.0,2160.0,0,HONEY POP,Bag
VIDEXPORT,24E17462,05/30/2024,Sale,-540.0,1620.0,1,HONEY POP,Bag
VIDEXPORT,24E17462,05/31/2024,Sale,-450.0,1170.0,2,HONEY POP,Bag
VIDEXPORT,24E17462,05/31/2024,Sale,-1170.0,0.0,2,HONEY POP,Bag
VIDEXPORT,24E17463,05/29/2024,Entry,2160.0,2160.0,0,HONEY POP,Bag
VIDEXPORT,24E17463,05/29/2024,Sale,-1980.0,180.0,0,HONEY POP,Bag
VIDEXPORT,24E17463,05/30/2024,Sale,-90.0,90.0,1,HONEY POP,Bag
VIDEXPORT,24E17463,07/10/2024,Sale,-90.0,0.0,42,HONEY POP,Bag
VIDEXPORT,24E17464,05/29/2024,Entry,1350.0,1350.0,0,HONEY POP,Bag
VIDEXPORT,24E17464,05/29/2024,Entry,450.0,1800.0,0,HONEY POP,Bag
VIDEXPORT,24E17464,05/29/2024,Sale,-1080.0,720.0,0,HONEY POP,Bag
VIDEXPORT,24E17464,05/30/2024,Sale,-450.0,270.0,1,HONEY POP,Bag
VIDEXPORT,24E17464,05/31/2024,Sale,-270.0,0.0,2,HONEY POP,Bag
VIDEXPORT,24E17470,05/29/2024,Entry,2320.0,2320.0,0,HONEY POP,Bag
VIDEXPORT,24E17470,05/29/2024,Sale,-90.0,2230.0,0,HONEY POP,Bag
VIDEXPORT,24E17470,05/30/2024,Sale,-1080.0,1150.0,1,HONEY POP,Bag
VIDEXPORT,24E17470,06/01/2024,Sale,-720.0,430.0,3,HONEY POP,Bag
VIDEXPORT,24E17470,06/03/2024,Sale,-430.0,0.0,5,HONEY POP,Bag
VIDEXPORT,24E17471,05/30/2024,Entry,2310.0,2310.0,0,HONEY POP,Bag
VIDEXPORT,24E17471,05/31/2024,Sale,-1620.0,690.0,1,HONEY POP,Bag
VIDEXPORT,24E17471,06/04/2024,Sale,-690.0,0.0,5,HONEY POP,Bag
VIDEXPORT,24E17473,05/30/2024,Entry,2340.0,2340.0,0,HONEY POP,Bag
VIDEXPORT,24E17473,05/31/2024,Sale,-180.0,2160.0,1,HONEY POP,Bag
VIDEXPORT,24E17473,05/31/2024,Sale,-180.0,1980.0,1,HONEY POP,Bag
VIDEXPORT,24E17473,06/01/2024,Sale,-1800.0,180.0,2,HONEY POP,Bag
VIDEXPORT,24E17473,06/04/2024,Sale,-180.0,0.0,5,HONEY POP,Bag
VIDEXPORT,24E17474,05/30/2024,Entry,2520.0,2520.0,0,HONEY POP,Bag
VIDEXPORT,24E17474,06/04/2024,Sale,-2160.0,360.0,5,HONEY POP,Bag
VIDEXPORT,24E17474,06/07/2024,Sale,-360.0,0.0,8,HONEY POP,Bag
VIDEXPORT,24E17475,05/30/2024,Entry,90.0,90.0,0,HONEY POP,Bag
VIDEXPORT,24E17475,05/30/2024,Entry,1620.0,1710.0,0,HONEY POP,Bag
VIDEXPORT,24E17475,05/31/2024,Sale,-540.0,1170.0,1,HONEY POP,Bag
VIDEXPORT,24E17475,05/31/2024,Sale,-990.0,180.0,1,HONEY POP,Bag
VIDEXPORT,24E17475,06/03/2024,Sale,-90.0,90.0,4,HONEY POP,Bag
VIDEXPORT,24E17475,06/08/2024,Sale,-90.0,0.0,9,HONEY POP,Bag
VIDEXPORT,24E17480,05/31/2024,Entry,2340.0,2340.0,0,HONEY POP,Bag
VIDEXPORT,24E17480,06/01/2024,Sale,-540.0,1800.0,1,HONEY POP,Bag
VIDEXPORT,24E17480,06/01/2024,Sale,-540.0,1260.0,1,HONEY POP,Bag
VIDEXPORT,24E17480,06/12/2024,Sale,-630.0,630.0,12,HONEY POP,Bag
VIDEXPORT,24E17480,06/12/2024,Sale,-540.0,90.0,12,HONEY POP,Bag
VIDEXPORT,24E17480,06/17/2024,Sale,-90.0,0.0,17,HONEY POP,Bag
VIDEXPORT,24E17481,05/31/2024,Entry,2340.0,2340.0,0,HONEY POP,Bag
VIDEXPORT,24E17481,06/01/2024,Sale,-180.0,2160.0,1,HONEY POP,Bag
VIDEXPORT,24E17481,06/03/2024,Sale,-720.0,1440.0,3,HONEY POP,Bag
VIDEXPORT,24E17481,06/03/2024,Sale,-90.0,1350.0,3,HONEY POP,Bag
VIDEXPORT,24E17481,06/04/2024,Sale,-90.0,1260.0,4,HONEY POP,Bag
VIDEXPORT,24E17481,06/06/2024,Sale,-720.0,540.0,6,HONEY POP,Bag
VIDEXPORT,24E17481,06/06/2024,Sale,-540.0,0.0,6,HONEY POP,Bag
VIDEXPORT,24E17482,05/31/2024,Entry,2340.0,2340.0,0,HONEY POP,Bag
VIDEXPORT,24E17482,06/03/2024,Sale,-630.0,1710.0,3,HONEY POP,Bag
VIDEXPORT,24E17482,06/07/2024,Sale,-630.0,1080.0,7,HONEY POP,Bag
VIDEXPORT,24E17482,06/08/2024,Sale,-450.0,630.0,8,HONEY POP,Bag
VIDEXPORT,24E17482,06/12/2024,Sale,-450.0,180.0,12,HONEY POP,Bag
VIDEXPORT,24E17482,06/12/2024,Sale,-90.0,90.0,12,HONEY POP,Bag
VIDEXPORT,24E17482,09/30/2024,Sale,-90.0,0.0,122,HONEY POP,Bag
VIDEXPORT,24E17483,06/01/2024,Entry,1530.0,1530.0,0,HONEY POP,Bag
VIDEXPORT,24E17483,06/01/2024,Entry,810.0,2340.0,0,HONEY POP,Bag
VIDEXPORT,24E17483,06/03/2024,Sale,-90.0,2250.0,2,HONEY POP,Bag
VIDEXPORT,24E17483,06/03/2024,Sale,-360.0,1890.0,2,HONEY POP,Bag
VIDEXPORT,24E17483,06/05/2024,Sale,-360.0,1530.0,4,HONEY POP,Bag
VIDEXPORT,24E17483,06/06/2024,Sale,-810.0,720.0,5,HONEY POP,Bag
VIDEXPORT,24E17483,06/06/2024,Sale,-360.0,360.0,5,HONEY POP,Bag
VIDEXPORT,24E17483,06/06/2024,Sale,-180.0,180.0,5,HONEY POP,Bag
VIDEXPORT,24E17483,06/15/2024,Sale,-90.0,90.0,14,HONEY POP,Bag
VIDEXPORT,24E17483,07/10/2024,Sale,-90.0,0.0,39,HONEY POP,Bag
VIDEXPORT,24E17487,05/30/2024,Entry,1800.0,1800.0,0,HONEY POP,Bag
VIDEXPORT,24E17487,06/07/2024,Sale,-1080.0,720.0,8,HONEY POP,Bag
VIDEXPORT,24E17487,06/15/2024,Sale,-540.0,180.0,16,HONEY POP,Bag
VIDEXPORT,24E17487,06/17/2024,Sale,-180.0,0.0,18,HONEY POP,Bag
VIDEXPORT,24E17488,05/31/2024,Entry,1710.0,1710.0,0,HONEY POP,Bag
VIDEXPORT,24E17488,06/03/2024,Sale,-1710.0,0.0,3,HONEY POP,Bag
VIDEXPORT,24E17490,06/01/2024,Entry,2340.0,2340.0,0,HONEY POP,Bag
VIDEXPORT,24E17490,06/01/2024,Sale,-1350.0,990.0,0,HONEY POP,Bag
VIDEXPORT,24E17490,06/01/2024,Sale,-990.0,0.0,0,HONEY POP,Bag
VIDEXPORT,24E17491,05/31/2024,Entry,1920.0,1920.0,0,HONEY POP,Clam
VIDEXPORT,24E17491,05/31/2024,Sale,-1920.0,0.0,0,HONEY POP,Clam
VIDEXPORT,24E17493,05/31/2024,Entry,2210.0,2210.0,0,HONEY POP,Bag
VIDEXPORT,24E17493,06/03/2024,Sale,-1020.0,1190.0,3,HONEY POP,Bag
VIDEXPORT,24E17493,06/03/2024,Sale,-85.0,1105.0,3,HONEY POP,Bag
VIDEXPORT,24E17493,06/04/2024,Sale,-595.0,510.0,4,HONEY POP,Bag
VIDEXPORT,24E17493,06/08/2024,Sale,-170.0,340.0,8,HONEY POP,Bag
VIDEXPORT,24E17493,06/12/2024,Sale,-340.0,0.0,12,HONEY POP,Bag
VIDEXPORT,24E17497,05/31/2024,Entry,1920.0,1920.0,0,HONEY POP,Clam
VIDEXPORT,24E17497,05/31/2024,Sale,-1920.0,0.0,0,HONEY POP,Clam
VIDEXPORT,24E17500,06/01/2024,Entry,1710.0,1710.0,0,HONEY POP,Bag
VIDEXPORT,24E17500,06/03/2024,Sale,-630.0,1080.0,2,HONEY POP,Bag
VIDEXPORT,24E17500,06/03/2024,Sale,-990.0,90.0,2,HONEY POP,Bag
VIDEXPORT,24E17500,06/06/2024,Sale,-90.0,0.0,5,HONEY POP,Bag
VIDEXPORT,24E17501,06/01/2024,Entry,850.0,850.0,0,HONEY POP,Clam
VIDEXPORT,24E17501,06/01/2024,Entry,800.0,1650.0,0,HONEY POP,Clam
VIDEXPORT,24E17501,06/01/2024,Sale,-800.0,850.0,0,HONEY POP,Clam
VIDEXPORT,24E17501,06/15/2024,Sale,-510.0,340.0,14,HONEY POP,Bag
VIDEXPORT,24E17501,06/17/2024,Sale,-340.0,0.0,16,HONEY POP,Bag
VIDEXPORT,24E17506,06/01/2024,Entry,1920.0,1920.0,0,HONEY POP,Clam
VIDEXPORT,24E17506,06/03/2024,Sale,-1920.0,0.0,2,HONEY POP,Clam
VIDEXPORT,24E17509,06/03/2024,Entry,2340.0,2340.0,0,HONEY POP,Bag
VIDEXPORT,24E17509,06/03/2024,Sale,-180.0,2160.0,0,HONEY POP,Bag
VIDEXPORT,24E17509,06/03/2024,Sale,-180.0,1980.0,0,HONEY POP,Bag
VIDEXPORT,24E17509,06/03/2024,Sale,-1980.0,0.0,0,HONEY POP,Bag
VIDEXPORT,24E17510,06/03/2024,Entry,2240.0,2240.0,0,HONEY POP,Clam
VIDEXPORT,24E17510,06/03/2024,Sale,-1920.0,320.0,0,HONEY POP,Clam
VIDEXPORT,24E17510,06/05/2024,Sale,-80.0,240.0,2,HONEY POP,Clam
VIDEXPORT,24E17510,06/08/2024,Sale,-80.0,160.0,5,HONEY POP,Clam
VIDEXPORT,24E17510,06/11/2024,Sale,-160.0,0.0,8,HONEY POP,Clam
VIDEXPORT,24E17511,06/03/2024,Entry,2340.0,2340.0,0,HONEY POP,Bag
VIDEXPORT,24E17511,06/03/2024,Sale,-90.0,2250.0,0,HONEY POP,Bag
VIDEXPORT,24E17511,06/03/2024,Sale,-1530.0,720.0,0,HONEY POP,Bag
VIDEXPORT,24E17511,06/03/2024,Sale,-630.0,90.0,0,HONEY POP,Bag
VIDEXPORT,24E17511,06/04/2024,Sale,-90.0,0.0,1,HONEY POP,Bag
VIDEXPORT,24E17514,06/03/2024,Entry,1875.0,1875.0,0,HONEY POP,Unknown
VIDEXPORT,24E17514,06/06/2024,Sale,-900.0,975.0,3,HONEY POP,Unknown
VIDEXPORT,24E17514,06/06/2024,Sale,-450.0,525.0,3,HONEY POP,Unknown
VIDEXPORT,24E17514,06/07/2024,Sale,-225.0,300.0,4,HONEY POP,Unknown
VIDEXPORT,24E17514,06/07/2024,Sale,-225.0,75.0,4,HONEY POP,Unknown
VIDEXPORT,24E17514,06/18/2024,Sale,-75.0,0.0,15,HONEY POP,Unknown
VIDEXPORT,24E17515,06/03/2024,Entry,2340.0,2340.0,0,HONEY POP,Bag
VIDEXPORT,24E17515,06/03/2024,Sale,-1800.0,540.0,0,HONEY POP,Bag
VIDEXPORT,24E17515,06/04/2024,Sale,-540.0,0.0,1,HONEY POP,Bag
VIDEXPORT,24E17516,06/03/2024,Entry,1800.0,1800.0,0,HONEY POP,Bag
VIDEXPORT,24E17516,06/03/2024,Entry,160.0,1960.0,0,HONEY POP,Bag
VIDEXPORT,24E17516,06/03/2024,Sale,-450.0,1510.0,0,HONEY POP,Bag
VIDEXPORT,24E17516,06/03/2024,Sale,-1260.0,250.0,0,HONEY POP,Bag
VIDEXPORT,24E17516,06/04/2024,Sale,-90.0,160.0,1,HONEY POP,Bag
VIDEXPORT,24E17516,06/08/2024,Sale,-160.0,0.0,5,HONEY POP,Clam
VIDEXPORT,24E17518,06/04/2024,Entry,2340.0,2340.0,0,HONEY POP,Bag
VIDEXPORT,24E17518,06/06/2024,Sale,-180.0,2160.0,2,HONEY POP,Bag
VIDEXPORT,24E17518,06/07/2024,Sale,-180.0,1980.0,3,HONEY POP,Bag
VIDEXPORT,24E17518,06/07/2024,Sale,-810.0,1170.0,3,HONEY POP,Bag
VIDEXPORT,24E17518,06/07/2024,Sale,-1080.0,90.0,3,HONEY POP,Bag
VIDEXPORT,24E17518,06/07/2024,Sale,-90.0,0.0,3,HONEY POP,Bag
VIDEXPORT,24E17519,06/03/2024,Entry,2340.0,2340.0,0,HONEY POP,Bag
VIDEXPORT,24E17519,06/04/2024,Sale,-450.0,1890.0,1,HONEY POP,Bag
VIDEXPORT,24E17519,06/07/2024,Sale,-1890.0,0.0,4,HONEY POP,Bag
VIDEXPORT,24E17521,06/04/2024,Entry,1800.0,1800.0,0,HONEY POP,Unknown
VIDEXPORT,24E17521,06/07/2024,Sale,-150.0,1650.0,3,HONEY POP,Unknown
VIDEXPORT,24E17521,06/08/2024,Sale,-225.0,1425.0,4,HONEY POP,Unknown
VIDEXPORT,24E17521,06/08/2024,Sale,-375.0,1050.0,4,HONEY POP,Unknown
VIDEXPORT,24E17521,06/10/2024,Sale,-225.0,825.0,6,HONEY POP,Unknown
VIDEXPORT,24E17521,06/10/2024,Sale,-375.0,450.0,6,HONEY POP,Unknown
VIDEXPORT,24E17521,06/10/2024,Sale,-225.0,225.0,6,HONEY POP,Unknown
VIDEXPORT,24E17521,06/11/2024,Sale,-150.0,75.0,7,HONEY POP,Unknown
VIDEXPORT,24E17521,06/12/2024,Sale,-75.0,0.0,8,HONEY POP,Unknown
VIDEXPORT,24E17523,06/04/2024,Entry,2340.0,2340.0,0,HONEY POP,Bag
VIDEXPORT,24E17523,06/05/2024,Sale,-90.0,2250.0,1,HONEY POP,Bag
VIDEXPORT,24E17523,06/07/2024,Sale,-540.0,1710.0,3,HONEY POP,Bag
VIDEXPORT,24E17523,06/07/2024,Sale,-810.0,900.0,3,HONEY POP,Bag
VIDEXPORT,24E17523,06/07/2024,Sale,-720.0,180.0,3,HONEY POP,Bag
VIDEXPORT,24E17523,06/07/2024,Sale,-180.0,0.0,3,HONEY POP,Bag
VIDEXPORT,24E17524,06/04/2024,Entry,1800.0,1800.0,0,HONEY POP,Unknown
VIDEXPORT,24E17524,06/04/2024,Sale,-675.0,1125.0,0,HONEY POP,Unknown
VIDEXPORT,24E17524,06/07/2024,Sale,-450.0,675.0,3,HONEY POP,Unknown
VIDEXPORT,24E17524,06/11/2024,Sale,-225.0,450.0,7,HONEY POP,Unknown
VIDEXPORT,24E17524,06/12/2024,Sale,-225.0,225.0,8,HONEY POP,Unknown
VIDEXPORT,24E17524,06/12/2024,Sale,-75.0,150.0,8,HONEY POP,Unknown
VIDEXPORT,24E17524,06/12/2024,Sale,-150.0,0.0,8,HONEY POP,Unknown
VIDEXPORT,24E17525,06/04/2024,Entry,2340.0,2340.0,0,HONEY POP,Bag
VIDEXPORT,24E17525,06/07/2024,Sale,-360.0,1980.0,3,HONEY POP,Bag
VIDEXPORT,24E17525,06/07/2024,Sale,-1530.0,450.0,3,HONEY POP,Bag
VIDEXPORT,24E17525,06/07/2024,Sale,-450.0,0.0,3,HONEY POP,Bag
VIDEXPORT,24E17528,06/04/2024,Entry,1950.0,1950.0,0,HONEY POP,Unknown
VIDEXPORT,24E17528,06/13/2024,Sale,-225.0,1725.0,9,HONEY POP,Unknown
VIDEXPORT,24E17528,06/14/2024,Sale,-75.0,1650.0,10,HONEY POP,Unknown
VIDEXPORT,24E17528,06/15/2024,Sale,-150.0,1500.0,11,HONEY POP,Unknown
VIDEXPORT,24E17528,06/15/2024,Sale,-225.0,1275.0,11,HONEY POP,Unknown
VIDEXPORT,24E17528,06/15/2024,Sale,-300.0,975.0,11,HONEY POP,Unknown
VIDEXPORT,24E17528,06/17/2024,Sale,-225.0,750.0,13,HONEY POP,Unknown
VIDEXPORT,24E17528,06/17/2024,Sale,-300.0,450.0,13,HONEY POP,Unknown
VIDEXPORT,24E17528,06/18/2024,Sale,-300.0,150.0,14,HONEY POP,Unknown
VIDEXPORT,24E17528,06/21/2024,Sale,-150.0,0.0,17,HONEY POP,Unknown
VIDEXPORT,24E17529,06/03/2024,Entry,2160.0,2160.0,0,HONEY POP,Bag
VIDEXPORT,24E17529,06/03/2024,Sale,-1260.0,900.0,0,HONEY POP,Bag
VIDEXPORT,24E17529,06/03/2024,Sale,-720.0,180.0,0,HONEY POP,Bag
VIDEXPORT,24E17529,06/04/2024,Sale,-180.0,0.0,1,HONEY POP,Bag
VIDEXPORT,24E17530,06/03/2024,Entry,2340.0,2340.0,0,HONEY POP,Bag
VIDEXPORT,24E17530,06/07/2024,Sale,-90.0,2250.0,4,HONEY POP,Bag
VIDEXPORT,24E17530,06/07/2024,Sale,-180.0,2070.0,4,HONEY POP,Bag
VIDEXPORT,24E17530,06/07/2024,Sale,-270.0,1800.0,4,HONEY POP,Bag
VIDEXPORT,24E17530,06/07/2024,Sale,-1800.0,0.0,4,HONEY POP,Bag
VIDEXPORT,24E17531,06/04/2024,Entry,2340.0,2340.0,0,HONEY POP,Bag
VIDEXPORT,24E17531,06/06/2024,Sale,-1620.0,720.0,2,HONEY POP,Bag
VIDEXPORT,24E17531,06/06/2024,Sale,-540.0,180.0,2,HONEY POP,Bag
VIDEXPORT,24E17531,06/07/2024,Sale,-180.0,0.0,3,HONEY POP,Bag
VIDEXPORT,24E17532,06/04/2024,Entry,2340.0,2340.0,0,HONEY POP,Bag
VIDEXPORT,24E17532,06/07/2024,Sale,-1800.0,540.0,3,HONEY POP,Bag
VIDEXPORT,24E17532,06/07/2024,Sale,-540.0,0.0,3,HONEY POP,Bag
VIDEXPORT,24E17533,06/03/2024,Entry,2340.0,2340.0,0,HONEY POP,Bag
VIDEXPORT,24E17533,06/07/2024,Sale,-1710.0,630.0,4,HONEY POP,Bag
VIDEXPORT,24E17533,06/07/2024,Sale,-630.0,0.0,4,HONEY POP,Bag
VIDEXPORT,24E17535,06/06/2024,Entry,1575.0,1575.0,0,HONEY POP,Unknown
VIDEXPORT,24E17535,06/12/2024,Sale,-75.0,1500.0,6,HONEY POP,Unknown
VIDEXPORT,24E17535,06/13/2024,Sale,-75.0,1425.0,7,HONEY POP,Unknown
VIDEXPORT,24E17535,06/14/2024,Sale,-225.0,1200.0,8,HONEY POP,Unknown
VIDEXPORT,24E17535,06/14/2024,Sale,-300.0,900.0,8,HONEY POP,Unknown
VIDEXPORT,24E17535,06/14/2024,Sale,-150.0,750.0,8,HONEY POP,Unknown
VIDEXPORT,24E17535,06/20/2024,Sale,-300.0,450.0,14,HONEY POP,Unknown
VIDEXPORT,24E17535,06/21/2024,Sale,-75.0,375.0,15,HONEY POP,Unknown
VIDEXPORT,24E17535,06/21/2024,Sale,-75.0,300.0,15,HONEY POP,Unknown
VIDEXPORT,24E17535,06/21/2024,Sale,-300.0,0.0,15,HONEY POP,Unknown
VIDEXPORT,24E17536,06/04/2024,Entry,2340.0,2340.0,0,HONEY POP,Bag
VIDEXPORT,24E17536,06/04/2024,Sale,-1980.0,360.0,0,HONEY POP,Bag
VIDEXPORT,24E17536,06/05/2024,Sale,-180.0,180.0,1,HONEY POP,Bag
VIDEXPORT,24E17536,06/07/2024,Sale,-180.0,0.0,3,HONEY POP,Bag
VIDEXPORT,24E17538,06/04/2024,Entry,2520.0,2520.0,0,HONEY POP,Bag
VIDEXPORT,24E17538,06/04/2024,Sale,-1080.0,1440.0,0,HONEY POP,Bag
VIDEXPORT,24E17538,06/04/2024,Sale,-270.0,1170.0,0,HONEY POP,Bag
VIDEXPORT,24E17538,06/04/2024,Sale,-990.0,180.0,0,HONEY POP,Bag
VIDEXPORT,24E17538,06/05/2024,Sale,-180.0,0.0,1,HONEY POP,Bag
VIDEXPORT,24E17539,06/04/2024,Entry,2250.0,2250.0,0,HONEY POP,Bag
VIDEXPORT,24E17539,06/04/2024,Sale,-360.0,1890.0,0,HONEY POP,Bag
VIDEXPORT,24E17539,06/05/2024,Sale,-810.0,1080.0,1,HONEY POP,Bag
VIDEXPORT,24E17539,06/05/2024,Sale,-720.0,360.0,1,HONEY POP,Bag
VIDEXPORT,24E17539,06/06/2024,Sale,-360.0,0.0,2,HONEY POP,Bag
VIDEXPORT,24E17540,06/04/2024,Entry,2340.0,2340.0,0,HONEY POP,Bag
VIDEXPORT,24E17540,06/05/2024,Sale,-180.0,2160.0,1,HONEY POP,Bag
VIDEXPORT,24E17540,06/07/2024,Sale,-270.0,1890.0,3,HONEY POP,Bag
VIDEXPORT,24E17540,06/07/2024,Sale,-1800.0,90.0,3,HONEY POP,Bag
VIDEXPORT,24E17540,06/07/2024,Sale,-90.0,0.0,3,HONEY POP,Bag
VIDEXPORT,24E17541,06/04/2024,Entry,2340.0,2340.0,0,HONEY POP,Bag
VIDEXPORT,24E17541,06/05/2024,Sale,-1980.0,360.0,1,HONEY POP,Bag
VIDEXPORT,24E17541,06/06/2024,Sale,-270.0,90.0,2,HONEY POP,Bag
VIDEXPORT,24E17541,06/06/2024,Sale,-90.0,0.0,2,HONEY POP,Bag
VIDEXPORT,24E17542,06/04/2024,Entry,2340.0,2340.0,0,HONEY POP,Bag
VIDEXPORT,24E17542,06/05/2024,Sale,-1620.0,720.0,1,HONEY POP,Bag
VIDEXPORT,24E17542,06/06/2024,Sale,-90.0,630.0,2,HONEY POP,Bag
VIDEXPORT,24E17542,06/07/2024,Sale,-630.0,0.0,3,HONEY POP,Bag
VIDEXPORT,24E17543,06/05/2024,Entry,2340.0,2340.0,0,HONEY POP,Bag
VIDEXPORT,24E17543,06/06/2024,Sale,-90.0,2250.0,1,HONEY POP,Bag
VIDEXPORT,24E17543,06/06/2024,Sale,-1530.0,720.0,1,HONEY POP,Bag
VIDEXPORT,24E17543,06/06/2024,Sale,-720.0,0.0,1,HONEY POP,Bag
VIDEXPORT,24E17546,06/05/2024,Entry,2160.0,2160.0,0,HONEY POP,Bag
VIDEXPORT,24E17546,06/06/2024,Sale,-720.0,1440.0,1,HONEY POP,Bag
VIDEXPORT,24E17546,06/06/2024,Sale,-450.0,990.0,1,HONEY POP,Bag
VIDEXPORT,24E17546,06/07/2024,Sale,-630.0,360.0,2,HONEY POP,Bag
VIDEXPORT,24E17546,06/07/2024,Sale,-180.0,180.0,2,HONEY POP,Bag
VIDEXPORT,24E17546,06/10/2024,Sale,-180.0,0.0,5,HONEY POP,Bag
VIDEXPORT,24E17547,06/05/2024,Entry,2160.0,2160.0,0,HONEY POP,Bag
VIDEXPORT,24E17547,06/06/2024,Sale,-1800.0,360.0,1,HONEY POP,Bag
VIDEXPORT,24E17547,06/06/2024,Sale,-360.0,0.0,1,HONEY POP,Bag
VIDEXPORT,24E17548,06/05/2024,Entry,2160.0,2160.0,0,HONEY POP,Bag
VIDEXPORT,24E17548,06/06/2024,Sale,-900.0,1260.0,1,HONEY POP,Bag
VIDEXPORT,24E17548,06/08/2024,Sale,-1170.0,90.0,3,HONEY POP,Bag
VIDEXPORT,24E17548,07/10/2024,Sale,-90.0,0.0,35,HONEY POP,Bag
VIDEXPORT,24E17549,06/04/2024,Entry,2160.0,2160.0,0,HONEY POP,Bag
VIDEXPORT,24E17549,06/05/2024,Sale,-1800.0,360.0,1,HONEY POP,Bag
VIDEXPORT,24E17549,06/05/2024,Sale,-180.0,180.0,1,HONEY POP,Bag
VIDEXPORT,24E17549,06/06/2024,Sale,-180.0,0.0,2,HONEY POP,Bag
VIDEXPORT,24E17550,06/06/2024,Entry,1920.0,1920.0,0,HONEY POP,Clam
VIDEXPORT,24E17550,06/06/2024,Sale,-320.0,1600.0,0,HONEY POP,Clam
VIDEXPORT,24E17550,06/06/2024,Sale,-160.0,1440.0,0,HONEY POP,Clam
VIDEXPORT,24E17550,06/11/2024,Sale,-1440.0,0.0,5,HONEY POP,Clam
VIDEXPORT,24E17551,06/05/2024,Entry,2080.0,2080.0,0,HONEY POP,Clam
VIDEXPORT,24E17551,06/05/2024,Sale,-1840.0,240.0,0,HONEY POP,Clam
VIDEXPORT,24E17551,06/06/2024,Sale,-80.0,160.0,1,HONEY POP,Clam
VIDEXPORT,24E17551,06/07/2024,Sale,-160.0,0.0,2,HONEY POP,Clam
VIDEXPORT,24E17552,06/07/2024,Entry,1760.0,1760.0,0,HONEY POP,Clam
VIDEXPORT,24E17552,06/07/2024,Sale,-1760.0,0.0,0,HONEY POP,Clam
VIDEXPORT,24E17553,06/07/2024,Entry,540.0,540.0,0,HONEY POP,Bag
VIDEXPORT,24E17553,06/07/2024,Entry,1280.0,1820.0,0,HONEY POP,Bag
VIDEXPORT,24E17553,06/08/2024,Sale,-450.0,1370.0,1,HONEY POP,Bag
VIDEXPORT,24E17553,06/08/2024,Sale,-1280.0,90.0,1,HONEY POP,Clam
VIDEXPORT,24E17553,06/10/2024,Sale,-90.0,0.0,3,HONEY POP,Bag
VIDEXPORT,24E17554,06/07/2024,Entry,2340.0,2340.0,0,HONEY POP,Bag
VIDEXPORT,24E17554,06/07/2024,Sale,-450.0,1890.0,0,HONEY POP,Bag
VIDEXPORT,24E17554,06/07/2024,Sale,-360.0,1530.0,0,HONEY POP,Bag
VIDEXPORT,24E17554,06/08/2024,Sale,-720.0,810.0,1,HONEY POP,Bag
VIDEXPORT,24E17554,06/08/2024,Sale,-360.0,450.0,1,HONEY POP,Bag
VIDEXPORT,24E17554,06/10/2024,Sale,-270.0,180.0,3,HONEY POP,Bag
VIDEXPORT,24E17554,06/10/2024,Sale,-180.0,0.0,3,HONEY POP,Bag
VIDEXPORT,24E7204,05/15/2024,Entry,2340.0,2340.0,0,EARLY SWEET,Bag
VIDEXPORT,24E7204,05/18/2024,Sale,-1980.0,360.0,3,EARLY SWEET,Bag
VIDEXPORT,24E7204,05/20/2024,Sale,-270.0,90.0,5,EARLY SWEET,Bag
VIDEXPORT,24E7204,05/20/2024,Sale,-90.0,0.0,5,EARLY SWEET,Bag
VIDEXPORT,24E7206,05/15/2024,Entry,2340.0,2340.0,0,EARLY SWEET,Bag
VIDEXPORT,24E7206,05/17/2024,Sale,-180.0,2160.0,2,EARLY SWEET,Bag
VIDEXPORT,24E7206,05/17/2024,Sale,-1530.0,630.0,2,EARLY SWEET,Bag
VIDEXPORT,24E7206,05/17/2024,Sale,-90.0,540.0,2,EARLY SWEET,Bag
VIDEXPORT,24E7206,05/17/2024,Sale,-180.0,360.0,2,EARLY SWEET,Bag
VIDEXPORT,24E7206,05/18/2024,Sale,-360.0,0.0,3,EARLY SWEET,Bag
VIDEXPORT,24E7207,05/16/2024,Entry,2340.0,2340.0,0,EARLY SWEET,Bag
VIDEXPORT,24E7207,05/17/2024,Sale,-1350.0,990.0,1,EARLY SWEET,Bag
VIDEXPORT,24E7207,05/20/2024,Sale,-450.0,540.0,4,EARLY SWEET,Bag
VIDEXPORT,24E7207,05/21/2024,Sale,-90.0,450.0,5,EARLY SWEET,Bag
VIDEXPORT,24E7207,05/22/2024,Sale,-360.0,90.0,6,EARLY SWEET,Bag
VIDEXPORT,24E7207,05/22/2024,Sale,-90.0,0.0,6,EARLY SWEET,Bag
VIDEXPORT,24E7209,05/16/2024,Entry,1710.0,1710.0,0,EARLY SWEET,Bag
VIDEXPORT,24E7209,05/16/2024,Entry,630.0,2340.0,0,EARLY SWEET,Bag
VIDEXPORT,24E7209,05/17/2024,Sale,-630.0,1710.0,1,EARLY SWEET,Bag
VIDEXPORT,24E7209,05/18/2024,Sale,-90.0,1620.0,2,EARLY SWEET,Bag
VIDEXPORT,24E7209,05/18/2024,Sale,-630.0,990.0,2,EARLY SWEET,Bag
VIDEXPORT,24E7209,05/18/2024,Sale,-90.0,900.0,2,EARLY SWEET,Bag
VIDEXPORT,24E7209,05/18/2024,Sale,-90.0,810.0,2,EARLY SWEET,Bag
VIDEXPORT,24E7209,05/20/2024,Sale,-540.0,270.0,4,EARLY SWEET,Bag
VIDEXPORT,24E7209,05/21/2024,Sale,-270.0,0.0,5,EARLY SWEET,Bag
VIDEXPORT,24E7210,05/16/2024,Entry,90.0,90.0,0,EARLY SWEET,Bag
VIDEXPORT,24E7210,05/16/2024,Entry,1800.0,1890.0,0,EARLY SWEET,Bag
VIDEXPORT,24E7210,05/16/2024,Entry,270.0,2160.0,0,EARLY SWEET,Bag
VIDEXPORT,24E7210,05/20/2024,Sale,-90.0,2070.0,4,EARLY SWEET,Bag
VIDEXPORT,24E7210,05/20/2024,Sale,-360.0,1710.0,4,EARLY SWEET,Bag
VIDEXPORT,24E7210,05/20/2024,Sale,-180.0,1530.0,4,EARLY SWEET,Bag
VIDEXPORT,24E7210,05/20/2024,Sale,-180.0,1350.0,4,EARLY SWEET,Bag
VIDEXPORT,24E7210,05/20/2024,Sale,-720.0,630.0,4,EARLY SWEET,Bag
VIDEXPORT,24E7210,05/20/2024,Sale,-270.0,360.0,4,EARLY SWEET,Bag
VIDEXPORT,24E7210,05/21/2024,Sale,-360.0,0.0,5,EARLY SWEET,Bag
VIDEXPORT,24E7217,05/16/2024,Entry,2339.0,2339.0,0,EARLY SWEET,Bag
VIDEXPORT,24E7217,05/20/2024,Sale,-179.0,2160.0,4,EARLY SWEET,Bag
VIDEXPORT,24E7217,05/21/2024,Sale,-450.0,1710.0,5,EARLY SWEET,Bag
VIDEXPORT,24E7217,05/22/2024,Sale,-90.0,1620.0,6,EARLY SWEET,Bag
VIDEXPORT,24E7217,05/23/2024,Sale,-1350.0,270.0,7,EARLY SWEET,Bag
VIDEXPORT,24E7217,05/24/2024,Sale,-270.0,0.0,8,EARLY SWEET,Bag
VIDEXPORT,24E7220,05/16/2024,Entry,2340.0,2340.0,0,EARLY SWEET,Bag
VIDEXPORT,24E7220,05/18/2024,Sale,-180.0,2160.0,2,EARLY SWEET,Bag
VIDEXPORT,24E7220,05/20/2024,Sale,-1980.0,180.0,4,EARLY SWEET,Bag
VIDEXPORT,24E7220,05/20/2024,Sale,-180.0,0.0,4,EARLY SWEET,Bag
VIDEXPORT,24E7224,05/16/2024,Entry,2340.0,2340.0,0,EARLY SWEET,Bag
VIDEXPORT,24E7224,05/22/2024,Sale,-1885.0,455.0,6,EARLY SWEET,Bag
VIDEXPORT,24E7224,05/22/2024,Sale,-5.0,450.0,6,EARLY SWEET,Bag
VIDEXPORT,24E7224,05/22/2024,Sale,-360.0,90.0,6,EARLY SWEET,Bag
VIDEXPORT,24E7224,05/23/2024,Sale,-90.0,0.0,7,EARLY SWEET,Bag
VIDEXPORT,24E7226,05/17/2024,Entry,2520.0,2520.0,0,EARLY SWEET,Bag
VIDEXPORT,24E7226,05/21/2024,Sale,-270.0,2250.0,4,EARLY SWEET,Bag
VIDEXPORT,24E7226,05/21/2024,Sale,-180.0,2070.0,4,EARLY SWEET,Bag
VIDEXPORT,24E7226,05/22/2024,Sale,-180.0,1890.0,5,EARLY SWEET,Bag
VIDEXPORT,24E7226,05/22/2024,Sale,-1890.0,0.0,5,EARLY SWEET,Bag
VIDEXPORT,24E7227,05/17/2024,Entry,2160.0,2160.0,0,EARLY SWEET,Bag
VIDEXPORT,24E7227,05/20/2024,Sale,-1170.0,990.0,3,EARLY SWEET,Bag
VIDEXPORT,24E7227,05/20/2024,Sale,-90.0,900.0,3,EARLY SWEET,Bag
VIDEXPORT,24E7227,05/22/2024,Sale,-720.0,180.0,5,EARLY SWEET,Bag
VIDEXPORT,24E7227,05/22/2024,Sale,-180.0,0.0,5,EARLY SWEET,Bag
VIDEXPORT,24E7232,05/17/2024,Entry,90.0,90.0,0,EARLY SWEET,Bag
VIDEXPORT,24E7232,05/17/2024,Entry,810.0,900.0,0,EARLY SWEET,Bag
VIDEXPORT,24E7232,05/17/2024,Entry,1440.0,2340.0,0,EARLY SWEET,Bag
VIDEXPORT,24E7232,05/21/2024,Sale,-810.0,1530.0,4,EARLY SWEET,Bag
VIDEXPORT,24E7232,05/21/2024,Sale,-450.0,1080.0,4,EARLY SWEET,Bag
VIDEXPORT,24E7232,05/22/2024,Sale,-990.0,90.0,5,EARLY SWEET,Bag
VIDEXPORT,24E7232,05/29/2024,Sale,-90.0,0.0,12,EARLY SWEET,Bag
VIDEXPORT,24TRA104847,06/12/2024,Entry,2520.0,2520.0,0,EARLY SWEET,Bag
VIDEXPORT,24TRA104847,06/14/2024,Sale,-1980.0,540.0,2,EARLY SWEET,Bag
VIDEXPORT,24TRA104847,06/15/2024,Sale,-270.0,270.0,3,EARLY SWEET,Bag
VIDEXPORT,24TRA104847,06/15/2024,Sale,-270.0,0.0,3,EARLY SWEET,Bag
