Exporter,Lotid,Date,Movement,Quantity,Inventory Balance,Days In Inventory,Variety,Packaging Style
Agrolatina,24A0005623,03/13/2025,Entry,240.0,240.0,0,AUTUMN CRISP,Clam
Agrolatina,24A0005623,03/13/2025,Entry,1360.0,1600.0,0,AUTUMN CRISP,Clam
Agrolatina,24A0005623,03/28/2025,Sale,-80.0,1520.0,15,AUTUMN CRISP,Clam
Agrolatina,24A0005623,03/29/2025,Sale,-240.0,1280.0,16,AUTUMN CRISP,Clam
Agrolatina,24A0005623,03/31/2025,Sale,-960.0,320.0,18,AUTUMN CRISP,Clam
Agrolatina,24A0005623,04/01/2025,Sale,-160.0,160.0,19,AUTUMN CRISP,Clam
Agrolatina,24A0005623,04/01/2025,Sale,-160.0,0.0,19,AUTUMN CRISP,Clam
Agrolatina,24A0026441,03/03/2025,Entry,1120.0,1120.0,0,TIMCO,Clam
Agrolatina,24A0026441,03/03/2025,Entry,480.0,1600.0,0,TIMCO,Clam
Agrolatina,24A0026441,03/27/2025,Sale,-320.0,1280.0,24,TIMCO,Clam
Agrolatina,24A0026441,04/01/2025,Sale,-80.0,1200.0,29,TIMCO,Clam
Agrolatina,24A0026441,04/01/2025,Sale,-480.0,720.0,29,TIMCO,Clam
Agrolatina,24A0026441,04/02/2025,Sale,-240.0,480.0,30,TIMCO,Clam
Agrolatina,24A0026441,04/02/2025,Sale,-320.0,160.0,30,TIMCO,Clam
Agrolatina,24A0026441,04/03/2025,Sale,-80.0,80.0,31,TIMCO,Clam
Agrolatina,24A0057740,02/24/2025,Entry,1280.0,1280.0,0,TIMCO,Clam
Agrolatina,24A0057740,02/24/2025,Entry,320.0,1600.0,0,TIMCO,Clam
Agrolatina,24A0066022,03/03/2025,Entry,1360.0,1360.0,0,TIMCO,Clam
Agrolatina,24A0066022,03/03/2025,Entry,240.0,1600.0,0,TIMCO,Clam
Agrolatina,24A0066022,03/21/2025,Sale,-480.0,1120.0,18,TIMCO,Clam
Agrolatina,24A0066022,03/24/2025,Sale,-800.0,320.0,21,TIMCO,Clam
Agrolatina,24A0066022,03/26/2025,Sale,-80.0,240.0,23,TIMCO,Clam
Agrolatina,24A0066022,03/29/2025,Sale,-80.0,160.0,26,TIMCO,Clam
Agrolatina,24A0066022,03/29/2025,Sale,-80.0,80.0,26,TIMCO,Clam
Agrolatina,24A0066022,03/31/2025,Sale,-80.0,0.0,28,TIMCO,Clam
Agrolatina,24A0066887,02/13/2025,Entry,960.0,960.0,0,SWEET GLOBE,Clam
Agrolatina,24A0066887,02/13/2025,Entry,640.0,1600.0,0,SWEET GLOBE,Clam
Agrolatina,24A0066887,02/20/2025,Sale,-80.0,1520.0,7,SWEET GLOBE,Clam
Agrolatina,24A0066887,02/24/2025,Sale,-480.0,1040.0,11,SWEET GLOBE,Clam
Agrolatina,24A0066887,02/26/2025,Sale,-240.0,800.0,13,SWEET GLOBE,Clam
Agrolatina,24A0066887,02/26/2025,Sale,-199.0,601.0,13,SWEET GLOBE,Clam
Agrolatina,24A0066887,02/26/2025,Sale,-120.0,481.0,13,SWEET GLOBE,Clam
Agrolatina,24A0066887,02/27/2025,Sale,-160.0,321.0,14,SWEET GLOBE,Clam
Agrolatina,24A0066887,02/27/2025,Sale,-50.0,271.0,14,SWEET GLOBE,Clam
Agrolatina,24A0066887,02/27/2025,Sale,-15.0,256.0,14,SWEET GLOBE,Clam
Agrolatina,24A0066887,03/10/2025,Sale,-40.0,216.0,25,SWEET GLOBE,Clam
Agrolatina,24A0066887,03/11/2025,Sale,-10.0,206.0,26,SWEET GLOBE,Clam
Agrolatina,24A0066887,03/12/2025,Sale,-10.0,196.0,27,SWEET GLOBE,Clam
Agrolatina,24A0068302,02/13/2025,Entry,960.0,960.0,0,SWEET GLOBE,Clam
Agrolatina,24A0068302,02/13/2025,Entry,640.0,1600.0,0,SWEET GLOBE,Clam
Agrolatina,24A0068302,02/21/2025,Sale,-160.0,1440.0,8,SWEET GLOBE,Clam
Agrolatina,24A0068302,02/24/2025,Sale,-560.0,880.0,11,SWEET GLOBE,Clam
Agrolatina,24A0068302,02/24/2025,Sale,-80.0,800.0,11,SWEET GLOBE,Clam
Agrolatina,24A0068302,02/24/2025,Sale,-160.0,640.0,11,SWEET GLOBE,Clam
Agrolatina,24A0068302,02/26/2025,Sale,-130.0,510.0,13,SWEET GLOBE,Clam
Agrolatina,24A0068302,02/27/2025,Sale,-80.0,430.0,14,SWEET GLOBE,Clam
Agrolatina,24A0068302,02/27/2025,Sale,-310.0,120.0,14,SWEET GLOBE,Clam
Agrolatina,24A0073464,01/16/2025,Entry,1280.0,1280.0,0,CANDY SNAP,Clam
Agrolatina,24A0073464,01/16/2025,Entry,320.0,1600.0,0,CANDY SNAP,Clam
Agrolatina,24A0073464,02/03/2025,Sale,-160.0,1440.0,18,CANDY SNAP,Clam
Agrolatina,24A0073464,02/05/2025,Sale,-29.0,1411.0,20,CANDY SNAP,Clam
Agrolatina,24A0073464,02/05/2025,Sale,-160.0,1251.0,20,CANDY SNAP,Clam
Agrolatina,24A0073464,02/10/2025,Sale,-617.0,634.0,25,CANDY SNAP,Clam
Agrolatina,24A0073464,02/10/2025,Sale,-130.0,504.0,25,CANDY SNAP,Clam
Agrolatina,24A0073464,02/13/2025,Sale,-160.0,344.0,28,CANDY SNAP,Clam
Agrolatina,24A0073464,02/17/2025,Sale,-160.0,184.0,32,CANDY SNAP,Clam
Agrolatina,24A0081304,01/30/2025,Entry,1360.0,1360.0,0,SWEET GLOBE,Clam
Agrolatina,24A0081304,01/30/2025,Entry,240.0,1600.0,0,SWEET GLOBE,Clam
Agrolatina,24A0081304,02/15/2025,Sale,-80.0,1520.0,16,SWEET GLOBE,Clam
Agrolatina,24A0081304,02/15/2025,Sale,-240.0,1280.0,16,SWEET GLOBE,Clam
Agrolatina,24A0081304,02/17/2025,Sale,-80.0,1200.0,18,SWEET GLOBE,Clam
Agrolatina,24A0081304,02/18/2025,Sale,-160.0,1040.0,19,SWEET GLOBE,Clam
Agrolatina,24A0081304,02/19/2025,Sale,-160.0,880.0,20,SWEET GLOBE,Clam
Agrolatina,24A0081304,02/20/2025,Sale,-80.0,800.0,21,SWEET GLOBE,Clam
Agrolatina,24A0081304,02/20/2025,Sale,-160.0,640.0,21,SWEET GLOBE,Clam
Agrolatina,24A0081304,02/20/2025,Sale,-80.0,560.0,21,SWEET GLOBE,Clam
Agrolatina,24A0081304,02/21/2025,Sale,-80.0,480.0,22,SWEET GLOBE,Clam
Agrolatina,24A0081304,02/22/2025,Sale,-50.0,430.0,23,SWEET GLOBE,Clam
Agrolatina,24A0081304,02/22/2025,Sale,-87.0,343.0,23,SWEET GLOBE,Clam
Agrolatina,24A0081304,02/27/2025,Sale,-40.0,303.0,28,SWEET GLOBE,Clam
Agrolatina,24A0081304,02/28/2025,Sale,-100.0,203.0,29,SWEET GLOBE,Clam
Agrolatina,24A0094976,01/01/2025,Entry,1200.0,1200.0,0,ALLISON,Clam
Agrolatina,24A0094976,01/01/2025,Entry,400.0,1600.0,0,ALLISON,Clam
Agrolatina,24A0094976,01/18/2025,Sale,-1200.0,400.0,17,ALLISON,Clam
Agrolatina,24A0094976,01/21/2025,Sale,-320.0,80.0,20,ALLISON,Clam
Agrolatina,24A0094976,01/21/2025,Sale,-80.0,0.0,20,ALLISON,Clam
Agrolatina,24A0102156,03/03/2025,Entry,640.0,640.0,0,SWEET GLOBE,Clam
Agrolatina,24A0102156,03/03/2025,Entry,960.0,1600.0,0,SWEET GLOBE,Clam
Agrolatina,24A0102156,03/08/2025,Sale,-80.0,1520.0,5,SWEET GLOBE,Clam
Agrolatina,24A0102156,03/08/2025,Sale,-80.0,1440.0,5,SWEET GLOBE,Clam
Agrolatina,24A0102156,03/08/2025,Sale,-80.0,1360.0,5,SWEET GLOBE,Clam
Agrolatina,24A0102156,03/08/2025,Sale,-160.0,1200.0,5,SWEET GLOBE,Clam
Agrolatina,24A0102156,03/13/2025,Sale,-120.0,1080.0,10,SWEET GLOBE,Clam
Agrolatina,24A0102156,03/13/2025,Sale,-400.0,680.0,10,SWEET GLOBE,Clam
Agrolatina,24A0102156,03/14/2025,Sale,-180.0,500.0,11,SWEET GLOBE,Clam
Agrolatina,24A0102156,03/15/2025,Sale,-60.0,440.0,12,SWEET GLOBE,Clam
Agrolatina,24A0102156,03/15/2025,Sale,-80.0,360.0,12,SWEET GLOBE,Clam
Agrolatina,24A0102156,03/15/2025,Sale,-20.0,340.0,12,SWEET GLOBE,Clam
Agrolatina,24A0102156,03/15/2025,Sale,-20.0,320.0,12,SWEET GLOBE,Clam
Agrolatina,24A0102156,03/17/2025,Sale,-40.0,280.0,14,SWEET GLOBE,Clam
Agrolatina,24A0115718,02/03/2025,Entry,880.0,880.0,0,SWEET GLOBE,Clam
Agrolatina,24A0115718,02/03/2025,Entry,720.0,1600.0,0,SWEET GLOBE,Clam
Agrolatina,24A0115718,04/01/2025,Sale,-524.0,1076.0,57,SWEET GLOBE,Clam
Agrolatina,24A0115718,04/02/2025,Sale,-60.0,1016.0,58,SWEET GLOBE,Clam
Agrolatina,24A0115718,04/02/2025,Sale,-240.0,776.0,58,SWEET GLOBE,Clam
Agrolatina,24A0115718,04/02/2025,Sale,-240.0,536.0,58,SWEET GLOBE,Clam
Agrolatina,24A0128799,12/26/2024,Entry,320.0,320.0,0,IVORY,Clam
Agrolatina,24A0128799,12/26/2024,Entry,160.0,480.0,0,IVORY,Clam
Agrolatina,24A0128799,12/26/2024,Entry,80.0,560.0,0,IVORY,Clam
Agrolatina,24A0128799,12/26/2024,Entry,640.0,1200.0,0,SWEET GLOBE,Clam
Agrolatina,24A0128799,12/26/2024,Entry,80.0,1280.0,0,SWEET GLOBE,Clam
Agrolatina,24A0128799,12/26/2024,Entry,320.0,1600.0,0,SWEET GLOBE,Clam
Agrolatina,24A0128799,01/16/2025,Sale,-160.0,1440.0,21,SWEET GLOBE,Clam
Agrolatina,24A0128799,01/16/2025,Sale,-320.0,1120.0,21,SWEET GLOBE,Clam
Agrolatina,24A0128799,01/21/2025,Sale,-160.0,960.0,26,IVORY,Clam
Agrolatina,24A0128799,01/21/2025,Sale,-80.0,880.0,26,IVORY,Clam
Agrolatina,24A0128799,01/21/2025,Sale,-80.0,800.0,26,SWEET GLOBE,Clam
Agrolatina,24A0128799,01/27/2025,Sale,-311.0,489.0,32,IVORY,Clam
Agrolatina,24A0128799,01/27/2025,Sale,-400.0,89.0,32,SWEET GLOBE,Clam
Agrolatina,24A0137996,01/28/2025,Entry,1520.0,1520.0,0,CANDY SNAP,Clam
Agrolatina,24A0137996,01/28/2025,Entry,80.0,1600.0,0,CANDY SNAP,Clam
Agrolatina,24A0137996,01/30/2025,Sale,-480.0,1120.0,2,CANDY SNAP,Clam
Agrolatina,24A0137996,01/31/2025,Sale,-80.0,1040.0,3,CANDY SNAP,Clam
Agrolatina,24A0137996,02/01/2025,Sale,-320.0,720.0,4,CANDY SNAP,Clam
Agrolatina,24A0137996,02/03/2025,Sale,-400.0,320.0,6,CANDY SNAP,Clam
Agrolatina,24A0137996,02/06/2025,Sale,-51.0,269.0,9,CANDY SNAP,Clam
Agrolatina,24A0137996,02/13/2025,Sale,-80.0,189.0,16,CANDY SNAP,Clam
Agrolatina,24A0137996,02/17/2025,Sale,-80.0,109.0,20,CANDY SNAP,Clam
Agrolatina,24A0141553,12/23/2024,Entry,960.0,960.0,0,ALLISON,Clam
Agrolatina,24A0141553,12/23/2024,Entry,640.0,1600.0,0,ALLISON,Clam
Agrolatina,24A0141553,01/07/2025,Sale,-960.0,640.0,15,ALLISON,Clam
Agrolatina,24A0141553,01/08/2025,Sale,-640.0,0.0,16,ALLISON,Clam
Agrolatina,24A0141661,02/24/2025,Entry,960.0,960.0,0,TIMCO,Clam
Agrolatina,24A0141661,02/24/2025,Entry,640.0,1600.0,0,TIMCO,Clam
Agrolatina,24A0141661,04/17/2025,Sale,-80.0,1520.0,52,TIMCO,Clam
Agrolatina,24A0141661,04/17/2025,Sale,-160.0,1360.0,52,TIMCO,Clam
Agrolatina,24A0141661,04/20/2025,Sale,-640.0,720.0,55,TIMCO,Clam
Agrolatina,24A0141661,04/21/2025,Sale,-240.0,480.0,56,TIMCO,Clam
Agrolatina,24A0141661,04/24/2025,Sale,-480.0,0.0,59,TIMCO,Clam
Agrolatina,24A0148671,01/01/2025,Entry,1360.0,1360.0,0,CANDY SNAP,Clam
Agrolatina,24A0148671,01/01/2025,Entry,240.0,1600.0,0,CANDY SNAP,Clam
Agrolatina,24A0148671,01/20/2025,Sale,-1360.0,240.0,19,CANDY SNAP,Clam
Agrolatina,24A0148671,01/21/2025,Sale,-160.0,80.0,20,CANDY SNAP,Clam
Agrolatina,24A0148671,01/28/2025,Sale,-80.0,0.0,27,CANDY SNAP,Clam
Agrolatina,24A0154930,12/30/2024,Entry,960.0,960.0,0,ALLISON,Clam
Agrolatina,24A0154930,12/30/2024,Entry,640.0,1600.0,0,ALLISON,Clam
Agrolatina,24A0154930,01/20/2025,Sale,-960.0,640.0,21,ALLISON,Clam
Agrolatina,24A0154930,01/20/2025,Sale,-640.0,0.0,21,ALLISON,Clam
Agrolatina,24A0173313,03/03/2025,Entry,1440.0,1440.0,0,TIMCO,Clam
Agrolatina,24A0173313,03/03/2025,Entry,160.0,1600.0,0,TIMCO,Clam
Agrolatina,24A0173313,03/27/2025,Sale,-560.0,1040.0,24,TIMCO,Clam
Agrolatina,24A0173313,04/01/2025,Sale,-480.0,560.0,29,TIMCO,Clam
Agrolatina,24A0173313,04/01/2025,Sale,-80.0,480.0,29,TIMCO,Clam
Agrolatina,24A0173313,04/02/2025,Sale,-160.0,320.0,30,TIMCO,Clam
Agrolatina,24A0173313,04/02/2025,Sale,-80.0,240.0,30,TIMCO,Clam
Agrolatina,24A0173313,04/04/2025,Sale,-80.0,160.0,32,TIMCO,Clam
Agrolatina,24A0173313,04/05/2025,Sale,-80.0,80.0,33,TIMCO,Clam
Agrolatina,24A0207389,02/07/2025,Entry,1360.0,1360.0,0,SWEET GLOBE,Clam
Agrolatina,24A0207389,02/07/2025,Entry,240.0,1600.0,0,SWEET GLOBE,Clam
Agrolatina,24A0207389,02/20/2025,Sale,-160.0,1440.0,13,SWEET GLOBE,Clam
Agrolatina,24A0207389,02/20/2025,Sale,-480.0,960.0,13,SWEET GLOBE,Clam
Agrolatina,24A0207389,02/22/2025,Sale,-40.0,920.0,15,SWEET GLOBE,Clam
Agrolatina,24A0207389,02/22/2025,Sale,-180.0,740.0,15,SWEET GLOBE,Clam
Agrolatina,24A0207389,02/22/2025,Sale,-50.0,690.0,15,SWEET GLOBE,Clam
Agrolatina,24A0207389,02/25/2025,Sale,-40.0,650.0,18,SWEET GLOBE,Clam
Agrolatina,24A0207389,02/26/2025,Sale,-40.0,610.0,19,SWEET GLOBE,Clam
Agrolatina,24A0207389,02/27/2025,Sale,-80.0,530.0,20,SWEET GLOBE,Clam
Agrolatina,24A0207389,02/28/2025,Sale,-25.0,505.0,21,SWEET GLOBE,Clam
Agrolatina,24A0207389,03/05/2025,Sale,-40.0,465.0,26,SWEET GLOBE,Clam
Agrolatina,24A0207389,03/11/2025,Sale,-40.0,425.0,32,SWEET GLOBE,Clam
Agrolatina,24A0214937,02/03/2025,Entry,1520.0,1520.0,0,SWEET GLOBE,Clam
Agrolatina,24A0214937,02/03/2025,Entry,80.0,1600.0,0,SWEET GLOBE,Clam
Agrolatina,24A0214937,02/10/2025,Sale,-160.0,1440.0,7,SWEET GLOBE,Clam
Agrolatina,24A0214937,02/10/2025,Sale,-160.0,1280.0,7,SWEET GLOBE,Clam
Agrolatina,24A0214937,02/14/2025,Sale,-240.0,1040.0,11,SWEET GLOBE,Clam
Agrolatina,24A0214937,02/17/2025,Sale,-80.0,960.0,14,SWEET GLOBE,Clam
Agrolatina,24A0214937,02/17/2025,Sale,-240.0,720.0,14,SWEET GLOBE,Clam
Agrolatina,24A0214937,02/22/2025,Sale,-10.0,710.0,19,SWEET GLOBE,Clam
Agrolatina,24A0214937,02/22/2025,Sale,-60.0,650.0,19,SWEET GLOBE,Clam
Agrolatina,24A0214937,02/28/2025,Sale,-360.0,290.0,25,SWEET GLOBE,Clam
Agrolatina,24A0214937,03/05/2025,Sale,-40.0,250.0,30,SWEET GLOBE,Clam
Agrolatina,24A0214937,03/06/2025,Sale,-40.0,210.0,31,SWEET GLOBE,Clam
Agrolatina,24A0217108,02/13/2025,Entry,1360.0,1360.0,0,SWEET GLOBE,Clam
Agrolatina,24A0217108,02/13/2025,Entry,240.0,1600.0,0,SWEET GLOBE,Clam
Agrolatina,24A0217108,02/21/2025,Sale,-80.0,1520.0,8,SWEET GLOBE,Clam
Agrolatina,24A0217108,02/22/2025,Sale,-160.0,1360.0,9,SWEET GLOBE,Clam
Agrolatina,24A0217108,02/24/2025,Sale,-960.0,400.0,11,SWEET GLOBE,Clam
Agrolatina,24A0217108,02/24/2025,Sale,-240.0,160.0,11,SWEET GLOBE,Clam
Agrolatina,24A0217108,02/26/2025,Sale,-40.0,120.0,13,SWEET GLOBE,Clam
Agrolatina,24A0217108,02/27/2025,Sale,-50.0,70.0,14,SWEET GLOBE,Clam
Agrolatina,24A0217108,02/27/2025,Sale,-20.0,50.0,14,SWEET GLOBE,Clam
Agrolatina,24A0218526,02/20/2025,Entry,1520.0,1520.0,0,COTTON CANDY,Clam
Agrolatina,24A0218526,02/20/2025,Entry,80.0,1600.0,0,COTTON CANDY,Clam
Agrolatina,24A0218526,03/04/2025,Sale,-80.0,1520.0,12,COTTON CANDY,Clam
Agrolatina,24A0218526,03/28/2025,Sale,-580.0,940.0,36,COTTON CANDY,Clam
Agrolatina,24A0218526,04/02/2025,Sale,-40.0,900.0,41,COTTON CANDY,Clam
Agrolatina,24A0218526,04/02/2025,Sale,-80.0,820.0,41,COTTON CANDY,Clam
Agrolatina,24A0218526,04/10/2025,Sale,-80.0,740.0,49,COTTON CANDY,Clam
Agrolatina,24A0224278,02/24/2025,Entry,480.0,480.0,0,TIMCO,Clam
Agrolatina,24A0224278,02/24/2025,Entry,1120.0,1600.0,0,TIMCO,Clam
Agrolatina,24A0224278,03/12/2025,Sale,-160.0,1440.0,16,TIMCO,Clam
Agrolatina,24A0224278,03/13/2025,Sale,-320.0,1120.0,17,TIMCO,Clam
Agrolatina,24A0224278,03/29/2025,Sale,-160.0,960.0,33,TIMCO,Clam
Agrolatina,24A0224278,04/01/2025,Sale,-960.0,0.0,36,TIMCO,Clam
Agrolatina,24A0245408,02/03/2025,Entry,320.0,320.0,0,CANDY DREAMS,Clam
Agrolatina,24A0245408,02/03/2025,Entry,1280.0,1600.0,0,CANDY DREAMS,Clam
Agrolatina,24A0245408,02/08/2025,Sale,-80.0,1520.0,5,CANDY DREAMS,Clam
Agrolatina,24A0245408,02/10/2025,Sale,-160.0,1360.0,7,CANDY DREAMS,Clam
Agrolatina,24A0245408,02/10/2025,Sale,-80.0,1280.0,7,CANDY DREAMS,Clam
Agrolatina,24A0245408,02/17/2025,Sale,-80.0,1200.0,14,CANDY DREAMS,Clam
Agrolatina,24A0245408,02/18/2025,Sale,-80.0,1120.0,15,CANDY DREAMS,Clam
Agrolatina,24A0245408,02/18/2025,Sale,-240.0,880.0,15,CANDY DREAMS,Clam
Agrolatina,24A0245408,02/18/2025,Sale,-80.0,800.0,15,CANDY DREAMS,Clam
Agrolatina,24A0245408,02/20/2025,Sale,-480.0,320.0,17,CANDY DREAMS,Clam
Agrolatina,24A0245408,02/20/2025,Sale,-160.0,160.0,17,CANDY DREAMS,Clam
Agrolatina,24A0245408,02/22/2025,Sale,-80.0,80.0,19,CANDY DREAMS,Clam
Agrolatina,24A0245408,02/24/2025,Sale,-80.0,0.0,21,CANDY DREAMS,Clam
Agrolatina,24A0284770,03/03/2025,Entry,1360.0,1360.0,0,TIMCO,Clam
Agrolatina,24A0284770,03/03/2025,Entry,80.0,1440.0,0,TIMCO,Clam
Agrolatina,24A0284770,03/03/2025,Entry,160.0,1600.0,0,TIMCO,Clam
Agrolatina,24A0284770,03/21/2025,Sale,-800.0,800.0,18,TIMCO,Clam
Agrolatina,24A0284770,03/24/2025,Sale,-480.0,320.0,21,TIMCO,Clam
Agrolatina,24A0284770,03/26/2025,Sale,-80.0,240.0,23,TIMCO,Clam
Agrolatina,24A0284770,03/28/2025,Sale,-80.0,160.0,25,TIMCO,Clam
Agrolatina,24A0284770,03/31/2025,Sale,-80.0,80.0,28,TIMCO,Clam
Agrolatina,24A0284770,04/01/2025,Sale,-80.0,0.0,29,TIMCO,Clam
Agrolatina,24A0301570,01/16/2025,Entry,560.0,560.0,0,IVORY,Clam
Agrolatina,24A0301570,01/16/2025,Entry,80.0,640.0,0,IVORY,Clam
Agrolatina,24A0301570,01/16/2025,Entry,800.0,1440.0,0,SWEET GLOBE,Clam
Agrolatina,24A0301570,01/16/2025,Entry,160.0,1600.0,0,SWEET GLOBE,Clam
Agrolatina,24A0301570,02/04/2025,Sale,-160.0,1440.0,19,IVORY,Clam
Agrolatina,24A0301570,02/04/2025,Sale,-80.0,1360.0,19,IVORY,Clam
Agrolatina,24A0301570,02/04/2025,Sale,-80.0,1280.0,19,SWEET GLOBE,Clam
Agrolatina,24A0301570,02/05/2025,Sale,-257.0,1023.0,20,IVORY,Clam
Agrolatina,24A0301570,02/05/2025,Sale,-80.0,943.0,20,SWEET GLOBE,Clam
Agrolatina,24A0301570,02/06/2025,Sale,-400.0,543.0,21,SWEET GLOBE,Clam
Agrolatina,24A0301570,02/06/2025,Sale,-160.0,383.0,21,SWEET GLOBE,Clam
Agrolatina,24A0301570,02/07/2025,Sale,-80.0,303.0,22,SWEET GLOBE,Clam
Agrolatina,24A0301570,02/13/2025,Sale,-160.0,143.0,28,SWEET GLOBE,Clam
Agrolatina,24A0302220,02/27/2025,Entry,1440.0,1440.0,0,IVORY,Clam
Agrolatina,24A0302220,02/27/2025,Entry,160.0,1600.0,0,IVORY,Clam
Agrolatina,24A0302220,03/01/2025,Sale,-320.0,1280.0,2,IVORY,Clam
Agrolatina,24A0302220,03/04/2025,Sale,-80.0,1200.0,5,IVORY,Clam
Agrolatina,24A0302220,03/14/2025,Sale,-160.0,1040.0,15,IVORY,Clam
Agrolatina,24A0302220,03/15/2025,Sale,-480.0,560.0,16,IVORY,Clam
Agrolatina,24A0302220,03/22/2025,Sale,-80.0,480.0,23,IVORY,Clam
Agrolatina,24A0302220,03/22/2025,Sale,-220.0,260.0,23,IVORY,Clam
Agrolatina,24A0302220,03/24/2025,Sale,-218.0,42.0,25,IVORY,Clam
Agrolatina,24A0317200,02/03/2025,Entry,400.0,400.0,0,CANDY DREAMS,Clam
Agrolatina,24A0317200,02/03/2025,Entry,1200.0,1600.0,0,CANDY DREAMS,Clam
Agrolatina,24A0317200,02/08/2025,Sale,-160.0,1440.0,5,CANDY DREAMS,Clam
Agrolatina,24A0317200,02/10/2025,Sale,-80.0,1360.0,7,CANDY DREAMS,Clam
Agrolatina,24A0317200,02/11/2025,Sale,-80.0,1280.0,8,CANDY DREAMS,Clam
Agrolatina,24A0317200,02/15/2025,Sale,-80.0,1200.0,12,CANDY DREAMS,Clam
Agrolatina,24A0317200,02/17/2025,Sale,-240.0,960.0,14,CANDY DREAMS,Clam
Agrolatina,24A0317200,02/18/2025,Sale,-80.0,880.0,15,CANDY DREAMS,Clam
Agrolatina,24A0317200,02/18/2025,Sale,-80.0,800.0,15,CANDY DREAMS,Clam
Agrolatina,24A0317200,02/18/2025,Sale,-80.0,720.0,15,CANDY DREAMS,Clam
Agrolatina,24A0317200,02/19/2025,Sale,-320.0,400.0,16,CANDY DREAMS,Clam
Agrolatina,24A0317200,02/20/2025,Sale,-320.0,80.0,17,CANDY DREAMS,Clam
Agrolatina,24A0317200,02/25/2025,Sale,-40.0,40.0,22,CANDY DREAMS,Clam
Agrolatina,24A0317200,02/25/2025,Sale,-20.0,20.0,22,CANDY DREAMS,Clam
Agrolatina,24A0319537,03/10/2025,Entry,1600.0,1600.0,0,AUTUMN CRISP,Clam
Agrolatina,24A0319537,03/19/2025,Sale,-1040.0,560.0,9,AUTUMN CRISP,Clam
Agrolatina,24A0319537,03/19/2025,Sale,-320.0,240.0,9,AUTUMN CRISP,Clam
Agrolatina,24A0319537,03/19/2025,Sale,-240.0,0.0,9,AUTUMN CRISP,Clam
Agrolatina,24A0343560,12/26/2024,Entry,1120.0,1120.0,0,SWEET GLOBE,Clam
Agrolatina,24A0343560,12/26/2024,Entry,80.0,1200.0,0,SWEET GLOBE,Clam
Agrolatina,24A0343560,12/26/2024,Entry,400.0,1600.0,0,SWEET GLOBE,Clam
Agrolatina,24A0343560,01/07/2025,Sale,-80.0,1520.0,12,SWEET GLOBE,Clam
Agrolatina,24A0343560,01/08/2025,Sale,-1120.0,400.0,13,SWEET GLOBE,Clam
Agrolatina,24A0343560,01/11/2025,Sale,-400.0,0.0,16,SWEET GLOBE,Clam
Agrolatina,24A0350384,03/10/2025,Entry,1120.0,1120.0,0,TIMCO,Clam
Agrolatina,24A0350384,03/10/2025,Entry,480.0,1600.0,0,TIMCO,Clam
Agrolatina,24A0350384,03/21/2025,Sale,-160.0,1440.0,11,TIMCO,Clam
Agrolatina,24A0350384,03/27/2025,Sale,-240.0,1200.0,17,TIMCO,Clam
Agrolatina,24A0350384,04/01/2025,Sale,-160.0,1040.0,22,TIMCO,Clam
Agrolatina,24A0350384,04/01/2025,Sale,-480.0,560.0,22,TIMCO,Clam
Agrolatina,24A0350384,04/02/2025,Sale,-560.0,0.0,23,TIMCO,Clam
Agrolatina,24A0354570,01/28/2025,Entry,1440.0,1440.0,0,IVORY,Clam
Agrolatina,24A0354570,01/28/2025,Entry,160.0,1600.0,0,IVORY,Clam
Agrolatina,24A0354570,01/31/2025,Sale,-400.0,1200.0,3,IVORY,Clam
Agrolatina,24A0354570,02/03/2025,Sale,-889.0,311.0,6,IVORY,Clam
Agrolatina,24A0358472,03/03/2025,Entry,640.0,640.0,0,SWEET GLOBE,Clam
Agrolatina,24A0358472,03/03/2025,Entry,960.0,1600.0,0,SWEET GLOBE,Clam
Agrolatina,24A0358472,03/13/2025,Sale,-160.0,1440.0,10,SWEET GLOBE,Clam
Agrolatina,24A0358472,03/15/2025,Sale,-240.0,1200.0,12,SWEET GLOBE,Clam
Agrolatina,24A0358472,03/15/2025,Sale,-140.0,1060.0,12,SWEET GLOBE,Clam
Agrolatina,24A0358472,03/15/2025,Sale,-200.0,860.0,12,SWEET GLOBE,Clam
Agrolatina,24A0358472,03/15/2025,Sale,-12.0,848.0,12,SWEET GLOBE,Clam
Agrolatina,24A0358472,03/17/2025,Sale,-240.0,608.0,14,SWEET GLOBE,Clam
Agrolatina,24A0358472,03/19/2025,Sale,-63.0,545.0,16,SWEET GLOBE,Clam
Agrolatina,24A0377301,02/13/2025,Entry,880.0,880.0,0,SWEET GLOBE,Clam
Agrolatina,24A0377301,02/13/2025,Entry,720.0,1600.0,0,SWEET GLOBE,Clam
Agrolatina,24A0377301,02/18/2025,Sale,-80.0,1520.0,5,SWEET GLOBE,Clam
Agrolatina,24A0377301,02/20/2025,Sale,-640.0,880.0,7,SWEET GLOBE,Clam
Agrolatina,24A0377301,02/21/2025,Sale,-80.0,800.0,8,SWEET GLOBE,Clam
Agrolatina,24A0377301,02/22/2025,Sale,-80.0,720.0,9,SWEET GLOBE,Clam
Agrolatina,24A0377301,02/22/2025,Sale,-30.0,690.0,9,SWEET GLOBE,Clam
Agrolatina,24A0377301,02/22/2025,Sale,-30.0,660.0,9,SWEET GLOBE,Clam
Agrolatina,24A0377301,02/26/2025,Sale,-80.0,580.0,13,SWEET GLOBE,Clam
Agrolatina,24A0377301,02/27/2025,Sale,-80.0,500.0,14,SWEET GLOBE,Clam
Agrolatina,24A0377301,02/27/2025,Sale,-100.0,400.0,14,SWEET GLOBE,Clam
Agrolatina,24A0377301,02/28/2025,Sale,-50.0,350.0,15,SWEET GLOBE,Clam
Agrolatina,24A0377301,03/05/2025,Sale,-89.0,261.0,20,SWEET GLOBE,Clam
Agrolatina,24A0377301,03/10/2025,Sale,-40.0,221.0,25,SWEET GLOBE,Clam
Agrolatina,24A0377301,03/11/2025,Sale,-20.0,201.0,26,SWEET GLOBE,Clam
Agrolatina,24A0377451,12/30/2024,Entry,1120.0,1120.0,0,SWEET GLOBE,Clam
Agrolatina,24A0377451,12/30/2024,Entry,480.0,1600.0,0,SWEET GLOBE,Clam
Agrolatina,24A0377451,01/20/2025,Sale,-480.0,1120.0,21,SWEET GLOBE,Clam
Agrolatina,24A0377451,01/21/2025,Sale,-1120.0,0.0,22,SWEET GLOBE,Clam
Agrolatina,24A0378334,03/03/2025,Entry,1520.0,1520.0,0,TIMCO,Clam
Agrolatina,24A0378334,03/03/2025,Entry,80.0,1600.0,0,TIMCO,Clam
Agrolatina,24A0378334,03/21/2025,Sale,-800.0,800.0,18,TIMCO,Clam
Agrolatina,24A0378334,03/26/2025,Sale,-400.0,400.0,23,TIMCO,Clam
Agrolatina,24A0378334,03/28/2025,Sale,-80.0,320.0,25,TIMCO,Clam
Agrolatina,24A0378334,04/02/2025,Sale,-240.0,80.0,30,TIMCO,Clam
Agrolatina,24A0379325,02/03/2025,Entry,1360.0,1360.0,0,SWEET GLOBE,Clam
Agrolatina,24A0379325,02/03/2025,Entry,240.0,1600.0,0,SWEET GLOBE,Clam
Agrolatina,24A0379325,03/13/2025,Sale,-160.0,1440.0,38,SWEET GLOBE,Clam
Agrolatina,24A0379325,03/14/2025,Sale,-160.0,1280.0,39,SWEET GLOBE,Clam
Agrolatina,24A0379325,03/15/2025,Sale,-160.0,1120.0,40,SWEET GLOBE,Clam
Agrolatina,24A0379325,03/15/2025,Sale,-400.0,720.0,40,SWEET GLOBE,Clam
Agrolatina,24A0379325,03/15/2025,Sale,-240.0,480.0,40,SWEET GLOBE,Clam
Agrolatina,24A0379325,03/15/2025,Sale,-60.0,420.0,40,SWEET GLOBE,Clam
Agrolatina,24A0379325,03/18/2025,Sale,-80.0,340.0,43,SWEET GLOBE,Clam
Agrolatina,24A0381446,12/30/2024,Entry,1600.0,1600.0,0,CANDY SNAP,Clam
Agrolatina,24A0381446,01/18/2025,Sale,-1600.0,0.0,19,CANDY SNAP,Clam
Agrolatina,24A0384785,02/03/2025,Entry,80.0,80.0,0,IVORY,Clam
Agrolatina,24A0384785,02/03/2025,Entry,1120.0,1200.0,0,SWEET GLOBE,Clam
Agrolatina,24A0384785,02/03/2025,Entry,400.0,1600.0,0,SWEET GLOBE,Clam
Agrolatina,24A0384785,02/06/2025,Sale,-80.0,1520.0,3,SWEET GLOBE,Clam
Agrolatina,24A0384785,02/07/2025,Sale,-80.0,1440.0,4,SWEET GLOBE,Clam
Agrolatina,24A0384785,02/07/2025,Sale,-160.0,1280.0,4,SWEET GLOBE,Clam
Agrolatina,24A0384785,02/08/2025,Sale,-240.0,1040.0,5,SWEET GLOBE,Clam
Agrolatina,24A0384785,02/10/2025,Sale,-80.0,960.0,7,SWEET GLOBE,Clam
Agrolatina,24A0384785,02/10/2025,Sale,-160.0,800.0,7,SWEET GLOBE,Clam
Agrolatina,24A0384785,02/11/2025,Sale,-80.0,720.0,8,SWEET GLOBE,Clam
Agrolatina,24A0384785,02/25/2025,Sale,-120.0,600.0,22,SWEET GLOBE,Clam
Agrolatina,24A0384785,02/28/2025,Sale,-40.0,560.0,25,SWEET GLOBE,Clam
Agrolatina,24A0384785,03/01/2025,Sale,-120.0,440.0,26,SWEET GLOBE,Clam
Agrolatina,24A0384785,03/05/2025,Sale,-40.0,400.0,30,SWEET GLOBE,Clam
Agrolatina,24A0384785,03/12/2025,Sale,-40.0,360.0,37,SWEET GLOBE,Clam
Agrolatina,24A0384785,03/29/2025,Sale,-40.0,320.0,54,IVORY,Clam
Agrolatina,24A0388780,02/11/2025,Entry,240.0,240.0,0,AUTUMN CRISP,Clam
Agrolatina,24A0388780,02/11/2025,Entry,1360.0,1600.0,0,AUTUMN CRISP,Clam
Agrolatina,24A0388780,03/01/2025,Sale,-240.0,1360.0,18,AUTUMN CRISP,Clam
Agrolatina,24A0388780,03/05/2025,Sale,-400.0,960.0,22,AUTUMN CRISP,Clam
Agrolatina,24A0388780,03/07/2025,Sale,-960.0,0.0,24,AUTUMN CRISP,Clam
Agrolatina,24A0398304,02/03/2025,Entry,1600.0,1600.0,0,SWEET GLOBE,Clam
Agrolatina,24A0398304,02/06/2025,Sale,-80.0,1520.0,3,SWEET GLOBE,Clam
Agrolatina,24A0398304,02/07/2025,Sale,-240.0,1280.0,4,SWEET GLOBE,Clam
Agrolatina,24A0398304,02/07/2025,Sale,-240.0,1040.0,4,SWEET GLOBE,Clam
Agrolatina,24A0398304,02/08/2025,Sale,-640.0,400.0,5,SWEET GLOBE,Clam
Agrolatina,24A0398304,02/08/2025,Sale,-80.0,320.0,5,SWEET GLOBE,Clam
Agrolatina,24A0398304,02/08/2025,Sale,-80.0,240.0,5,SWEET GLOBE,Clam
Agrolatina,24A0398304,02/10/2025,Sale,-240.0,0.0,7,SWEET GLOBE,Clam
Agrolatina,24A0409179,01/11/2025,Entry,1440.0,1440.0,0,SWEET GLOBE,Clam
Agrolatina,24A0409179,01/11/2025,Entry,160.0,1600.0,0,SWEET GLOBE,Clam
Agrolatina,24A0409179,01/27/2025,Sale,-1440.0,160.0,16,SWEET GLOBE,Clam
Agrolatina,24A0409179,01/27/2025,Sale,-160.0,0.0,16,SWEET GLOBE,Clam
Agrolatina,24A0424759,02/24/2025,Entry,720.0,720.0,0,TIMCO,Clam
Agrolatina,24A0424759,02/24/2025,Entry,880.0,1600.0,0,TIMCO,Clam
Agrolatina,24A0424759,04/03/2025,Sale,-720.0,880.0,38,TIMCO,Clam
Agrolatina,24A0424759,04/23/2025,Sale,-880.0,0.0,58,TIMCO,Clam
Agrolatina,24A0438942,12/30/2024,Entry,1440.0,1440.0,0,SWEET GLOBE,Clam
Agrolatina,24A0438942,12/30/2024,Entry,80.0,1520.0,0,SWEET GLOBE,Clam
Agrolatina,24A0438942,12/30/2024,Entry,80.0,1600.0,0,SWEET GLOBE,Clam
Agrolatina,24A0438942,01/17/2025,Sale,-1440.0,160.0,18,SWEET GLOBE,Clam
Agrolatina,24A0438942,01/18/2025,Sale,-80.0,80.0,19,SWEET GLOBE,Clam
Agrolatina,24A0438942,01/23/2025,Sale,-80.0,0.0,24,SWEET GLOBE,Clam
Agrolatina,24A0459101,03/03/2025,Entry,1530.0,1530.0,0,TIMCO,Clam
Agrolatina,24A0459101,03/03/2025,Entry,170.0,1700.0,0,TIMCO,Clam
Agrolatina,24A0459101,03/19/2025,Sale,-680.0,1020.0,16,TIMCO,Clam
Agrolatina,24A0459101,03/20/2025,Sale,-425.0,595.0,17,TIMCO,Clam
Agrolatina,24A0459101,04/09/2025,Sale,-270.0,325.0,37,TIMCO,Bag
Agrolatina,24A0459101,04/10/2025,Sale,-28.0,297.0,38,TIMCO,Bag
Agrolatina,24A0459101,04/14/2025,Sale,-90.0,207.0,42,TIMCO,Bag
Agrolatina,24A0466327,02/27/2025,Entry,1280.0,1280.0,0,IVORY,Clam
Agrolatina,24A0466327,02/27/2025,Entry,320.0,1600.0,0,IVORY,Clam
Agrolatina,24A0466327,03/06/2025,Sale,-80.0,1520.0,7,IVORY,Clam
Agrolatina,24A0466327,03/12/2025,Sale,-80.0,1440.0,13,IVORY,Clam
Agrolatina,24A0466327,03/28/2025,Sale,-40.0,1400.0,29,IVORY,Clam
Agrolatina,24A0466327,03/29/2025,Sale,-120.0,1280.0,30,IVORY,Clam
Agrolatina,24A0466327,03/29/2025,Sale,-40.0,1240.0,30,IVORY,Clam
Agrolatina,24A0466327,03/31/2025,Sale,-620.0,620.0,32,IVORY,Clam
Agrolatina,24A0466327,04/01/2025,Sale,-140.0,480.0,33,IVORY,Clam
Agrolatina,24A0466327,04/01/2025,Sale,-80.0,400.0,33,IVORY,Clam
Agrolatina,24A0466327,04/05/2025,Sale,-50.0,350.0,37,IVORY,Clam
Agrolatina,24A0470672,02/27/2025,Entry,1520.0,1520.0,0,COTTON CANDY,Clam
Agrolatina,24A0470672,02/27/2025,Entry,80.0,1600.0,0,COTTON CANDY,Clam
Agrolatina,24A0470672,03/28/2025,Sale,-80.0,1520.0,29,COTTON CANDY,Clam
Agrolatina,24A0470672,03/29/2025,Sale,-80.0,1440.0,30,COTTON CANDY,Clam
Agrolatina,24A0470672,03/31/2025,Sale,-80.0,1360.0,32,COTTON CANDY,Clam
Agrolatina,24A0470672,04/02/2025,Sale,-80.0,1280.0,34,COTTON CANDY,Clam
Agrolatina,24A0470672,04/02/2025,Sale,-30.0,1250.0,34,COTTON CANDY,Clam
Agrolatina,24A0470672,04/10/2025,Sale,-160.0,1090.0,42,COTTON CANDY,Clam
Agrolatina,24A0489235,02/03/2025,Entry,1200.0,1200.0,0,SWEET GLOBE,Clam
Agrolatina,24A0489235,02/03/2025,Entry,400.0,1600.0,0,SWEET GLOBE,Clam
Agrolatina,24A0505892,02/13/2025,Entry,1040.0,1040.0,0,SWEET GLOBE,Clam
Agrolatina,24A0505892,02/13/2025,Entry,560.0,1600.0,0,SWEET GLOBE,Clam
Agrolatina,24A0505892,02/24/2025,Sale,-560.0,1040.0,11,SWEET GLOBE,Clam
Agrolatina,24A0505892,02/25/2025,Sale,-200.0,840.0,12,SWEET GLOBE,Clam
Agrolatina,24A0505892,02/25/2025,Sale,-80.0,760.0,12,SWEET GLOBE,Clam
Agrolatina,24A0505892,02/26/2025,Sale,-175.0,585.0,13,SWEET GLOBE,Clam
Agrolatina,24A0505892,02/26/2025,Sale,-80.0,505.0,13,SWEET GLOBE,Clam
Agrolatina,24A0505892,02/27/2025,Sale,-80.0,425.0,14,SWEET GLOBE,Clam
Agrolatina,24A0505892,02/27/2025,Sale,-10.0,415.0,14,SWEET GLOBE,Clam
Agrolatina,24A0505892,02/28/2025,Sale,-30.0,385.0,15,SWEET GLOBE,Clam
Agrolatina,24A0505892,03/10/2025,Sale,-40.0,345.0,25,SWEET GLOBE,Clam
Agrolatina,24A0505892,03/11/2025,Sale,-20.0,325.0,26,SWEET GLOBE,Clam
Agrolatina,24A0512192,03/03/2025,Entry,800.0,800.0,0,IVORY,Clam
Agrolatina,24A0512192,03/03/2025,Entry,800.0,1600.0,0,IVORY,Clam
Agrolatina,24A0512192,03/21/2025,Sale,-40.0,1560.0,18,IVORY,Clam
Agrolatina,24A0512192,03/22/2025,Sale,-80.0,1480.0,19,IVORY,Clam
Agrolatina,24A0512192,03/22/2025,Sale,-20.0,1460.0,19,IVORY,Clam
Agrolatina,24A0512192,03/24/2025,Sale,-160.0,1300.0,21,IVORY,Clam
Agrolatina,24A0512192,03/25/2025,Sale,-105.0,1195.0,22,IVORY,Clam
Agrolatina,24A0512192,03/25/2025,Sale,-96.0,1099.0,22,IVORY,Clam
Agrolatina,24A0512192,03/27/2025,Sale,-80.0,1019.0,24,IVORY,Clam
Agrolatina,24A0512192,03/28/2025,Sale,-65.0,954.0,25,IVORY,Clam
Agrolatina,24A0512192,03/29/2025,Sale,-80.0,874.0,26,IVORY,Clam
Agrolatina,24A0512192,03/29/2025,Sale,-80.0,794.0,26,IVORY,Clam
Agrolatina,24A0512192,03/31/2025,Sale,-240.0,554.0,28,IVORY,Clam
Agrolatina,24A0512192,04/01/2025,Sale,-80.0,474.0,29,IVORY,Clam
Agrolatina,24A0512905,02/13/2025,Entry,720.0,720.0,0,SWEET GLOBE,Clam
Agrolatina,24A0512905,02/13/2025,Entry,880.0,1600.0,0,SWEET GLOBE,Clam
Agrolatina,24A0512905,02/21/2025,Sale,-80.0,1520.0,8,SWEET GLOBE,Clam
Agrolatina,24A0512905,02/21/2025,Sale,-80.0,1440.0,8,SWEET GLOBE,Clam
Agrolatina,24A0512905,02/24/2025,Sale,-240.0,1200.0,11,SWEET GLOBE,Clam
Agrolatina,24A0512905,02/24/2025,Sale,-80.0,1120.0,11,SWEET GLOBE,Clam
Agrolatina,24A0512905,02/26/2025,Sale,-50.0,1070.0,13,SWEET GLOBE,Clam
Agrolatina,24A0512905,02/26/2025,Sale,-240.0,830.0,13,SWEET GLOBE,Clam
Agrolatina,24A0512905,02/26/2025,Sale,-30.0,800.0,13,SWEET GLOBE,Clam
Agrolatina,24A0512905,02/27/2025,Sale,-100.0,700.0,14,SWEET GLOBE,Clam
Agrolatina,24A0512905,02/27/2025,Sale,-20.0,680.0,14,SWEET GLOBE,Clam
Agrolatina,24A0512905,02/27/2025,Sale,-350.0,330.0,14,SWEET GLOBE,Clam
Agrolatina,24A0512905,02/27/2025,Sale,-55.0,275.0,14,SWEET GLOBE,Clam
Agrolatina,24A0512905,02/28/2025,Sale,-80.0,195.0,15,SWEET GLOBE,Clam
Agrolatina,24A0512905,02/28/2025,Sale,-10.0,185.0,15,SWEET GLOBE,Clam
Agrolatina,24A0516177,02/13/2025,Entry,1200.0,1200.0,0,SWEET GLOBE,Clam
Agrolatina,24A0516177,02/13/2025,Entry,400.0,1600.0,0,SWEET GLOBE,Clam
Agrolatina,24A0516177,04/01/2025,Sale,-196.0,1404.0,47,SWEET GLOBE,Clam
Agrolatina,24A0516177,04/02/2025,Sale,-486.0,918.0,48,SWEET GLOBE,Clam
Agrolatina,24A0516177,04/02/2025,Sale,-160.0,758.0,48,SWEET GLOBE,Clam
Agrolatina,24A0516177,04/02/2025,Sale,-80.0,678.0,48,SWEET GLOBE,Clam
Agrolatina,24A0516177,04/02/2025,Sale,-180.0,498.0,48,SWEET GLOBE,Clam
Agrolatina,24A0518420,01/16/2025,Entry,1040.0,1040.0,0,ALLISON,Clam
Agrolatina,24A0518420,01/16/2025,Entry,560.0,1600.0,0,ALLISON,Clam
Agrolatina,24A0518420,02/05/2025,Sale,-80.0,1520.0,20,ALLISON,Clam
Agrolatina,24A0518420,02/19/2025,Sale,-480.0,1040.0,34,ALLISON,Clam
Agrolatina,24A0518420,02/19/2025,Sale,-320.0,720.0,34,ALLISON,Clam
Agrolatina,24A0518420,02/20/2025,Sale,-160.0,560.0,35,ALLISON,Clam
Agrolatina,24A0518420,02/25/2025,Sale,-80.0,480.0,40,ALLISON,Clam
Agrolatina,24A0518420,02/27/2025,Sale,-80.0,400.0,42,ALLISON,Clam
Agrolatina,24A0518420,03/03/2025,Sale,-80.0,320.0,46,ALLISON,Clam
Agrolatina,24A0518420,03/04/2025,Sale,-320.0,0.0,47,ALLISON,Clam
Agrolatina,24A0525836,12/23/2024,Entry,1040.0,1040.0,0,SWEET GLOBE,Clam
Agrolatina,24A0525836,12/23/2024,Entry,560.0,1600.0,0,SWEET GLOBE,Clam
Agrolatina,24A0525836,01/15/2025,Sale,-1040.0,560.0,23,SWEET GLOBE,Clam
Agrolatina,24A0525836,01/15/2025,Sale,-560.0,0.0,23,SWEET GLOBE,Clam
Agrolatina,24A0528347,02/13/2025,Entry,1200.0,1200.0,0,SWEET GLOBE,Clam
Agrolatina,24A0528347,02/13/2025,Entry,400.0,1600.0,0,SWEET GLOBE,Clam
Agrolatina,24A0528347,04/02/2025,Sale,-394.0,1206.0,48,SWEET GLOBE,Clam
Agrolatina,24A0528347,04/02/2025,Sale,-260.0,946.0,48,SWEET GLOBE,Clam
Agrolatina,24A0528347,04/02/2025,Sale,-240.0,706.0,48,SWEET GLOBE,Clam
Agrolatina,24A0528347,04/02/2025,Sale,-60.0,646.0,48,SWEET GLOBE,Clam
Agrolatina,24A0531783,01/16/2025,Entry,480.0,480.0,0,IVORY,Clam
Agrolatina,24A0531783,01/16/2025,Entry,160.0,640.0,0,IVORY,Clam
Agrolatina,24A0531783,01/16/2025,Entry,880.0,1520.0,0,SWEET GLOBE,Clam
Agrolatina,24A0531783,01/16/2025,Entry,80.0,1600.0,0,SWEET GLOBE,Clam
Agrolatina,24A0531783,02/04/2025,Sale,-80.0,1520.0,19,IVORY,Clam
Agrolatina,24A0531783,02/04/2025,Sale,-160.0,1360.0,19,IVORY,Clam
Agrolatina,24A0531783,02/04/2025,Sale,-160.0,1200.0,19,IVORY,Clam
Agrolatina,24A0531783,02/04/2025,Sale,-160.0,1040.0,19,SWEET GLOBE,Clam
Agrolatina,24A0531783,02/05/2025,Sale,-80.0,960.0,20,IVORY,Clam
Agrolatina,24A0531783,02/05/2025,Sale,-80.0,880.0,20,IVORY,Clam
Agrolatina,24A0531783,02/05/2025,Sale,-160.0,720.0,20,SWEET GLOBE,Clam
Agrolatina,24A0531783,02/05/2025,Sale,-160.0,560.0,20,SWEET GLOBE,Clam
Agrolatina,24A0531783,02/05/2025,Sale,-240.0,320.0,20,SWEET GLOBE,Clam
Agrolatina,24A0531783,02/07/2025,Sale,-80.0,240.0,22,SWEET GLOBE,Clam
Agrolatina,24A0531783,02/11/2025,Sale,-80.0,160.0,26,SWEET GLOBE,Clam
Agrolatina,24A0531783,02/15/2025,Sale,-80.0,80.0,30,IVORY,Clam
Agrolatina,24A0531783,02/22/2025,Sale,-48.0,32.0,37,SWEET GLOBE,Clam
Agrolatina,24A0534674,02/20/2025,Entry,800.0,800.0,0,SWEET GLOBE,Clam
Agrolatina,24A0534674,02/20/2025,Entry,800.0,1600.0,0,SWEET GLOBE,Clam
Agrolatina,24A0534674,02/27/2025,Sale,-720.0,880.0,7,SWEET GLOBE,Clam
Agrolatina,24A0534674,02/27/2025,Sale,-80.0,800.0,7,SWEET GLOBE,Clam
Agrolatina,24A0534674,02/27/2025,Sale,-240.0,560.0,7,SWEET GLOBE,Clam
Agrolatina,24A0534674,02/27/2025,Sale,-80.0,480.0,7,SWEET GLOBE,Clam
Agrolatina,24A0534674,03/01/2025,Sale,-64.0,416.0,9,SWEET GLOBE,Clam
Agrolatina,24A0534674,03/03/2025,Sale,-80.0,336.0,11,SWEET GLOBE,Clam
Agrolatina,24A0534674,03/17/2025,Sale,-80.0,256.0,25,SWEET GLOBE,Clam
Agrolatina,24A0557793,12/23/2024,Entry,1520.0,1520.0,0,CANDY SNAP,Clam
Agrolatina,24A0557793,12/23/2024,Entry,80.0,1600.0,0,CANDY SNAP,Clam
Agrolatina,24A0557793,01/14/2025,Sale,-1200.0,400.0,22,CANDY SNAP,Clam
Agrolatina,24A0557793,01/18/2025,Sale,-320.0,80.0,26,CANDY SNAP,Clam
Agrolatina,24A0557793,01/21/2025,Sale,-80.0,0.0,29,CANDY SNAP,Clam
Agrolatina,24A0559081,12/30/2024,Entry,1520.0,1520.0,0,CANDY SNAP,Clam
Agrolatina,24A0559081,12/30/2024,Entry,80.0,1600.0,0,CANDY SNAP,Clam
Agrolatina,24A0559081,01/20/2025,Sale,-800.0,800.0,21,CANDY SNAP,Clam
Agrolatina,24A0559081,01/20/2025,Sale,-240.0,560.0,21,CANDY SNAP,Clam
Agrolatina,24A0559081,01/21/2025,Sale,-80.0,480.0,22,CANDY SNAP,Clam
Agrolatina,24A0559081,01/21/2025,Sale,-80.0,400.0,22,CANDY SNAP,Clam
Agrolatina,24A0559081,01/22/2025,Sale,-400.0,0.0,23,CANDY SNAP,Clam
Agrolatina,24A0567174,01/16/2025,Entry,1280.0,1280.0,0,ALLISON,Clam
Agrolatina,24A0567174,01/16/2025,Entry,320.0,1600.0,0,ALLISON,Clam
Agrolatina,24A0567174,03/14/2025,Sale,-560.0,1040.0,57,ALLISON,Clam
Agrolatina,24A0567174,03/22/2025,Sale,-60.0,980.0,65,IVORY,Clam
Agrolatina,24A0567174,03/24/2025,Sale,-80.0,900.0,67,ALLISON,Clam
Agrolatina,24A0567174,03/25/2025,Sale,-2.0,898.0,68,ALLISON,Clam
Agrolatina,24A0567174,03/27/2025,Sale,-587.0,311.0,70,ALLISON,Clam
Agrolatina,24A0567174,03/27/2025,Sale,-60.0,251.0,70,ALLISON,Clam
Agrolatina,24A0567174,04/02/2025,Sale,-40.0,211.0,76,COTTON CANDY,Clam
Agrolatina,24A0567549,12/07/2024,Entry,1520.0,1520.0,0,CANDY SNAP,Clam
Agrolatina,24A0567549,12/07/2024,Entry,80.0,1600.0,0,CANDY SNAP,Clam
Agrolatina,24A0567549,01/06/2025,Sale,-1440.0,160.0,30,CANDY SNAP,Clam
Agrolatina,24A0567549,01/06/2025,Sale,-80.0,80.0,30,CANDY SNAP,Clam
Agrolatina,24A0567549,01/06/2025,Sale,-80.0,0.0,30,CANDY SNAP,Clam
Agrolatina,24A0573808,01/02/2025,Entry,1040.0,1040.0,0,CANDY SNAP,Clam
Agrolatina,24A0573808,01/02/2025,Entry,560.0,1600.0,0,CANDY SNAP,Clam
Agrolatina,24A0573808,01/14/2025,Sale,-160.0,1440.0,12,CANDY SNAP,Clam
Agrolatina,24A0573808,01/14/2025,Sale,-560.0,880.0,12,CANDY SNAP,Clam
Agrolatina,24A0573808,01/14/2025,Sale,-320.0,560.0,12,CANDY SNAP,Clam
Agrolatina,24A0573808,01/14/2025,Sale,-480.0,80.0,12,CANDY SNAP,Clam
Agrolatina,24A0573808,01/14/2025,Sale,-80.0,0.0,12,CANDY SNAP,Clam
Agrolatina,24A0577721,01/16/2025,Entry,720.0,720.0,0,IVORY,Clam
Agrolatina,24A0577721,01/16/2025,Entry,80.0,800.0,0,IVORY,Clam
Agrolatina,24A0577721,01/16/2025,Entry,800.0,1600.0,0,SWEET GLOBE,Clam
Agrolatina,24A0577721,01/29/2025,Sale,-560.0,1040.0,13,IVORY,Clam
Agrolatina,24A0577721,01/29/2025,Sale,-400.0,640.0,13,SWEET GLOBE,Clam
Agrolatina,24A0577721,01/29/2025,Sale,-160.0,480.0,13,SWEET GLOBE,Clam
Agrolatina,24A0577721,01/30/2025,Sale,-80.0,400.0,14,SWEET GLOBE,Clam
Agrolatina,24A0577721,01/31/2025,Sale,-121.0,279.0,15,IVORY,Clam
Agrolatina,24A0577721,01/31/2025,Sale,-80.0,199.0,15,SWEET GLOBE,Clam
Agrolatina,24A0577721,02/03/2025,Sale,-80.0,119.0,18,IVORY,Clam
Agrolatina,24A0577721,02/03/2025,Sale,-80.0,39.0,18,SWEET GLOBE,Clam
Agrolatina,24A0588536,02/20/2025,Entry,1120.0,1120.0,0,IVORY,Clam
Agrolatina,24A0588536,02/20/2025,Entry,480.0,1600.0,0,IVORY,Clam
Agrolatina,24A0588536,02/25/2025,Sale,-320.0,1280.0,5,IVORY,Clam
Agrolatina,24A0588536,02/26/2025,Sale,-640.0,640.0,6,IVORY,Clam
Agrolatina,24A0588536,02/26/2025,Sale,-480.0,160.0,6,IVORY,Clam
Agrolatina,24A0588536,02/26/2025,Sale,-160.0,0.0,6,IVORY,Clam
Agrolatina,24A0591400,03/13/2025,Entry,80.0,80.0,0,AUTUMN CRISP,Clam
Agrolatina,24A0591400,03/13/2025,Entry,1520.0,1600.0,0,AUTUMN CRISP,Clam
Agrolatina,24A0591400,03/29/2025,Sale,-80.0,1520.0,16,AUTUMN CRISP,Clam
Agrolatina,24A0591400,03/31/2025,Sale,-240.0,1280.0,18,AUTUMN CRISP,Clam
Agrolatina,24A0591400,03/31/2025,Sale,-80.0,1200.0,18,AUTUMN CRISP,Clam
Agrolatina,24A0591400,04/01/2025,Sale,-800.0,400.0,19,AUTUMN CRISP,Clam
Agrolatina,24A0591400,04/01/2025,Sale,-400.0,0.0,19,AUTUMN CRISP,Clam
Agrolatina,24A0603517,01/28/2025,Entry,1520.0,1520.0,0,ALLISON,Clam
Agrolatina,24A0603517,01/28/2025,Entry,80.0,1600.0,0,ALLISON,Clam
Agrolatina,24A0603517,02/01/2025,Sale,-80.0,1520.0,4,ALLISON,Clam
Agrolatina,24A0603517,02/01/2025,Sale,-80.0,1440.0,4,ALLISON,Clam
Agrolatina,24A0603517,02/03/2025,Sale,-80.0,1360.0,6,ALLISON,Clam
Agrolatina,24A0603517,02/05/2025,Sale,-320.0,1040.0,8,ALLISON,Clam
Agrolatina,24A0603517,02/07/2025,Sale,-160.0,880.0,10,ALLISON,Clam
Agrolatina,24A0603517,02/08/2025,Sale,-160.0,720.0,11,ALLISON,Clam
Agrolatina,24A0603517,02/10/2025,Sale,-320.0,400.0,13,ALLISON,Clam
Agrolatina,24A0603517,02/13/2025,Sale,-80.0,320.0,16,ALLISON,Clam
Agrolatina,24A0603517,02/13/2025,Sale,-160.0,160.0,16,ALLISON,Clam
Agrolatina,24A0603517,02/17/2025,Sale,-80.0,80.0,20,ALLISON,Clam
Agrolatina,24A0603517,02/27/2025,Sale,-80.0,0.0,30,ALLISON,Clam
Agrolatina,24A0608904,02/24/2025,Entry,400.0,400.0,0,TIMCO,Clam
Agrolatina,24A0608904,02/24/2025,Entry,1200.0,1600.0,0,TIMCO,Clam
Agrolatina,24A0608904,03/21/2025,Sale,-1200.0,400.0,25,TIMCO,Clam
Agrolatina,24A0608904,03/22/2025,Sale,-240.0,160.0,26,TIMCO,Clam
Agrolatina,24A0608904,03/24/2025,Sale,-160.0,0.0,28,TIMCO,Clam
Agrolatina,24A0612226,01/30/2025,Entry,1280.0,1280.0,0,SWEET GLOBE,Clam
Agrolatina,24A0612226,01/30/2025,Entry,320.0,1600.0,0,SWEET GLOBE,Clam
Agrolatina,24A0612226,02/08/2025,Sale,-240.0,1360.0,9,SWEET GLOBE,Clam
Agrolatina,24A0612226,02/08/2025,Sale,-320.0,1040.0,9,SWEET GLOBE,Clam
Agrolatina,24A0612226,02/10/2025,Sale,-240.0,800.0,11,SWEET GLOBE,Clam
Agrolatina,24A0612226,02/10/2025,Sale,-240.0,560.0,11,SWEET GLOBE,Clam
Agrolatina,24A0612226,02/11/2025,Sale,-240.0,320.0,12,SWEET GLOBE,Clam
Agrolatina,24A0612226,02/18/2025,Sale,-80.0,240.0,19,SWEET GLOBE,Clam
Agrolatina,24A0612226,02/18/2025,Sale,-160.0,80.0,19,SWEET GLOBE,Clam
Agrolatina,24A0612226,02/28/2025,Sale,-56.0,24.0,29,SWEET GLOBE,Clam
Agrolatina,24A0620140,03/03/2025,Entry,1040.0,1040.0,0,IVORY,Clam
Agrolatina,24A0620140,03/03/2025,Entry,560.0,1600.0,0,IVORY,Clam
Agrolatina,24A0620140,03/12/2025,Sale,-160.0,1440.0,9,IVORY,Clam
Agrolatina,24A0620140,03/12/2025,Sale,-80.0,1360.0,9,IVORY,Clam
Agrolatina,24A0620140,03/14/2025,Sale,-240.0,1120.0,11,IVORY,Clam
Agrolatina,24A0620140,03/15/2025,Sale,-80.0,1040.0,12,IVORY,Clam
Agrolatina,24A0620140,03/26/2025,Sale,-80.0,960.0,23,IVORY,Clam
Agrolatina,24A0620140,03/27/2025,Sale,-80.0,880.0,24,IVORY,Clam
Agrolatina,24A0620140,04/01/2025,Sale,-80.0,800.0,29,IVORY,Clam
Agrolatina,24A0620140,04/01/2025,Sale,-120.0,680.0,29,IVORY,Clam
Agrolatina,24A0620140,04/02/2025,Sale,-320.0,360.0,30,IVORY,Clam
Agrolatina,24A0620140,04/02/2025,Sale,-40.0,320.0,30,IVORY,Clam
Agrolatina,24A0620140,04/07/2025,Sale,-71.0,249.0,35,IVORY,Clam
Agrolatina,24A0620469,03/03/2025,Entry,1440.0,1440.0,0,IVORY,Clam
Agrolatina,24A0620469,03/03/2025,Entry,160.0,1600.0,0,IVORY,Clam
Agrolatina,24A0620469,03/12/2025,Sale,-320.0,1280.0,9,IVORY,Clam
Agrolatina,24A0620469,03/12/2025,Sale,-80.0,1200.0,9,IVORY,Clam
Agrolatina,24A0620469,03/22/2025,Sale,-40.0,1160.0,19,IVORY,Clam
Agrolatina,24A0620469,04/01/2025,Sale,-80.0,1080.0,29,IVORY,Clam
Agrolatina,24A0620469,04/01/2025,Sale,-40.0,1040.0,29,IVORY,Clam
Agrolatina,24A0620469,04/02/2025,Sale,-320.0,720.0,30,IVORY,Clam
Agrolatina,24A0620469,04/02/2025,Sale,-40.0,680.0,30,IVORY,Clam
Agrolatina,24A0620469,04/02/2025,Sale,-160.0,520.0,30,IVORY,Clam
Agrolatina,24A0620469,04/03/2025,Sale,-240.0,280.0,31,IVORY,Clam
Agrolatina,24A0642534,03/10/2025,Entry,1200.0,1200.0,0,TIMCO,Clam
Agrolatina,24A0642534,03/10/2025,Entry,320.0,1520.0,0,TIMCO,Clam
Agrolatina,24A0642534,03/10/2025,Entry,80.0,1600.0,0,TIMCO,Clam
Agrolatina,24A0642534,03/31/2025,Sale,-80.0,1520.0,21,TIMCO,Clam
Agrolatina,24A0642534,04/03/2025,Sale,-400.0,1120.0,24,TIMCO,Clam
Agrolatina,24A0642534,04/04/2025,Sale,-80.0,1040.0,25,TIMCO,Clam
Agrolatina,24A0642534,04/09/2025,Sale,-80.0,960.0,30,TIMCO,Clam
Agrolatina,24A0642534,04/09/2025,Sale,-320.0,640.0,30,TIMCO,Clam
Agrolatina,24A0642534,04/11/2025,Sale,-640.0,0.0,32,TIMCO,Clam
Agrolatina,24A1014323,02/11/2025,Entry,880.0,880.0,0,SWEET GLOBE,Clam
Agrolatina,24A1014323,02/11/2025,Entry,720.0,1600.0,0,SWEET GLOBE,Clam
Agrolatina,24A1014323,02/22/2025,Sale,-880.0,720.0,11,SWEET GLOBE,Clam
Agrolatina,24A1014323,02/22/2025,Sale,-720.0,0.0,11,SWEET GLOBE,Clam
Agrolatina,24A1023879,03/10/2025,Entry,480.0,480.0,0,AUTUMN CRISP,Clam
Agrolatina,24A1023879,03/10/2025,Entry,80.0,560.0,0,IVORY,Clam
Agrolatina,24A1023879,03/10/2025,Entry,80.0,640.0,0,IVORY,Clam
Agrolatina,24A1023879,03/10/2025,Entry,320.0,960.0,0,SWEET GLOBE,Clam
Agrolatina,24A1023879,03/10/2025,Entry,640.0,1600.0,0,SWEET GLOBE,Clam
Agrolatina,24A1023879,04/02/2025,Sale,-80.0,1520.0,23,IVORY,Clam
Agrolatina,24A1023879,04/02/2025,Sale,-80.0,1440.0,23,IVORY,Clam
Agrolatina,24A1023879,04/02/2025,Sale,-320.0,1120.0,23,SWEET GLOBE,Clam
Agrolatina,24A1023879,04/02/2025,Sale,-480.0,640.0,23,SWEET GLOBE,Clam
Agrolatina,24A1023879,04/03/2025,Sale,-480.0,160.0,24,AUTUMN CRISP,Clam
Agrolatina,24A1023879,04/04/2025,Sale,-80.0,80.0,25,SWEET GLOBE,Clam
Agrolatina,24A1101143,02/17/2025,Entry,960.0,960.0,0,SWEET GLOBE,Clam
Agrolatina,24A1101143,02/17/2025,Entry,640.0,1600.0,0,SWEET GLOBE,Clam
Agrolatina,24A1101143,03/06/2025,Sale,-400.0,1200.0,17,SWEET GLOBE,Clam
Agrolatina,24A1101143,03/08/2025,Sale,-480.0,720.0,19,SWEET GLOBE,Clam
Agrolatina,24A1101143,03/08/2025,Sale,-80.0,640.0,19,SWEET GLOBE,Clam
Agrolatina,24A1101143,03/10/2025,Sale,-100.0,540.0,21,SWEET GLOBE,Clam
Agrolatina,24A1101143,03/10/2025,Sale,-160.0,380.0,21,SWEET GLOBE,Clam
Agrolatina,24A1101143,03/14/2025,Sale,-40.0,340.0,25,SWEET GLOBE,Clam
Agrolatina,24A1101143,03/15/2025,Sale,-60.0,280.0,26,SWEET GLOBE,Clam
Agrolatina,24A1101903,02/17/2025,Entry,1235.0,1235.0,0,IVORY,Bag
Agrolatina,24A1101903,02/17/2025,Entry,380.0,1615.0,0,IVORY,Bag
Agrolatina,24A1101903,02/17/2025,Entry,285.0,1900.0,0,IVORY,Bag
Agrolatina,24A1101903,03/04/2025,Sale,-190.0,1710.0,15,IVORY,Bag
Agrolatina,24A1101903,03/05/2025,Sale,-665.0,1045.0,16,IVORY,Bag
Agrolatina,24A1101903,03/05/2025,Sale,-190.0,855.0,16,IVORY,Bag
Agrolatina,24A1101903,03/08/2025,Sale,-95.0,760.0,19,IVORY,Bag
Agrolatina,24A1101903,03/08/2025,Sale,-145.0,615.0,19,IVORY,Bag
Agrolatina,24A1101903,03/12/2025,Sale,-135.0,480.0,23,IVORY,Bag
Agrolatina,24A1101903,03/12/2025,Sale,-95.0,385.0,23,IVORY,Bag
Agrolatina,24A1101903,03/12/2025,Sale,-170.0,215.0,23,IVORY,Bag
Agrolatina,24A1101903,03/17/2025,Sale,-7.0,208.0,28,IVORY,Bag
Agrolatina,24A1165589,02/13/2025,Entry,285.0,285.0,0,ALLISON,Bag
Agrolatina,24A1165589,02/13/2025,Entry,1520.0,1805.0,0,TIMCO,Bag
Agrolatina,24A1165589,02/13/2025,Entry,95.0,1900.0,0,TIMCO,Bag
Agrolatina,24A1165589,02/21/2025,Sale,-190.0,1710.0,8,TIMCO,Bag
Agrolatina,24A1165589,02/21/2025,Sale,-1235.0,475.0,8,TIMCO,Bag
Agrolatina,24A1165589,02/21/2025,Sale,-95.0,380.0,8,TIMCO,Bag
Agrolatina,24A1165589,03/01/2025,Sale,-190.0,190.0,16,ALLISON,Bag
Agrolatina,24A1165589,03/04/2025,Sale,-95.0,95.0,19,TIMCO,Bag
Agrolatina,24A1165589,03/15/2025,Sale,-95.0,0.0,30,ALLISON,Bag
Agrolatina,24A1175740,02/13/2025,Entry,560.0,560.0,0,CANDY DREAMS,Clam
Agrolatina,24A1175740,02/13/2025,Entry,1040.0,1600.0,0,CANDY DREAMS,Clam
Agrolatina,24A1175740,02/15/2025,Sale,-80.0,1520.0,2,CANDY DREAMS,Clam
Agrolatina,24A1175740,02/15/2025,Sale,-160.0,1360.0,2,CANDY DREAMS,Clam
Agrolatina,24A1175740,02/17/2025,Sale,-80.0,1280.0,4,CANDY DREAMS,Clam
Agrolatina,24A1175740,02/18/2025,Sale,-80.0,1200.0,5,CANDY DREAMS,Clam
Agrolatina,24A1175740,02/18/2025,Sale,-80.0,1120.0,5,CANDY DREAMS,Clam
Agrolatina,24A1175740,02/22/2025,Sale,-160.0,960.0,9,CANDY DREAMS,Clam
Agrolatina,24A1175740,02/22/2025,Sale,-240.0,720.0,9,CANDY DREAMS,Clam
Agrolatina,24A1175740,02/24/2025,Sale,-80.0,640.0,11,CANDY DREAMS,Clam
Agrolatina,24A1175740,02/24/2025,Sale,-240.0,400.0,11,CANDY DREAMS,Clam
Agrolatina,24A1175740,02/25/2025,Sale,-20.0,380.0,12,CANDY DREAMS,Clam
Agrolatina,24A1175740,02/25/2025,Sale,-130.0,250.0,12,CANDY DREAMS,Clam
Agrolatina,24A1175740,02/26/2025,Sale,-20.0,230.0,13,CANDY DREAMS,Clam
Agrolatina,24A1175740,02/27/2025,Sale,-80.0,150.0,14,CANDY DREAMS,Clam
Agrolatina,24A1175740,03/01/2025,Sale,-40.0,110.0,16,CANDY DREAMS,Clam
Agrolatina,24A1175740,03/04/2025,Sale,-60.0,50.0,19,CANDY DREAMS,Clam
Agrolatina,24A1185939,02/24/2025,Entry,640.0,640.0,0,AUTUMN CRISP,Clam
Agrolatina,24A1185939,02/24/2025,Entry,960.0,1600.0,0,AUTUMN CRISP,Clam
Agrolatina,24A1185939,03/15/2025,Sale,-480.0,1120.0,19,AUTUMN CRISP,Clam
Agrolatina,24A1185939,03/17/2025,Sale,-960.0,160.0,21,AUTUMN CRISP,Clam
Agrolatina,24A1185939,03/18/2025,Sale,-160.0,0.0,22,AUTUMN CRISP,Clam
Agrolatina,24A1186787,01/02/2025,Entry,1520.0,1520.0,0,CANDY SNAP,Clam
Agrolatina,24A1186787,01/02/2025,Entry,80.0,1600.0,0,CANDY SNAP,Clam
Agrolatina,24A1186787,01/10/2025,Sale,-1440.0,160.0,8,CANDY SNAP,Clam
Agrolatina,24A1186787,01/10/2025,Sale,-80.0,80.0,8,CANDY SNAP,Clam
Agrolatina,24A1186787,01/14/2025,Sale,-80.0,0.0,12,CANDY SNAP,Clam
Agrolatina,24A1197625,01/18/2025,Entry,1520.0,1520.0,0,CANDY SNAP,Clam
Agrolatina,24A1197625,01/18/2025,Entry,80.0,1600.0,0,CANDY SNAP,Clam
Agrolatina,24A1197625,02/03/2025,Sale,-160.0,1440.0,16,CANDY SNAP,Clam
Agrolatina,24A1197625,02/03/2025,Sale,-240.0,1200.0,16,CANDY SNAP,Clam
Agrolatina,24A1197625,02/17/2025,Sale,-80.0,1120.0,30,CANDY SNAP,Clam
Agrolatina,24A1197625,02/17/2025,Sale,-80.0,1040.0,30,CANDY SNAP,Clam
Agrolatina,24A1197625,03/03/2025,Sale,-160.0,880.0,44,CANDY SNAP,Clam
Agrolatina,24A1197625,03/03/2025,Sale,-240.0,640.0,44,CANDY SNAP,Clam
Agrolatina,24A1197625,03/03/2025,Sale,-280.0,360.0,44,CANDY SNAP,Clam
Agrolatina,24A1197625,03/04/2025,Sale,-202.0,158.0,45,CANDY SNAP,Clam
Agrolatina,24A1202595,02/27/2025,Entry,560.0,560.0,0,CANDY DREAMS,Clam
Agrolatina,24A1202595,02/27/2025,Entry,1040.0,1600.0,0,CANDY DREAMS,Clam
Agrolatina,24A1202595,04/01/2025,Sale,-80.0,1520.0,33,CANDY DREAMS,Clam
Agrolatina,24A1202595,04/11/2025,Sale,-320.0,1200.0,43,CANDY DREAMS,Clam
Agrolatina,24A1202595,04/21/2025,Sale,-160.0,1040.0,53,CANDY DREAMS,Clam
Agrolatina,24A1204679,01/13/2025,Entry,1520.0,1520.0,0,CANDY SNAP,Clam
Agrolatina,24A1204679,01/13/2025,Entry,160.0,1680.0,0,CANDY SNAP,Clam
Agrolatina,24A1204679,02/03/2025,Sale,-160.0,1520.0,21,CANDY SNAP,Clam
Agrolatina,24A1204679,02/06/2025,Sale,-640.0,880.0,24,CANDY SNAP,Clam
Agrolatina,24A1204679,02/10/2025,Sale,-80.0,800.0,28,CANDY SNAP,Clam
Agrolatina,24A1204679,02/17/2025,Sale,-160.0,640.0,35,CANDY SNAP,Clam
Agrolatina,24A1204679,02/27/2025,Sale,-10.0,630.0,45,CANDY SNAP,Clam
Agrolatina,24A1204679,02/28/2025,Sale,-108.0,522.0,46,CANDY SNAP,Clam
Agrolatina,24A1204679,03/01/2025,Sale,-320.0,202.0,47,CANDY SNAP,Clam
Agrolatina,24A1204679,03/03/2025,Sale,-22.0,180.0,49,CANDY SNAP,Clam
Agrolatina,24A1204679,03/03/2025,Sale,-80.0,100.0,49,CANDY SNAP,Clam
Agrolatina,24A1204679,03/04/2025,Sale,-38.0,62.0,50,CANDY SNAP,Clam
Agrolatina,24A1205084,01/19/2025,Entry,960.0,960.0,0,SWEET GLOBE,Clam
Agrolatina,24A1205084,01/19/2025,Entry,640.0,1600.0,0,SWEET GLOBE,Clam
Agrolatina,24A1205084,02/07/2025,Sale,-80.0,1520.0,19,SWEET GLOBE,Clam
Agrolatina,24A1205084,02/07/2025,Sale,-80.0,1440.0,19,SWEET GLOBE,Clam
Agrolatina,24A1205084,02/07/2025,Sale,-80.0,1360.0,19,SWEET GLOBE,Clam
Agrolatina,24A1205084,02/08/2025,Sale,-80.0,1280.0,20,SWEET GLOBE,Clam
Agrolatina,24A1205084,02/10/2025,Sale,-80.0,1200.0,22,SWEET GLOBE,Clam
Agrolatina,24A1205084,02/10/2025,Sale,-80.0,1120.0,22,SWEET GLOBE,Clam
Agrolatina,24A1205084,02/10/2025,Sale,-80.0,1040.0,22,SWEET GLOBE,Clam
Agrolatina,24A1205084,02/11/2025,Sale,-240.0,800.0,23,SWEET GLOBE,Clam
Agrolatina,24A1205084,02/15/2025,Sale,-80.0,720.0,27,SWEET GLOBE,Clam
Agrolatina,24A1205084,02/15/2025,Sale,-80.0,640.0,27,SWEET GLOBE,Clam
Agrolatina,24A1205084,02/18/2025,Sale,-80.0,560.0,30,SWEET GLOBE,Clam
Agrolatina,24A1205084,02/18/2025,Sale,-80.0,480.0,30,SWEET GLOBE,Clam
Agrolatina,24A1205084,02/28/2025,Sale,-50.0,430.0,40,SWEET GLOBE,Clam
Agrolatina,24A1205084,03/05/2025,Sale,-240.0,190.0,45,SWEET GLOBE,Clam
Agrolatina,24A1205084,03/12/2025,Sale,-40.0,150.0,52,SWEET GLOBE,Clam
Agrolatina,24A1205629,02/13/2025,Entry,1120.0,1120.0,0,SWEET GLOBE,Clam
Agrolatina,24A1205629,02/13/2025,Entry,480.0,1600.0,0,SWEET GLOBE,Clam
Agrolatina,24A1205629,02/27/2025,Sale,-640.0,960.0,14,SWEET GLOBE,Clam
Agrolatina,24A1205629,02/27/2025,Sale,-240.0,720.0,14,SWEET GLOBE,Clam
Agrolatina,24A1205629,02/28/2025,Sale,-80.0,640.0,15,SWEET GLOBE,Clam
Agrolatina,24A1205629,03/03/2025,Sale,-160.0,480.0,18,SWEET GLOBE,Clam
Agrolatina,24A1205629,03/10/2025,Sale,-120.0,360.0,25,SWEET GLOBE,Clam
Agrolatina,24A1205629,03/11/2025,Sale,-124.0,236.0,26,SWEET GLOBE,Clam
Agrolatina,24A1205629,03/12/2025,Sale,-140.0,96.0,27,SWEET GLOBE,Clam
Agrolatina,24A1215479,02/20/2025,Entry,935.0,935.0,0,SWEET GLOBE,Clam
Agrolatina,24A1215479,02/20/2025,Entry,765.0,1700.0,0,SWEET GLOBE,Clam
Agrolatina,24A1215479,03/20/2025,Sale,-746.0,954.0,28,SWEET GLOBE,Clam
Agrolatina,24A1215479,04/03/2025,Sale,-96.0,858.0,42,SWEET GLOBE,Bag
Agrolatina,24A1215479,04/07/2025,Sale,-210.0,648.0,46,SWEET GLOBE,Bag
Agrolatina,24A1215479,04/08/2025,Sale,-180.0,468.0,47,SWEET GLOBE,Bag
Agrolatina,24A1227124,03/03/2025,Entry,160.0,160.0,0,ALLISON,Clam
Agrolatina,24A1227124,03/03/2025,Entry,960.0,1120.0,0,ALLISON,Clam
Agrolatina,24A1227124,03/03/2025,Entry,400.0,1520.0,0,TIMCO,Clam
Agrolatina,24A1227124,03/03/2025,Entry,80.0,1600.0,0,TIMCO,Clam
Agrolatina,24A1227124,03/11/2025,Sale,-160.0,1440.0,8,ALLISON,Clam
Agrolatina,24A1227124,03/20/2025,Sale,-720.0,720.0,17,ALLISON,Clam
Agrolatina,24A1227124,03/21/2025,Sale,-160.0,560.0,18,TIMCO,Clam
Agrolatina,24A1227124,03/26/2025,Sale,-160.0,400.0,23,TIMCO,Clam
Agrolatina,24A1227124,03/27/2025,Sale,-180.0,220.0,24,ALLISON,Clam
Agrolatina,24A1227124,03/29/2025,Sale,-80.0,140.0,26,TIMCO,Clam
Agrolatina,24A1227124,03/31/2025,Sale,-80.0,60.0,28,TIMCO,Clam
Agrolatina,24A1227464,01/16/2025,Entry,1520.0,1520.0,0,SWEET GLOBE,Clam
Agrolatina,24A1227464,01/16/2025,Entry,80.0,1600.0,0,SWEET GLOBE,Clam
Agrolatina,24A1227464,02/05/2025,Sale,-80.0,1520.0,20,SWEET GLOBE,Clam
Agrolatina,24A1227464,02/05/2025,Sale,-160.0,1360.0,20,SWEET GLOBE,Clam
Agrolatina,24A1227464,02/05/2025,Sale,-80.0,1280.0,20,SWEET GLOBE,Clam
Agrolatina,24A1227464,02/05/2025,Sale,-80.0,1200.0,20,SWEET GLOBE,Clam
Agrolatina,24A1227464,02/06/2025,Sale,-320.0,880.0,21,SWEET GLOBE,Clam
Agrolatina,24A1227464,02/06/2025,Sale,-480.0,400.0,21,SWEET GLOBE,Clam
Agrolatina,24A1227464,02/06/2025,Sale,-80.0,320.0,21,SWEET GLOBE,Clam
Agrolatina,24A1227464,02/06/2025,Sale,-160.0,160.0,21,SWEET GLOBE,Clam
Agrolatina,24A1227464,02/07/2025,Sale,-80.0,80.0,22,SWEET GLOBE,Clam
Agrolatina,24A1227464,02/13/2025,Sale,-80.0,0.0,28,SWEET GLOBE,Clam
Agrolatina,24A1230260,03/03/2025,Entry,1040.0,1040.0,0,SWEET GLOBE,Clam
Agrolatina,24A1230260,03/03/2025,Entry,560.0,1600.0,0,SWEET GLOBE,Clam
Agrolatina,24A1230260,03/08/2025,Sale,-320.0,1280.0,5,SWEET GLOBE,Clam
Agrolatina,24A1230260,03/13/2025,Sale,-360.0,920.0,10,SWEET GLOBE,Clam
Agrolatina,24A1230260,03/13/2025,Sale,-160.0,760.0,10,SWEET GLOBE,Clam
Agrolatina,24A1230260,03/14/2025,Sale,-80.0,680.0,11,SWEET GLOBE,Clam
Agrolatina,24A1230260,03/14/2025,Sale,-35.0,645.0,11,SWEET GLOBE,Clam
Agrolatina,24A1230260,03/15/2025,Sale,-80.0,565.0,12,SWEET GLOBE,Clam
Agrolatina,24A1230260,03/15/2025,Sale,-160.0,405.0,12,SWEET GLOBE,Clam
Agrolatina,24A1230260,03/15/2025,Sale,-80.0,325.0,12,SWEET GLOBE,Clam
Agrolatina,24A1230260,03/15/2025,Sale,-62.0,263.0,12,SWEET GLOBE,Clam
Agrolatina,24A1256100,01/30/2025,Entry,1440.0,1440.0,0,SWEET GLOBE,Clam
Agrolatina,24A1256100,01/30/2025,Entry,160.0,1600.0,0,SWEET GLOBE,Clam
Agrolatina,24A1256100,02/11/2025,Sale,-240.0,1360.0,12,SWEET GLOBE,Clam
Agrolatina,24A1256100,02/11/2025,Sale,-207.0,1153.0,12,SWEET GLOBE,Clam
Agrolatina,24A1256100,02/11/2025,Sale,-160.0,993.0,12,SWEET GLOBE,Clam
Agrolatina,24A1256100,02/14/2025,Sale,-2.0,991.0,15,SWEET GLOBE,Clam
Agrolatina,24A1256100,02/17/2025,Sale,-160.0,831.0,18,SWEET GLOBE,Clam
Agrolatina,24A1256100,02/17/2025,Sale,-240.0,591.0,18,SWEET GLOBE,Clam
Agrolatina,24A1256100,02/18/2025,Sale,-160.0,431.0,19,SWEET GLOBE,Clam
Agrolatina,24A1256100,02/22/2025,Sale,-10.0,421.0,23,SWEET GLOBE,Clam
Agrolatina,24A1256100,02/22/2025,Sale,-248.0,173.0,23,SWEET GLOBE,Clam
Agrolatina,24A1256100,02/28/2025,Sale,-20.0,153.0,29,SWEET GLOBE,Clam
Agrolatina,24A1259264,01/09/2025,Entry,1280.0,1280.0,0,SWEET GLOBE,Clam
Agrolatina,24A1259264,01/09/2025,Entry,80.0,1360.0,0,SWEET GLOBE,Clam
Agrolatina,24A1259264,01/09/2025,Entry,240.0,1600.0,0,SWEET GLOBE,Clam
Agrolatina,24A1259264,01/18/2025,Sale,-1280.0,320.0,9,SWEET GLOBE,Clam
Agrolatina,24A1259264,01/20/2025,Sale,-240.0,80.0,11,SWEET GLOBE,Clam
Agrolatina,24A1259264,01/22/2025,Sale,-80.0,0.0,13,SWEET GLOBE,Clam
Agrolatina,24A1260619,01/16/2025,Entry,800.0,800.0,0,ALLISON,Clam
Agrolatina,24A1260619,01/16/2025,Entry,800.0,1600.0,0,ALLISON,Clam
Agrolatina,24A1260619,01/29/2025,Sale,-80.0,1520.0,13,ALLISON,Clam
Agrolatina,24A1260619,01/30/2025,Sale,-80.0,1440.0,14,ALLISON,Clam
Agrolatina,24A1260619,01/30/2025,Sale,-160.0,1280.0,14,ALLISON,Clam
Agrolatina,24A1260619,01/30/2025,Sale,-80.0,1200.0,14,ALLISON,Clam
Agrolatina,24A1260619,02/04/2025,Sale,-240.0,960.0,19,ALLISON,Clam
Agrolatina,24A1260619,02/04/2025,Sale,-80.0,880.0,19,ALLISON,Clam
Agrolatina,24A1260619,02/05/2025,Sale,-80.0,800.0,20,ALLISON,Clam
Agrolatina,24A1260619,02/05/2025,Sale,-80.0,720.0,20,ALLISON,Clam
Agrolatina,24A1260619,02/05/2025,Sale,-160.0,560.0,20,ALLISON,Clam
Agrolatina,24A1260619,02/06/2025,Sale,-80.0,480.0,21,ALLISON,Clam
Agrolatina,24A1260619,02/08/2025,Sale,-80.0,400.0,23,ALLISON,Clam
Agrolatina,24A1260619,02/10/2025,Sale,-240.0,160.0,25,ALLISON,Clam
Agrolatina,24A1260619,02/11/2025,Sale,-80.0,80.0,26,ALLISON,Clam
Agrolatina,24A1260619,02/13/2025,Sale,-80.0,0.0,28,ALLISON,Clam
Agrolatina,24A1261723,01/16/2025,Entry,1440.0,1440.0,0,ALLISON,Clam
Agrolatina,24A1261723,01/16/2025,Entry,160.0,1600.0,0,ALLISON,Clam
Agrolatina,24A1261723,01/30/2025,Sale,-80.0,1520.0,14,ALLISON,Clam
Agrolatina,24A1261723,02/03/2025,Sale,-160.0,1360.0,18,ALLISON,Clam
Agrolatina,24A1261723,02/03/2025,Sale,-80.0,1280.0,18,ALLISON,Clam
Agrolatina,24A1261723,02/04/2025,Sale,-160.0,1120.0,19,ALLISON,Clam
Agrolatina,24A1261723,02/04/2025,Sale,-320.0,800.0,19,ALLISON,Clam
Agrolatina,24A1261723,02/05/2025,Sale,-160.0,640.0,20,ALLISON,Clam
Agrolatina,24A1261723,02/05/2025,Sale,-80.0,560.0,20,ALLISON,Clam
Agrolatina,24A1261723,02/07/2025,Sale,-400.0,160.0,22,ALLISON,Clam
Agrolatina,24A1261723,02/08/2025,Sale,-80.0,80.0,23,ALLISON,Clam
Agrolatina,24A1261723,02/10/2025,Sale,-80.0,0.0,25,ALLISON,Clam
Agrolatina,24A1262437,01/11/2025,Entry,1440.0,1440.0,0,CANDY SNAP,Clam
Agrolatina,24A1262437,01/11/2025,Entry,160.0,1600.0,0,CANDY SNAP,Clam
Agrolatina,24A1262437,01/23/2025,Sale,-400.0,1200.0,12,CANDY SNAP,Clam
Agrolatina,24A1262437,01/24/2025,Sale,-960.0,240.0,13,CANDY SNAP,Clam
Agrolatina,24A1262437,01/24/2025,Sale,-80.0,160.0,13,CANDY SNAP,Clam
Agrolatina,24A1262437,01/28/2025,Sale,-160.0,0.0,17,CANDY SNAP,Clam
Agrolatina,24A1264868,03/04/2025,Entry,1040.0,1040.0,0,SWEET GLOBE,Clam
Agrolatina,24A1264868,03/04/2025,Entry,560.0,1600.0,0,SWEET GLOBE,Clam
Agrolatina,24A1264868,03/07/2025,Sale,-400.0,1200.0,3,SWEET GLOBE,Clam
Agrolatina,24A1264868,03/08/2025,Sale,-80.0,1120.0,4,SWEET GLOBE,Clam
Agrolatina,24A1264868,03/08/2025,Sale,-560.0,560.0,4,SWEET GLOBE,Clam
Agrolatina,24A1264868,03/10/2025,Sale,-80.0,480.0,6,SWEET GLOBE,Clam
Agrolatina,24A1264868,03/10/2025,Sale,-40.0,440.0,6,SWEET GLOBE,Clam
Agrolatina,24A1264868,03/11/2025,Sale,-160.0,280.0,7,SWEET GLOBE,Clam
Agrolatina,24A1264868,03/13/2025,Sale,-40.0,240.0,9,SWEET GLOBE,Clam
Agrolatina,24A1264868,03/14/2025,Sale,-40.0,200.0,10,SWEET GLOBE,Clam
Agrolatina,24A1264868,03/15/2025,Sale,-20.0,180.0,11,SWEET GLOBE,Clam
Agrolatina,24A1269935,02/11/2025,Entry,1440.0,1440.0,0,TIMCO,Clam
Agrolatina,24A1269935,02/11/2025,Entry,160.0,1600.0,0,TIMCO,Clam
Agrolatina,24A1269935,03/05/2025,Sale,-1360.0,240.0,22,TIMCO,Clam
Agrolatina,24A1269935,03/05/2025,Sale,-160.0,80.0,22,TIMCO,Clam
Agrolatina,24A1269935,03/07/2025,Sale,-80.0,0.0,24,TIMCO,Clam
Agrolatina,24A1271722,03/09/2025,Entry,1440.0,1440.0,0,TIMCO,Clam
Agrolatina,24A1271722,03/09/2025,Entry,160.0,1600.0,0,TIMCO,Clam
Agrolatina,24A1271722,03/21/2025,Sale,-160.0,1440.0,12,TIMCO,Clam
Agrolatina,24A1271722,03/28/2025,Sale,-160.0,1280.0,19,TIMCO,Clam
Agrolatina,24A1271722,04/03/2025,Sale,-320.0,960.0,25,TIMCO,Clam
Agrolatina,24A1271722,04/04/2025,Sale,-160.0,800.0,26,TIMCO,Clam
Agrolatina,24A1271722,04/05/2025,Sale,-80.0,720.0,27,TIMCO,Clam
Agrolatina,24A1271722,04/05/2025,Sale,-640.0,80.0,27,TIMCO,Clam
Agrolatina,24A1271722,04/07/2025,Sale,-80.0,0.0,29,TIMCO,Clam
Agrolatina,24A1272862,12/31/2024,Entry,1600.0,1600.0,0,CANDY SNAP,Clam
Agrolatina,24A1272862,01/22/2025,Sale,-80.0,1520.0,22,CANDY SNAP,Clam
Agrolatina,24A1272862,01/22/2025,Sale,-1520.0,0.0,22,CANDY SNAP,Clam
Agrolatina,24A1274525,12/31/2024,Entry,1440.0,1440.0,0,CANDY SNAP,Clam
Agrolatina,24A1274525,12/31/2024,Entry,160.0,1600.0,0,CANDY SNAP,Clam
Agrolatina,24A1274525,01/14/2025,Sale,-480.0,1120.0,14,CANDY SNAP,Clam
Agrolatina,24A1274525,01/14/2025,Sale,-1040.0,80.0,14,CANDY SNAP,Clam
Agrolatina,24A1274525,01/14/2025,Sale,-80.0,0.0,14,CANDY SNAP,Clam
Agrolatina,24A1277967,02/03/2025,Entry,1440.0,1440.0,0,CANDY DREAMS,Clam
Agrolatina,24A1277967,02/03/2025,Entry,80.0,1520.0,0,CANDY DREAMS,Clam
Agrolatina,24A1277967,02/03/2025,Entry,80.0,1600.0,0,CANDY DREAMS,Clam
Agrolatina,24A1277967,03/06/2025,Sale,-30.0,1570.0,31,CANDY DREAMS,Clam
Agrolatina,24A1277967,03/08/2025,Sale,-640.0,930.0,33,CANDY DREAMS,Clam
Agrolatina,24A1277967,03/09/2025,Sale,-400.0,530.0,34,CANDY DREAMS,Clam
Agrolatina,24A1277967,03/11/2025,Sale,-110.0,420.0,36,CANDY DREAMS,Clam
Agrolatina,24A1277967,03/11/2025,Sale,-160.0,260.0,36,CANDY DREAMS,Clam
Agrolatina,24A1277967,03/11/2025,Sale,-70.0,190.0,36,CANDY DREAMS,Clam
Agrolatina,24A1284605,12/26/2024,Entry,1200.0,1200.0,0,SWEET GLOBE,Clam
Agrolatina,24A1284605,12/26/2024,Entry,400.0,1600.0,0,SWEET GLOBE,Clam
Agrolatina,24A1284605,01/07/2025,Sale,-1200.0,400.0,12,SWEET GLOBE,Clam
Agrolatina,24A1284605,01/07/2025,Sale,-400.0,0.0,12,SWEET GLOBE,Clam
Agrolatina,24A1288088,03/03/2025,Entry,1360.0,1360.0,0,TIMCO,Clam
Agrolatina,24A1288088,03/03/2025,Entry,240.0,1600.0,0,TIMCO,Clam
Agrolatina,24A1288088,03/21/2025,Sale,-80.0,1520.0,18,TIMCO,Clam
Agrolatina,24A1288088,03/21/2025,Sale,-640.0,880.0,18,TIMCO,Clam
Agrolatina,24A1288088,03/24/2025,Sale,-320.0,560.0,21,TIMCO,Clam
Agrolatina,24A1288088,03/26/2025,Sale,-320.0,240.0,23,TIMCO,Clam
Agrolatina,24A1288088,03/28/2025,Sale,-80.0,160.0,25,TIMCO,Clam
Agrolatina,24A1288088,03/29/2025,Sale,-80.0,80.0,26,TIMCO,Clam
Agrolatina,24A1288088,03/31/2025,Sale,-80.0,0.0,28,TIMCO,Clam
Agrolatina,24A1291219,01/02/2025,Entry,80.0,80.0,0,IVORY,Clam
Agrolatina,24A1291219,01/02/2025,Entry,80.0,160.0,0,IVORY,Clam
Agrolatina,24A1291219,01/02/2025,Entry,1200.0,1360.0,0,SWEET GLOBE,Clam
Agrolatina,24A1291219,01/02/2025,Entry,240.0,1600.0,0,SWEET GLOBE,Clam
Agrolatina,24A1291219,01/17/2025,Sale,-160.0,1440.0,15,SWEET GLOBE,Clam
Agrolatina,24A1291219,01/18/2025,Sale,-80.0,1360.0,16,IVORY,Clam
Agrolatina,24A1291219,01/18/2025,Sale,-80.0,1280.0,16,IVORY,Clam
Agrolatina,24A1291219,01/18/2025,Sale,-1040.0,240.0,16,SWEET GLOBE,Clam
Agrolatina,24A1291219,01/18/2025,Sale,-240.0,0.0,16,SWEET GLOBE,Clam
Agrolatina,24A1295560,12/26/2024,Entry,1280.0,1280.0,0,SWEET GLOBE,Clam
Agrolatina,24A1295560,12/26/2024,Entry,80.0,1360.0,0,SWEET GLOBE,Clam
Agrolatina,24A1295560,12/26/2024,Entry,240.0,1600.0,0,SWEET GLOBE,Clam
Agrolatina,24A1295560,01/07/2025,Sale,-80.0,1520.0,12,SWEET GLOBE,Clam
Agrolatina,24A1295560,01/08/2025,Sale,-480.0,1040.0,13,SWEET GLOBE,Clam
Agrolatina,24A1295560,01/08/2025,Sale,-800.0,240.0,13,SWEET GLOBE,Clam
Agrolatina,24A1295560,01/11/2025,Sale,-240.0,0.0,16,SWEET GLOBE,Clam
Agrolatina,24A1299781,02/27/2025,Entry,665.0,665.0,0,COTTON CANDY,Bag
Agrolatina,24A1299781,02/27/2025,Entry,1235.0,1900.0,0,COTTON CANDY,Bag
Agrolatina,24A1299781,03/18/2025,Sale,-380.0,1520.0,19,COTTON CANDY,Bag
Agrolatina,24A1299781,04/08/2025,Sale,-72.0,1448.0,40,COTTON CANDY,Bag
Agrolatina,24A1299781,04/18/2025,Sale,-1235.0,213.0,50,COTTON CANDY,Bag
Agrolatina,24A1317083,01/02/2025,Entry,1440.0,1440.0,0,CANDY SNAP,Clam
Agrolatina,24A1317083,01/02/2025,Entry,160.0,1600.0,0,CANDY SNAP,Clam
Agrolatina,24A1317083,01/09/2025,Sale,-160.0,1440.0,7,CANDY SNAP,Clam
Agrolatina,24A1317083,01/09/2025,Sale,-160.0,1280.0,7,CANDY SNAP,Clam
Agrolatina,24A1317083,01/11/2025,Sale,-960.0,320.0,9,CANDY SNAP,Clam
Agrolatina,24A1317083,01/14/2025,Sale,-320.0,0.0,12,CANDY SNAP,Clam
Agrolatina,24A1317592,12/23/2024,Entry,1120.0,1120.0,0,SWEET GLOBE,Clam
Agrolatina,24A1317592,12/23/2024,Entry,480.0,1600.0,0,SWEET GLOBE,Clam
Agrolatina,24A1317592,01/14/2025,Sale,-80.0,1520.0,22,SWEET GLOBE,Clam
Agrolatina,24A1317592,01/14/2025,Sale,-240.0,1280.0,22,SWEET GLOBE,Clam
Agrolatina,24A1317592,01/15/2025,Sale,-960.0,320.0,23,SWEET GLOBE,Clam
Agrolatina,24A1317592,01/15/2025,Sale,-80.0,240.0,23,SWEET GLOBE,Clam
Agrolatina,24A1317592,01/15/2025,Sale,-240.0,0.0,23,SWEET GLOBE,Clam
Agrolatina,24A1317910,01/16/2025,Entry,1280.0,1280.0,0,SWEET GLOBE,Clam
Agrolatina,24A1317910,01/16/2025,Entry,320.0,1600.0,0,SWEET GLOBE,Clam
Agrolatina,24A1317910,01/29/2025,Sale,-800.0,800.0,13,SWEET GLOBE,Clam
Agrolatina,24A1317910,01/29/2025,Sale,-160.0,640.0,13,SWEET GLOBE,Clam
Agrolatina,24A1317910,01/30/2025,Sale,-80.0,560.0,14,SWEET GLOBE,Clam
Agrolatina,24A1317910,01/30/2025,Sale,-160.0,400.0,14,SWEET GLOBE,Clam
Agrolatina,24A1317910,01/30/2025,Sale,-80.0,320.0,14,SWEET GLOBE,Clam
Agrolatina,24A1317910,02/03/2025,Sale,-160.0,160.0,18,SWEET GLOBE,Clam
Agrolatina,24A1317910,02/03/2025,Sale,-80.0,80.0,18,SWEET GLOBE,Clam
Agrolatina,24A1317910,02/13/2025,Sale,-80.0,0.0,28,SWEET GLOBE,Clam
Agrolatina,24A1318876,12/23/2024,Entry,1600.0,1600.0,0,CANDY SNAP,Clam
Agrolatina,24A1318876,01/06/2025,Sale,-1600.0,0.0,14,CANDY SNAP,Clam
Agrolatina,24A1322157,02/17/2025,Entry,1280.0,1280.0,0,IVORY,Clam
Agrolatina,24A1322157,02/17/2025,Entry,320.0,1600.0,0,IVORY,Clam
Agrolatina,24A1322157,02/26/2025,Sale,-240.0,1360.0,9,IVORY,Clam
Agrolatina,24A1322157,02/26/2025,Sale,-560.0,800.0,9,IVORY,Clam
Agrolatina,24A1322157,03/22/2025,Sale,-240.0,560.0,33,IVORY,Clam
Agrolatina,24A1322157,03/22/2025,Sale,-80.0,480.0,33,IVORY,Clam
Agrolatina,24A1322157,03/22/2025,Sale,-80.0,400.0,33,IVORY,Clam
Agrolatina,24A1322157,03/27/2025,Sale,-40.0,360.0,38,IVORY,Clam
Agrolatina,24A1322157,03/29/2025,Sale,-27.0,333.0,40,IVORY,Clam
Agrolatina,24A1322157,03/29/2025,Sale,-180.0,153.0,40,IVORY,Clam
Agrolatina,24A1330146,12/30/2024,Entry,1520.0,1520.0,0,SWEET GLOBE,Clam
Agrolatina,24A1330146,12/30/2024,Entry,80.0,1600.0,0,SWEET GLOBE,Clam
Agrolatina,24A1330146,01/18/2025,Sale,-1520.0,80.0,19,SWEET GLOBE,Clam
Agrolatina,24A1330146,01/23/2025,Sale,-80.0,0.0,24,SWEET GLOBE,Clam
Agrolatina,24A1330316,01/27/2025,Entry,1360.0,1360.0,0,SWEET GLOBE,Clam
Agrolatina,24A1330316,01/27/2025,Entry,240.0,1600.0,0,SWEET GLOBE,Clam
Agrolatina,24A1330316,02/01/2025,Sale,-1360.0,240.0,5,SWEET GLOBE,Clam
Agrolatina,24A1330316,02/04/2025,Sale,-240.0,0.0,8,SWEET GLOBE,Clam
Agrolatina,24A1333803,02/17/2025,Entry,1200.0,1200.0,0,IVORY,Clam
Agrolatina,24A1333803,02/17/2025,Entry,400.0,1600.0,0,IVORY,Clam
Agrolatina,24A1333803,02/25/2025,Sale,-400.0,1200.0,8,IVORY,Clam
Agrolatina,24A1333803,02/25/2025,Sale,-480.0,720.0,8,IVORY,Clam
Agrolatina,24A1333803,02/25/2025,Sale,-80.0,640.0,8,IVORY,Clam
Agrolatina,24A1333803,02/25/2025,Sale,-240.0,400.0,8,IVORY,Clam
Agrolatina,24A1333803,02/25/2025,Sale,-160.0,240.0,8,IVORY,Clam
Agrolatina,24A1333803,02/26/2025,Sale,-80.0,160.0,9,IVORY,Clam
Agrolatina,24A1333803,03/28/2025,Sale,-80.0,80.0,39,IVORY,Clam
Agrolatina,24A1333803,03/29/2025,Sale,-20.0,60.0,40,IVORY,Clam
Agrolatina,24A1333839,01/02/2025,Entry,1280.0,1280.0,0,CANDY SNAP,Clam
Agrolatina,24A1333839,01/02/2025,Entry,320.0,1600.0,0,CANDY SNAP,Clam
Agrolatina,24A1333839,01/09/2025,Sale,-800.0,800.0,7,CANDY SNAP,Clam
Agrolatina,24A1333839,01/09/2025,Sale,-240.0,560.0,7,CANDY SNAP,Clam
Agrolatina,24A1333839,01/10/2025,Sale,-480.0,80.0,8,CANDY SNAP,Clam
Agrolatina,24A1333839,01/14/2025,Sale,-80.0,0.0,12,CANDY SNAP,Clam
Agrolatina,24A1334435,01/03/2025,Entry,1520.0,1520.0,0,SWEET GLOBE,Clam
Agrolatina,24A1334435,01/03/2025,Entry,80.0,1600.0,0,SWEET GLOBE,Clam
Agrolatina,24A1334435,01/16/2025,Sale,-1520.0,80.0,13,SWEET GLOBE,Clam
Agrolatina,24A1334435,01/18/2025,Sale,-80.0,0.0,15,SWEET GLOBE,Clam
Agrolatina,24A1338240,12/23/2024,Entry,1120.0,1120.0,0,SWEET GLOBE,Clam
Agrolatina,24A1338240,12/23/2024,Entry,80.0,1200.0,0,SWEET GLOBE,Clam
Agrolatina,24A1338240,12/23/2024,Entry,400.0,1600.0,0,SWEET GLOBE,Clam
Agrolatina,24A1338240,01/04/2025,Sale,-160.0,1440.0,12,SWEET GLOBE,Clam
Agrolatina,24A1338240,01/07/2025,Sale,-1120.0,320.0,15,SWEET GLOBE,Clam
Agrolatina,24A1338240,01/08/2025,Sale,-80.0,240.0,16,SWEET GLOBE,Clam
Agrolatina,24A1338240,01/08/2025,Sale,-240.0,0.0,16,SWEET GLOBE,Clam
Agrolatina,24A1339971,02/27/2025,Entry,800.0,800.0,0,SWEET GLOBE,Clam
Agrolatina,24A1339971,02/27/2025,Entry,80.0,880.0,0,SWEET GLOBE,Clam
Agrolatina,24A1339971,02/27/2025,Entry,720.0,1600.0,0,SWEET GLOBE,Clam
Agrolatina,24A1339971,03/05/2025,Sale,-160.0,1440.0,6,SWEET GLOBE,Clam
Agrolatina,24A1339971,03/08/2025,Sale,-160.0,1280.0,9,SWEET GLOBE,Clam
Agrolatina,24A1339971,03/08/2025,Sale,-240.0,1040.0,9,SWEET GLOBE,Clam
Agrolatina,24A1339971,03/11/2025,Sale,-60.0,980.0,12,SWEET GLOBE,Clam
Agrolatina,24A1339971,03/13/2025,Sale,-77.0,903.0,14,SWEET GLOBE,Clam
Agrolatina,24A1339971,03/13/2025,Sale,-40.0,863.0,14,SWEET GLOBE,Clam
Agrolatina,24A1339971,03/14/2025,Sale,-280.0,583.0,15,SWEET GLOBE,Clam
Agrolatina,24A1339971,03/14/2025,Sale,-240.0,343.0,15,SWEET GLOBE,Clam
Agrolatina,24A1339971,03/15/2025,Sale,-80.0,263.0,16,SWEET GLOBE,Clam
Agrolatina,24A1339971,03/15/2025,Sale,-20.0,243.0,16,SWEET GLOBE,Clam
Agrolatina,24A1339971,03/17/2025,Sale,-60.0,183.0,18,SWEET GLOBE,Clam
Agrolatina,24A1355967,12/30/2024,Entry,1600.0,1600.0,0,CANDY SNAP,Clam
Agrolatina,24A1355967,01/18/2025,Sale,-1600.0,0.0,19,CANDY SNAP,Clam
Agrolatina,24A1357208,02/27/2025,Entry,595.0,595.0,0,SWEET GLOBE,Clam
Agrolatina,24A1357208,02/27/2025,Entry,1105.0,1700.0,0,SWEET GLOBE,Clam
Agrolatina,24A1357208,03/19/2025,Sale,-170.0,1530.0,20,SWEET GLOBE,Clam
Agrolatina,24A1357208,03/19/2025,Sale,-85.0,1445.0,20,SWEET GLOBE,Clam
Agrolatina,24A1357208,03/20/2025,Sale,-113.0,1332.0,21,SWEET GLOBE,Clam
Agrolatina,24A1357208,04/03/2025,Sale,-660.0,672.0,35,SWEET GLOBE,Bag
Agrolatina,24A1357208,04/07/2025,Sale,-30.0,642.0,39,SWEET GLOBE,Bag
Agrolatina,24A1357208,04/08/2025,Sale,-50.0,592.0,40,SWEET GLOBE,Bag
Agrolatina,24A1362884,12/26/2024,Entry,1600.0,1600.0,0,CANDY SNAP,Clam
Agrolatina,24A1362884,01/08/2025,Sale,-800.0,800.0,13,CANDY SNAP,Clam
Agrolatina,24A1362884,01/08/2025,Sale,-800.0,0.0,13,CANDY SNAP,Clam
Agrolatina,24A1364569,02/04/2025,Entry,560.0,560.0,0,AUTUMN CRISP,Clam
Agrolatina,24A1364569,02/04/2025,Entry,1040.0,1600.0,0,AUTUMN CRISP,Clam
Agrolatina,24A1364569,02/21/2025,Sale,-960.0,640.0,17,AUTUMN CRISP,Clam
Agrolatina,24A1364569,02/26/2025,Sale,-240.0,400.0,22,AUTUMN CRISP,Clam
Agrolatina,24A1364569,03/01/2025,Sale,-320.0,80.0,25,AUTUMN CRISP,Clam
Agrolatina,24A1364569,03/03/2025,Sale,-80.0,0.0,27,AUTUMN CRISP,Clam
Agrolatina,24A1375583,01/16/2025,Entry,1600.0,1600.0,0,ALLISON,Clam
Agrolatina,24A1375583,02/19/2025,Sale,-80.0,1520.0,34,ALLISON,Clam
Agrolatina,24A1375583,02/20/2025,Sale,-400.0,1120.0,35,ALLISON,Clam
Agrolatina,24A1375583,02/24/2025,Sale,-560.0,560.0,39,ALLISON,Clam
Agrolatina,24A1375583,02/25/2025,Sale,-320.0,240.0,40,ALLISON,Clam
Agrolatina,24A1375583,02/27/2025,Sale,-240.0,0.0,42,ALLISON,Clam
Agrolatina,24A1392169,12/30/2024,Entry,1520.0,1520.0,0,CANDY SNAP,Clam
Agrolatina,24A1392169,12/30/2024,Entry,80.0,1600.0,0,CANDY SNAP,Clam
Agrolatina,24A1392169,01/20/2025,Sale,-640.0,960.0,21,CANDY SNAP,Clam
Agrolatina,24A1392169,01/20/2025,Sale,-80.0,880.0,21,CANDY SNAP,Clam
Agrolatina,24A1392169,01/21/2025,Sale,-320.0,560.0,22,CANDY SNAP,Clam
Agrolatina,24A1392169,01/21/2025,Sale,-560.0,0.0,22,CANDY SNAP,Clam
Agrolatina,24A1392597,03/04/2025,Entry,640.0,640.0,0,CANDY DREAMS,Clam
Agrolatina,24A1392597,03/04/2025,Entry,960.0,1600.0,0,CANDY DREAMS,Clam
Agrolatina,24A1392597,03/05/2025,Sale,-480.0,1120.0,1,CANDY DREAMS,Clam
Agrolatina,24A1392597,03/29/2025,Sale,-80.0,1040.0,25,CANDY DREAMS,Clam
Agrolatina,24A1392597,03/31/2025,Sale,-160.0,880.0,27,CANDY DREAMS,Clam
Agrolatina,24A1392597,04/01/2025,Sale,-160.0,720.0,28,CANDY DREAMS,Clam
Agrolatina,24A1392597,04/02/2025,Sale,-160.0,560.0,29,CANDY DREAMS,Clam
Agrolatina,24A1396925,03/09/2025,Entry,1280.0,1280.0,0,TIMCO,Clam
Agrolatina,24A1396925,03/09/2025,Entry,320.0,1600.0,0,TIMCO,Clam
Agrolatina,24A1396925,03/28/2025,Sale,-240.0,1360.0,19,TIMCO,Clam
Agrolatina,24A1396925,03/29/2025,Sale,-80.0,1280.0,20,TIMCO,Clam
Agrolatina,24A1396925,04/01/2025,Sale,-80.0,1200.0,23,TIMCO,Clam
Agrolatina,24A1396925,04/02/2025,Sale,-400.0,800.0,24,TIMCO,Clam
Agrolatina,24A1396925,04/05/2025,Sale,-80.0,720.0,27,TIMCO,Clam
Agrolatina,24A1396925,04/05/2025,Sale,-80.0,640.0,27,TIMCO,Clam
Agrolatina,24A1396925,04/07/2025,Sale,-80.0,560.0,29,TIMCO,Clam
Agrolatina,24A1396925,04/09/2025,Sale,-400.0,160.0,31,TIMCO,Clam
Agrolatina,24A1396925,04/10/2025,Sale,-160.0,0.0,32,TIMCO,Clam
Agrolatina,24A1404487,02/10/2025,Entry,1200.0,1200.0,0,SWEET FAVORS,Clam
Agrolatina,24A1404487,02/10/2025,Entry,400.0,1600.0,0,SWEET FAVORS,Clam
Agrolatina,24A1404487,03/01/2025,Sale,-560.0,1040.0,19,SWEET FAVORS,Clam
Agrolatina,24A1404487,03/01/2025,Sale,-400.0,640.0,19,SWEET FAVORS,Clam
Agrolatina,24A1404487,03/02/2025,Sale,-560.0,80.0,20,SWEET FAVORS,Clam
Agrolatina,24A1404487,03/27/2025,Sale,-80.0,0.0,45,SWEET FAVORS,Clam
Agrolatina,24A1404526,02/27/2025,Entry,950.0,950.0,0,COTTON CANDY,Bag
Agrolatina,24A1404526,02/27/2025,Entry,950.0,1900.0,0,COTTON CANDY,Bag
Agrolatina,24A1404526,03/04/2025,Sale,-20.0,1880.0,5,COTTON CANDY,Bag
Agrolatina,24A1404526,03/05/2025,Sale,-20.0,1860.0,6,COTTON CANDY,Bag
Agrolatina,24A1404526,03/08/2025,Sale,-875.0,985.0,9,COTTON CANDY,Bag
Agrolatina,24A1404526,03/18/2025,Sale,-95.0,890.0,19,COTTON CANDY,Bag
Agrolatina,24A1404526,04/03/2025,Sale,-20.0,870.0,35,COTTON CANDY,Bag
Agrolatina,24A1404526,04/04/2025,Sale,-190.0,680.0,36,COTTON CANDY,Bag
Agrolatina,24A1404526,04/18/2025,Sale,-475.0,205.0,50,COTTON CANDY,Bag
Agrolatina,24A1405586,03/09/2025,Entry,1600.0,1600.0,0,TIMCO,Clam
Agrolatina,24A1405586,04/02/2025,Sale,-1360.0,240.0,24,TIMCO,Clam
Agrolatina,24A1405586,04/02/2025,Sale,-80.0,160.0,24,TIMCO,Clam
Agrolatina,24A1405586,04/05/2025,Sale,-80.0,80.0,27,TIMCO,Clam
Agrolatina,24A1405586,04/07/2025,Sale,-80.0,0.0,29,TIMCO,Clam
Agrolatina,24A1409128,03/04/2025,Entry,560.0,560.0,0,AUTUMN CRISP,Clam
Agrolatina,24A1409128,03/04/2025,Entry,1040.0,1600.0,0,AUTUMN CRISP,Clam
Agrolatina,24A1409581,03/04/2025,Entry,720.0,720.0,0,TIMCO,Clam
Agrolatina,24A1409581,03/04/2025,Entry,880.0,1600.0,0,TIMCO,Clam
Agrolatina,24A1409581,04/01/2025,Sale,-240.0,1360.0,28,TIMCO,Clam
Agrolatina,24A1409581,04/01/2025,Sale,-720.0,640.0,28,TIMCO,Clam
Agrolatina,24A1409581,04/02/2025,Sale,-160.0,480.0,29,TIMCO,Clam
Agrolatina,24A1409581,04/08/2025,Sale,-240.0,240.0,35,TIMCO,Clam
Agrolatina,24A1409581,04/12/2025,Sale,-80.0,160.0,39,TIMCO,Clam
Agrolatina,24A1409581,04/16/2025,Sale,-160.0,0.0,43,TIMCO,Clam
Agrolatina,24A1410005,02/05/2025,Entry,1280.0,1280.0,0,SWEET GLOBE,Clam
Agrolatina,24A1410005,02/05/2025,Entry,320.0,1600.0,0,SWEET GLOBE,Clam
Agrolatina,24A1410005,02/18/2025,Sale,-80.0,1520.0,13,SWEET GLOBE,Clam
Agrolatina,24A1410005,02/22/2025,Sale,-886.0,634.0,17,SWEET GLOBE,Clam
Agrolatina,24A1410005,03/05/2025,Sale,-50.0,584.0,28,SWEET GLOBE,Clam
Agrolatina,24A1410005,03/10/2025,Sale,-118.0,466.0,33,SWEET GLOBE,Clam
Agrolatina,24A1410005,03/11/2025,Sale,-20.0,446.0,34,SWEET GLOBE,Clam
Agrolatina,24A1413175,03/10/2025,Entry,160.0,160.0,0,AUTUMN CRISP,Clam
Agrolatina,24A1413175,03/10/2025,Entry,1440.0,1600.0,0,AUTUMN CRISP,Clam
Agrolatina,24A1413908,02/27/2025,Entry,1120.0,1120.0,0,COTTON CANDY,Clam
Agrolatina,24A1413908,02/27/2025,Entry,480.0,1600.0,0,COTTON CANDY,Clam
Agrolatina,24A1413908,03/03/2025,Sale,-160.0,1440.0,4,COTTON CANDY,Clam
Agrolatina,24A1413908,03/04/2025,Sale,-320.0,1120.0,5,COTTON CANDY,Clam
Agrolatina,24A1413908,03/07/2025,Sale,-80.0,1040.0,8,COTTON CANDY,Clam
Agrolatina,24A1413908,04/02/2025,Sale,-40.0,1000.0,34,COTTON CANDY,Clam
Agrolatina,24A1417781,12/30/2024,Entry,1360.0,1360.0,0,CANDY SNAP,Clam
Agrolatina,24A1417781,12/30/2024,Entry,240.0,1600.0,0,CANDY SNAP,Clam
Agrolatina,24A1417781,01/20/2025,Sale,-160.0,1440.0,21,CANDY SNAP,Clam
Agrolatina,24A1417781,01/21/2025,Sale,-240.0,1200.0,22,CANDY SNAP,Clam
Agrolatina,24A1417781,01/23/2025,Sale,-1200.0,0.0,24,CANDY SNAP,Clam
Agrolatina,24A1422433,01/27/2025,Entry,240.0,240.0,0,ALLISON,Clam
Agrolatina,24A1422433,01/27/2025,Entry,240.0,480.0,0,ALLISON,Clam
Agrolatina,24A1422433,01/27/2025,Entry,400.0,880.0,0,CANDY DREAMS,Clam
Agrolatina,24A1422433,01/27/2025,Entry,240.0,1120.0,0,CANDY DREAMS,Clam
Agrolatina,24A1422433,01/27/2025,Entry,80.0,1200.0,0,CANDY SNAP,Clam
Agrolatina,24A1422433,01/27/2025,Entry,400.0,1600.0,0,CANDY SNAP,Clam
Agrolatina,24A1422433,02/01/2025,Sale,-400.0,1200.0,5,CANDY DREAMS,Clam
Agrolatina,24A1422433,02/01/2025,Sale,-240.0,960.0,5,CANDY DREAMS,Clam
Agrolatina,24A1422433,02/01/2025,Sale,-80.0,880.0,5,CANDY SNAP,Clam
Agrolatina,24A1422433,02/03/2025,Sale,-80.0,800.0,7,ALLISON,Clam
Agrolatina,24A1422433,02/03/2025,Sale,-160.0,640.0,7,CANDY SNAP,Clam
Agrolatina,24A1422433,02/04/2025,Sale,-80.0,560.0,8,ALLISON,Clam
Agrolatina,24A1422433,02/05/2025,Sale,-160.0,400.0,9,CANDY SNAP,Clam
Agrolatina,24A1422433,02/10/2025,Sale,-80.0,320.0,14,ALLISON,Clam
Agrolatina,24A1422433,02/11/2025,Sale,-160.0,160.0,15,ALLISON,Clam
Agrolatina,24A1422433,02/12/2025,Sale,-80.0,80.0,16,ALLISON,Clam
Agrolatina,24A1422433,02/19/2025,Sale,-76.0,4.0,23,CANDY SNAP,Clam
Agrolatina,24A1423023,03/04/2025,Entry,1120.0,1120.0,0,IVORY,Clam
Agrolatina,24A1423023,03/04/2025,Entry,160.0,1280.0,0,IVORY,Clam
Agrolatina,24A1423023,03/04/2025,Entry,320.0,1600.0,0,IVORY,Clam
Agrolatina,24A1423023,03/11/2025,Sale,-160.0,1440.0,7,IVORY,Clam
Agrolatina,24A1423023,03/12/2025,Sale,-80.0,1360.0,8,IVORY,Clam
Agrolatina,24A1423023,03/22/2025,Sale,-60.0,1300.0,18,IVORY,Clam
Agrolatina,24A1423023,03/22/2025,Sale,-160.0,1140.0,18,IVORY,Clam
Agrolatina,24A1423023,03/22/2025,Sale,-80.0,1060.0,18,IVORY,Clam
Agrolatina,24A1423023,03/24/2025,Sale,-80.0,980.0,20,IVORY,Clam
Agrolatina,24A1423023,03/25/2025,Sale,-10.0,970.0,21,IVORY,Clam
Agrolatina,24A1423023,03/25/2025,Sale,-40.0,930.0,21,IVORY,Clam
Agrolatina,24A1423023,03/26/2025,Sale,-320.0,610.0,22,IVORY,Clam
Agrolatina,24A1423023,03/27/2025,Sale,-80.0,530.0,23,IVORY,Clam
Agrolatina,24A1423023,03/28/2025,Sale,-40.0,490.0,24,IVORY,Clam
Agrolatina,24A1423023,04/01/2025,Sale,-40.0,450.0,28,IVORY,Clam
Agrolatina,24A1423023,04/08/2025,Sale,-80.0,370.0,35,IVORY,Clam
Agrolatina,24A1429269,02/10/2025,Entry,1040.0,1040.0,0,TIMCO,Clam
Agrolatina,24A1429269,02/10/2025,Entry,560.0,1600.0,0,TIMCO,Clam
Agrolatina,24A1429269,03/05/2025,Sale,-160.0,1440.0,23,TIMCO,Clam
Agrolatina,24A1429269,03/06/2025,Sale,-480.0,960.0,24,TIMCO,Clam
Agrolatina,24A1429269,03/07/2025,Sale,-880.0,80.0,25,TIMCO,Clam
Agrolatina,24A1429269,03/09/2025,Sale,-80.0,0.0,27,TIMCO,Clam
Agrolatina,24A1429632,12/26/2024,Entry,1360.0,1360.0,0,CANDY SNAP,Clam
Agrolatina,24A1429632,12/26/2024,Entry,240.0,1600.0,0,CANDY SNAP,Clam
Agrolatina,24A1429632,01/02/2025,Sale,-1120.0,480.0,7,CANDY SNAP,Clam
Agrolatina,24A1429632,01/02/2025,Sale,-160.0,320.0,7,CANDY SNAP,Clam
Agrolatina,24A1429632,01/03/2025,Sale,-240.0,80.0,8,CANDY SNAP,Clam
Agrolatina,24A1429632,01/03/2025,Sale,-80.0,0.0,8,CANDY SNAP,Clam
Agrolatina,24A1430439,01/03/2025,Entry,1200.0,1200.0,0,SWEET GLOBE,Clam
Agrolatina,24A1430439,01/03/2025,Entry,160.0,1360.0,0,SWEET GLOBE,Clam
Agrolatina,24A1430439,01/03/2025,Entry,240.0,1600.0,0,SWEET GLOBE,Clam
Agrolatina,24A1430439,01/15/2025,Sale,-160.0,1440.0,12,SWEET GLOBE,Clam
Agrolatina,24A1430439,01/16/2025,Sale,-1040.0,400.0,13,SWEET GLOBE,Clam
Agrolatina,24A1430439,01/17/2025,Sale,-160.0,240.0,14,SWEET GLOBE,Clam
Agrolatina,24A1430439,01/21/2025,Sale,-80.0,160.0,18,SWEET GLOBE,Clam
Agrolatina,24A1430439,01/29/2025,Sale,-80.0,80.0,26,SWEET GLOBE,Clam
Agrolatina,24A1430439,02/21/2025,Sale,-80.0,0.0,49,SWEET GLOBE,Clam
Agrolatina,24A1433546,02/11/2025,Entry,800.0,800.0,0,SWEET GLOBE,Clam
Agrolatina,24A1433546,02/11/2025,Entry,800.0,1600.0,0,SWEET GLOBE,Clam
Agrolatina,24A1433546,02/19/2025,Sale,-160.0,1440.0,8,SWEET GLOBE,Clam
Agrolatina,24A1433546,02/19/2025,Sale,-80.0,1360.0,8,SWEET GLOBE,Clam
Agrolatina,24A1433546,02/20/2025,Sale,-160.0,1200.0,9,SWEET GLOBE,Clam
Agrolatina,24A1433546,02/24/2025,Sale,-320.0,880.0,13,SWEET GLOBE,Clam
Agrolatina,24A1433546,02/24/2025,Sale,-80.0,800.0,13,SWEET GLOBE,Clam
Agrolatina,24A1433546,02/28/2025,Sale,-40.0,760.0,17,SWEET GLOBE,Clam
Agrolatina,24A1433546,03/01/2025,Sale,-80.0,680.0,18,SWEET GLOBE,Clam
Agrolatina,24A1433546,03/01/2025,Sale,-160.0,520.0,18,SWEET GLOBE,Clam
Agrolatina,24A1433546,03/03/2025,Sale,-320.0,200.0,20,SWEET GLOBE,Clam
Agrolatina,24A1433546,03/03/2025,Sale,-160.0,40.0,20,SWEET GLOBE,Clam
Agrolatina,24A1434455,01/03/2025,Entry,1280.0,1280.0,0,SWEET GLOBE,Clam
Agrolatina,24A1434455,01/03/2025,Entry,80.0,1360.0,0,SWEET GLOBE,Clam
Agrolatina,24A1434455,01/03/2025,Entry,240.0,1600.0,0,SWEET GLOBE,Clam
Agrolatina,24A1434455,01/13/2025,Sale,-1280.0,320.0,10,SWEET GLOBE,Clam
Agrolatina,24A1434455,01/14/2025,Sale,-240.0,80.0,11,SWEET GLOBE,Clam
Agrolatina,24A1434455,01/15/2025,Sale,-80.0,0.0,12,SWEET GLOBE,Clam
Agrolatina,24A1434706,02/06/2025,Entry,240.0,240.0,0,SWEET GLOBE,Clam
Agrolatina,24A1434706,02/06/2025,Entry,1360.0,1600.0,0,SWEET GLOBE,Clam
Agrolatina,24A1434706,02/10/2025,Sale,-80.0,1520.0,4,SWEET GLOBE,Clam
Agrolatina,24A1434706,02/14/2025,Sale,-80.0,1440.0,8,SWEET GLOBE,Clam
Agrolatina,24A1434706,02/18/2025,Sale,-320.0,1120.0,12,SWEET GLOBE,Clam
Agrolatina,24A1434706,02/18/2025,Sale,-160.0,960.0,12,SWEET GLOBE,Clam
Agrolatina,24A1434706,02/27/2025,Sale,-140.0,820.0,21,SWEET GLOBE,Clam
Agrolatina,24A1434706,02/28/2025,Sale,-40.0,780.0,22,SWEET GLOBE,Clam
Agrolatina,24A1434706,03/01/2025,Sale,-200.0,580.0,23,SWEET GLOBE,Clam
Agrolatina,24A1434706,03/04/2025,Sale,-40.0,540.0,26,SWEET GLOBE,Clam
Agrolatina,24A1434706,03/05/2025,Sale,-120.0,420.0,27,SWEET GLOBE,Clam
Agrolatina,24A1434706,03/05/2025,Sale,-50.0,370.0,27,SWEET GLOBE,Clam
Agrolatina,24A1435255,01/02/2025,Entry,960.0,960.0,0,ALLISON,Clam
Agrolatina,24A1435255,01/02/2025,Entry,640.0,1600.0,0,ALLISON,Clam
Agrolatina,24A1435255,01/14/2025,Sale,-160.0,1440.0,12,ALLISON,Clam
Agrolatina,24A1435255,01/14/2025,Sale,-560.0,880.0,12,ALLISON,Clam
Agrolatina,24A1435255,01/14/2025,Sale,-320.0,560.0,12,ALLISON,Clam
Agrolatina,24A1435255,01/16/2025,Sale,-160.0,400.0,14,ALLISON,Clam
Agrolatina,24A1435255,01/16/2025,Sale,-80.0,320.0,14,ALLISON,Clam
Agrolatina,24A1435255,01/17/2025,Sale,-320.0,0.0,15,ALLISON,Clam
Agrolatina,24A1453434,03/04/2025,Entry,1120.0,1120.0,0,IVORY,Clam
Agrolatina,24A1453434,03/04/2025,Entry,480.0,1600.0,0,IVORY,Clam
Agrolatina,24A1453434,03/11/2025,Sale,-160.0,1440.0,7,IVORY,Clam
Agrolatina,24A1453434,03/12/2025,Sale,-160.0,1280.0,8,IVORY,Clam
Agrolatina,24A1453434,03/22/2025,Sale,-100.0,1180.0,18,IVORY,Clam
Agrolatina,24A1453434,03/22/2025,Sale,-240.0,940.0,18,IVORY,Clam
Agrolatina,24A1453434,03/24/2025,Sale,-80.0,860.0,20,IVORY,Clam
Agrolatina,24A1453434,03/25/2025,Sale,-40.0,820.0,21,IVORY,Clam
Agrolatina,24A1453434,03/27/2025,Sale,-80.0,740.0,23,IVORY,Clam
Agrolatina,24A1453434,03/27/2025,Sale,-192.0,548.0,23,IVORY,Clam
Agrolatina,24A1453434,03/28/2025,Sale,-20.0,528.0,24,IVORY,Clam
Agrolatina,24A1453434,04/01/2025,Sale,-80.0,448.0,28,IVORY,Clam
Agrolatina,24A1453434,04/02/2025,Sale,-20.0,428.0,29,IVORY,Clam
Agrolatina,24A1453434,04/02/2025,Sale,-40.0,388.0,29,IVORY,Clam
Agrolatina,24A1462400,03/04/2025,Entry,1200.0,1200.0,0,IVORY,Clam
Agrolatina,24A1462400,03/04/2025,Entry,400.0,1600.0,0,IVORY,Clam
Agrolatina,24A1462400,03/12/2025,Sale,-80.0,1520.0,8,IVORY,Clam
Agrolatina,24A1462400,03/21/2025,Sale,-160.0,1360.0,17,IVORY,Clam
Agrolatina,24A1462400,03/22/2025,Sale,-40.0,1320.0,18,IVORY,Clam
Agrolatina,24A1462400,03/22/2025,Sale,-60.0,1260.0,18,IVORY,Clam
Agrolatina,24A1462400,03/28/2025,Sale,-20.0,1240.0,24,IVORY,Clam
Agrolatina,24A1462400,03/31/2025,Sale,-80.0,1160.0,27,IVORY,Clam
Agrolatina,24A1462400,04/01/2025,Sale,-80.0,1080.0,28,IVORY,Clam
Agrolatina,24A1462400,04/01/2025,Sale,-80.0,1000.0,28,IVORY,Clam
Agrolatina,24A1462400,04/02/2025,Sale,-80.0,920.0,29,IVORY,Clam
Agrolatina,24A1462400,04/02/2025,Sale,-120.0,800.0,29,IVORY,Clam
Agrolatina,24A1462400,04/03/2025,Sale,-236.0,564.0,30,IVORY,Clam
Agrolatina,24A1462400,04/04/2025,Sale,-139.0,425.0,31,IVORY,Clam
Agrolatina,24A1462400,04/08/2025,Sale,-40.0,385.0,35,IVORY,Clam
Agrolatina,24A1464399,02/17/2025,Entry,1360.0,1360.0,0,IVORY,Clam
Agrolatina,24A1464399,02/17/2025,Entry,80.0,1440.0,0,IVORY,Clam
Agrolatina,24A1464399,02/17/2025,Entry,160.0,1600.0,0,IVORY,Clam
Agrolatina,24A1464399,03/11/2025,Sale,-80.0,1520.0,22,IVORY,Clam
Agrolatina,24A1464399,03/15/2025,Sale,-160.0,1360.0,26,IVORY,Clam
Agrolatina,24A1464399,03/21/2025,Sale,-159.0,1201.0,32,IVORY,Clam
Agrolatina,24A1464399,03/21/2025,Sale,-80.0,1121.0,32,IVORY,Clam
Agrolatina,24A1464399,03/22/2025,Sale,-80.0,1041.0,33,IVORY,Clam
Agrolatina,24A1464399,03/22/2025,Sale,-60.0,981.0,33,IVORY,Clam
Agrolatina,24A1464399,03/22/2025,Sale,-458.0,523.0,33,IVORY,Clam
Agrolatina,24A1464399,03/28/2025,Sale,-120.0,403.0,39,IVORY,Clam
Agrolatina,24A1473132,03/07/2025,Entry,1440.0,1440.0,0,TIMCO,Clam
Agrolatina,24A1473132,03/07/2025,Entry,160.0,1600.0,0,TIMCO,Clam
Agrolatina,24A1473132,04/03/2025,Sale,-160.0,1440.0,27,TIMCO,Clam
Agrolatina,24A1473132,04/06/2025,Sale,-1440.0,0.0,30,TIMCO,Clam
Agrolatina,24A1473976,01/13/2025,Entry,1200.0,1200.0,0,CANDY SNAP,Clam
Agrolatina,24A1473976,01/13/2025,Entry,400.0,1600.0,0,CANDY SNAP,Clam
Agrolatina,24A1473976,02/06/2025,Sale,-240.0,1360.0,24,CANDY SNAP,Clam
Agrolatina,24A1473976,02/17/2025,Sale,-80.0,1280.0,35,CANDY SNAP,Clam
Agrolatina,24A1473976,02/17/2025,Sale,-400.0,880.0,35,CANDY SNAP,Clam
Agrolatina,24A1473976,02/27/2025,Sale,-410.0,470.0,45,CANDY SNAP,Clam
Agrolatina,24A1473976,02/28/2025,Sale,-65.0,405.0,46,CANDY SNAP,Clam
Agrolatina,24A1473976,03/01/2025,Sale,-80.0,325.0,47,CANDY SNAP,Clam
Agrolatina,24A1473976,03/03/2025,Sale,-80.0,245.0,49,CANDY SNAP,Clam
Agrolatina,24A1473976,03/04/2025,Sale,-40.0,205.0,50,CANDY SNAP,Clam
Agrolatina,24A1473976,03/31/2025,Sale,-60.0,145.0,77,CANDY SNAP,Clam
Agrolatina,24A1476764,01/18/2025,Entry,1360.0,1360.0,0,ALLISON,Clam
Agrolatina,24A1476764,01/18/2025,Entry,240.0,1600.0,0,ALLISON,Clam
Agrolatina,24A1476764,01/30/2025,Sale,-160.0,1440.0,12,ALLISON,Clam
Agrolatina,24A1476764,02/01/2025,Sale,-160.0,1280.0,14,ALLISON,Clam
Agrolatina,24A1476764,02/04/2025,Sale,-400.0,880.0,17,ALLISON,Clam
Agrolatina,24A1476764,02/05/2025,Sale,-320.0,560.0,18,ALLISON,Clam
Agrolatina,24A1476764,02/05/2025,Sale,-80.0,480.0,18,ALLISON,Clam
Agrolatina,24A1476764,02/06/2025,Sale,-80.0,400.0,19,ALLISON,Clam
Agrolatina,24A1476764,02/07/2025,Sale,-320.0,80.0,20,ALLISON,Clam
Agrolatina,24A1476764,02/10/2025,Sale,-80.0,0.0,23,ALLISON,Clam
Agrolatina,24A1561038,03/07/2025,Entry,560.0,560.0,0,AUTUMN CRISP,Clam
Agrolatina,24A1561038,03/07/2025,Entry,1040.0,1600.0,0,AUTUMN CRISP,Clam
Agrolatina,24A1561038,03/26/2025,Sale,-400.0,1200.0,19,AUTUMN CRISP,Clam
Agrolatina,24A1561038,03/26/2025,Sale,-1040.0,160.0,19,AUTUMN CRISP,Clam
Agrolatina,24A1561038,03/31/2025,Sale,-160.0,0.0,24,AUTUMN CRISP,Clam
Agrolatina,24A1569208,03/10/2025,Entry,1520.0,1520.0,0,TIMCO,Clam
Agrolatina,24A1569208,03/10/2025,Entry,80.0,1600.0,0,TIMCO,Clam
Agrolatina,24A1569208,03/22/2025,Sale,-80.0,1520.0,12,TIMCO,Clam
Agrolatina,24A1569208,04/03/2025,Sale,-80.0,1440.0,24,TIMCO,Clam
Agrolatina,24A1569208,04/07/2025,Sale,-80.0,1360.0,28,TIMCO,Clam
Agrolatina,24A1569208,04/07/2025,Sale,-80.0,1280.0,28,TIMCO,Clam
Agrolatina,24A1569208,04/11/2025,Sale,-80.0,1200.0,32,TIMCO,Clam
Agrolatina,24A1569208,04/13/2025,Sale,-1200.0,0.0,34,TIMCO,Clam
Agrolatina,24A1569661,01/13/2025,Entry,1600.0,1600.0,0,SWEET GLOBE,Clam
Agrolatina,24A1569661,01/31/2025,Sale,-640.0,960.0,18,SWEET GLOBE,Clam
Agrolatina,24A1569661,01/31/2025,Sale,-160.0,800.0,18,SWEET GLOBE,Clam
Agrolatina,24A1569661,01/31/2025,Sale,-80.0,720.0,18,SWEET GLOBE,Clam
Agrolatina,24A1569661,02/01/2025,Sale,-720.0,0.0,19,SWEET GLOBE,Clam
Agrolatina,24A1583227,01/21/2025,Entry,1440.0,1440.0,0,ALLISON,Clam
Agrolatina,24A1583227,01/21/2025,Entry,160.0,1600.0,0,ALLISON,Clam
Agrolatina,24A1583227,01/28/2025,Sale,-160.0,1440.0,7,ALLISON,Clam
Agrolatina,24A1583227,02/01/2025,Sale,-80.0,1360.0,11,ALLISON,Clam
Agrolatina,24A1583227,02/03/2025,Sale,-160.0,1200.0,13,ALLISON,Clam
Agrolatina,24A1583227,02/04/2025,Sale,-160.0,1040.0,14,ALLISON,Clam
Agrolatina,24A1583227,02/05/2025,Sale,-80.0,960.0,15,ALLISON,Clam
Agrolatina,24A1583227,02/05/2025,Sale,-80.0,880.0,15,ALLISON,Clam
Agrolatina,24A1583227,02/05/2025,Sale,-240.0,640.0,15,ALLISON,Clam
Agrolatina,24A1583227,02/05/2025,Sale,-160.0,480.0,15,ALLISON,Clam
Agrolatina,24A1583227,02/05/2025,Sale,-80.0,400.0,15,ALLISON,Clam
Agrolatina,24A1583227,02/08/2025,Sale,-240.0,160.0,18,ALLISON,Clam
Agrolatina,24A1583227,02/10/2025,Sale,-80.0,80.0,20,ALLISON,Clam
Agrolatina,24A1583227,02/10/2025,Sale,-80.0,0.0,20,ALLISON,Clam
Agrolatina,24A1593586,01/20/2025,Entry,480.0,480.0,0,AUTUMN CRISP,Clam
Agrolatina,24A1593586,01/20/2025,Entry,1120.0,1600.0,0,AUTUMN CRISP,Clam
Agrolatina,24A1593586,01/31/2025,Sale,-480.0,1120.0,11,AUTUMN CRISP,Clam
Agrolatina,24A1593586,02/01/2025,Sale,-1120.0,0.0,12,AUTUMN CRISP,Clam
Agrolatina,24A1600522,01/13/2025,Entry,1440.0,1440.0,0,SWEET GLOBE,Clam
Agrolatina,24A1600522,01/13/2025,Entry,80.0,1520.0,0,SWEET GLOBE,Clam
Agrolatina,24A1600522,01/13/2025,Entry,80.0,1600.0,0,SWEET GLOBE,Clam
Agrolatina,24A1600522,01/16/2025,Sale,-1440.0,160.0,3,SWEET GLOBE,Clam
Agrolatina,24A1600522,01/16/2025,Sale,-80.0,80.0,3,SWEET GLOBE,Clam
Agrolatina,24A1600522,01/23/2025,Sale,-80.0,0.0,10,SWEET GLOBE,Clam
Agrolatina,24A1600841,02/12/2025,Entry,1235.0,1235.0,0,SWEET GLOBE,Bag
Agrolatina,24A1600841,02/12/2025,Entry,665.0,1900.0,0,SWEET GLOBE,Bag
Agrolatina,24A1600841,02/18/2025,Sale,-570.0,1330.0,6,SWEET GLOBE,Bag
Agrolatina,24A1600841,02/24/2025,Sale,-95.0,1235.0,12,SWEET GLOBE,Bag
Agrolatina,24A1600841,02/25/2025,Sale,-665.0,570.0,13,SWEET GLOBE,Bag
Agrolatina,24A1600841,03/03/2025,Sale,-95.0,475.0,19,SWEET GLOBE,Bag
Agrolatina,24A1600841,03/11/2025,Sale,-380.0,95.0,27,SWEET GLOBE,Bag
Agrolatina,24A1600841,03/18/2025,Sale,-20.0,75.0,34,SWEET GLOBE,Bag
Agrolatina,24A1600841,03/18/2025,Sale,-75.0,0.0,34,SWEET GLOBE,Bag
Agrolatina,24A1600986,03/03/2025,Entry,400.0,400.0,0,AUTUMN CRISP,Clam
Agrolatina,24A1600986,03/03/2025,Entry,1200.0,1600.0,0,AUTUMN CRISP,Clam
Agrolatina,24A1600986,03/08/2025,Sale,-400.0,1200.0,5,AUTUMN CRISP,Clam
Agrolatina,24A1600986,03/25/2025,Sale,-80.0,1120.0,22,AUTUMN CRISP,Clam
Agrolatina,24A1600986,03/26/2025,Sale,-480.0,640.0,23,AUTUMN CRISP,Clam
Agrolatina,24A1600986,03/26/2025,Sale,-160.0,480.0,23,AUTUMN CRISP,Clam
Agrolatina,24A1600986,03/27/2025,Sale,-480.0,0.0,24,AUTUMN CRISP,Clam
Agrolatina,24A1601030,01/13/2025,Entry,1360.0,1360.0,0,CANDY SNAP,Clam
Agrolatina,24A1601030,01/13/2025,Entry,240.0,1600.0,0,CANDY SNAP,Clam
Agrolatina,24A1601030,01/21/2025,Sale,-240.0,1360.0,8,CANDY SNAP,Clam
Agrolatina,24A1601030,01/23/2025,Sale,-640.0,720.0,10,CANDY SNAP,Clam
Agrolatina,24A1601030,01/23/2025,Sale,-720.0,0.0,10,CANDY SNAP,Clam
Agrolatina,24A1601175,03/10/2025,Entry,1520.0,1520.0,0,TIMCO,Clam
Agrolatina,24A1601175,03/10/2025,Entry,80.0,1600.0,0,TIMCO,Clam
Agrolatina,24A1601175,04/03/2025,Sale,-80.0,1520.0,24,TIMCO,Clam
Agrolatina,24A1601175,04/11/2025,Sale,-800.0,720.0,32,TIMCO,Clam
Agrolatina,24A1601175,04/13/2025,Sale,-720.0,0.0,34,TIMCO,Clam
Agrolatina,24A1601180,02/10/2025,Entry,1040.0,1040.0,0,ALLISON,Clam
Agrolatina,24A1601180,02/10/2025,Entry,560.0,1600.0,0,ALLISON,Clam
Agrolatina,24A1601180,02/22/2025,Sale,-880.0,720.0,12,ALLISON,Clam
Agrolatina,24A1601180,03/01/2025,Sale,-560.0,160.0,19,ALLISON,Clam
Agrolatina,24A1601180,03/04/2025,Sale,-160.0,0.0,22,ALLISON,Clam
Agrolatina,24A1601220,02/12/2025,Entry,160.0,160.0,0,AUTUMN CRISP,Clam
Agrolatina,24A1601220,02/12/2025,Entry,800.0,960.0,0,AUTUMN CRISP,Clam
Agrolatina,24A1601220,02/12/2025,Entry,640.0,1600.0,0,AUTUMN CRISP,Clam
Agrolatina,24A1601220,03/03/2025,Sale,-640.0,960.0,19,AUTUMN CRISP,Clam
Agrolatina,24A1601220,03/08/2025,Sale,-160.0,800.0,24,AUTUMN CRISP,Clam
Agrolatina,24A1601220,03/08/2025,Sale,-800.0,0.0,24,AUTUMN CRISP,Clam
Agrolatina,24A1601323,12/30/2024,Entry,800.0,800.0,0,ALLISON,Clam
Agrolatina,24A1601323,12/30/2024,Entry,800.0,1600.0,0,ALLISON,Clam
Agrolatina,24A1601323,01/08/2025,Sale,-160.0,1440.0,9,ALLISON,Clam
Agrolatina,24A1601323,01/13/2025,Sale,-320.0,1120.0,14,ALLISON,Clam
Agrolatina,24A1601323,01/13/2025,Sale,-560.0,560.0,14,ALLISON,Clam
Agrolatina,24A1601323,01/14/2025,Sale,-480.0,80.0,15,ALLISON,Clam
Agrolatina,24A1601323,02/06/2025,Sale,-80.0,0.0,38,ALLISON,Clam
Agrolatina,24A1601513,03/03/2025,Entry,1520.0,1520.0,0,TIMCO,Clam
Agrolatina,24A1601513,03/03/2025,Entry,80.0,1600.0,0,TIMCO,Clam
Agrolatina,24A1601513,04/07/2025,Sale,-480.0,1120.0,35,TIMCO,Clam
Agrolatina,24A1601513,04/08/2025,Sale,-880.0,240.0,36,TIMCO,Clam
Agrolatina,24A1601513,04/12/2025,Sale,-160.0,80.0,40,TIMCO,Clam
Agrolatina,24A1601513,04/16/2025,Sale,-80.0,0.0,44,TIMCO,Clam
Agrolatina,24A1601534,02/17/2025,Entry,320.0,320.0,0,AUTUMN CRISP,Clam
Agrolatina,24A1601534,02/17/2025,Entry,1280.0,1600.0,0,AUTUMN CRISP,Clam
Agrolatina,24A1601534,02/22/2025,Sale,-960.0,640.0,5,AUTUMN CRISP,Clam
Agrolatina,24A1601534,03/04/2025,Sale,-320.0,320.0,15,AUTUMN CRISP,Clam
Agrolatina,24A1601534,03/06/2025,Sale,-320.0,0.0,17,AUTUMN CRISP,Clam
Agrolatina,24A1601642,02/12/2025,Entry,1200.0,1200.0,0,COTTON CANDY,Clam
Agrolatina,24A1601642,02/12/2025,Entry,400.0,1600.0,0,COTTON CANDY,Clam
Agrolatina,24A1601642,02/22/2025,Sale,-1200.0,400.0,10,COTTON CANDY,Clam
Agrolatina,24A1601642,02/22/2025,Sale,-400.0,0.0,10,COTTON CANDY,Clam
Agrolatina,24A1601730,03/03/2025,Entry,480.0,480.0,0,AUTUMN CRISP,Clam
Agrolatina,24A1601730,03/03/2025,Entry,1120.0,1600.0,0,AUTUMN CRISP,Clam
Agrolatina,24A1601730,03/21/2025,Sale,-640.0,960.0,18,AUTUMN CRISP,Clam
Agrolatina,24A1601730,03/27/2025,Sale,-480.0,480.0,24,AUTUMN CRISP,Clam
Agrolatina,24A1601730,03/27/2025,Sale,-480.0,0.0,24,AUTUMN CRISP,Clam
Agrolatina,24A1601766,02/10/2025,Entry,960.0,960.0,0,TIMCO,Clam
Agrolatina,24A1601766,02/10/2025,Entry,160.0,1120.0,0,TIMCO,Clam
Agrolatina,24A1601766,02/10/2025,Entry,480.0,1600.0,0,TIMCO,Clam
Agrolatina,24A1601766,03/08/2025,Sale,-960.0,640.0,26,TIMCO,Clam
Agrolatina,24A1601766,03/14/2025,Sale,-160.0,480.0,32,TIMCO,Clam
Agrolatina,24A1601766,03/17/2025,Sale,-480.0,0.0,35,TIMCO,Clam
Agrolatina,24A1601771,01/13/2025,Entry,1360.0,1360.0,0,IVORY,Clam
Agrolatina,24A1601771,01/13/2025,Entry,80.0,1440.0,0,IVORY,Clam
Agrolatina,24A1601771,01/13/2025,Entry,160.0,1600.0,0,IVORY,Clam
Agrolatina,24A1601771,01/18/2025,Sale,-1360.0,240.0,5,IVORY,Clam
Agrolatina,24A1601771,01/18/2025,Sale,-80.0,160.0,5,IVORY,Clam
Agrolatina,24A1601771,01/20/2025,Sale,-80.0,80.0,7,IVORY,Clam
Agrolatina,24A1601771,01/23/2025,Sale,-80.0,0.0,10,IVORY,Clam
Agrolatina,24A1601874,12/29/2024,Entry,1040.0,1040.0,0,IVORY,Clam
Agrolatina,24A1601874,12/29/2024,Entry,560.0,1600.0,0,IVORY,Clam
Agrolatina,24A1601874,01/09/2025,Sale,-1040.0,560.0,11,IVORY,Clam
Agrolatina,24A1601874,01/09/2025,Sale,-560.0,0.0,11,IVORY,Clam
Agrolatina,24A1602187,02/24/2025,Entry,80.0,80.0,0,AUTUMN CRISP,Clam
Agrolatina,24A1602187,02/24/2025,Entry,1520.0,1600.0,0,AUTUMN CRISP,Clam
Agrolatina,24A1602187,03/06/2025,Sale,-80.0,1520.0,10,AUTUMN CRISP,Clam
Agrolatina,24A1602187,03/17/2025,Sale,-960.0,560.0,21,AUTUMN CRISP,Clam
Agrolatina,24A1602187,03/24/2025,Sale,-560.0,0.0,28,AUTUMN CRISP,Clam
Agrolatina,24A1602968,02/17/2025,Entry,960.0,960.0,0,AUTUMN CRISP,Clam
Agrolatina,24A1602968,02/17/2025,Entry,640.0,1600.0,0,AUTUMN CRISP,Clam
Agrolatina,24A1602968,03/04/2025,Sale,-640.0,960.0,15,AUTUMN CRISP,Clam
Agrolatina,24A1602968,03/06/2025,Sale,-960.0,0.0,17,AUTUMN CRISP,Clam
Agrolatina,24A3003901,02/13/2025,Entry,960.0,960.0,0,SWEET GLOBE,Clam
Agrolatina,24A3003901,02/13/2025,Entry,640.0,1600.0,0,SWEET GLOBE,Clam
Agrolatina,24A3003901,02/20/2025,Sale,-160.0,1440.0,7,SWEET GLOBE,Clam
Agrolatina,24A3003901,02/21/2025,Sale,-80.0,1360.0,8,SWEET GLOBE,Clam
Agrolatina,24A3003901,02/21/2025,Sale,-240.0,1120.0,8,SWEET GLOBE,Clam
Agrolatina,24A3003901,02/22/2025,Sale,-80.0,1040.0,9,SWEET GLOBE,Clam
Agrolatina,24A3003901,02/22/2025,Sale,-80.0,960.0,9,SWEET GLOBE,Clam
Agrolatina,24A3003901,02/22/2025,Sale,-80.0,880.0,9,SWEET GLOBE,Clam
Agrolatina,24A3003901,02/24/2025,Sale,-160.0,720.0,11,SWEET GLOBE,Clam
Agrolatina,24A3003901,02/25/2025,Sale,-80.0,640.0,12,SWEET GLOBE,Clam
Agrolatina,24A3003901,02/26/2025,Sale,-80.0,560.0,13,SWEET GLOBE,Clam
Agrolatina,24A3003901,02/27/2025,Sale,-80.0,480.0,14,SWEET GLOBE,Clam
Agrolatina,24A3003901,02/28/2025,Sale,-40.0,440.0,15,SWEET GLOBE,Clam
Agrolatina,24A3003901,03/04/2025,Sale,-40.0,400.0,19,SWEET GLOBE,Clam
Agrolatina,24A3003901,03/05/2025,Sale,-80.0,320.0,20,SWEET GLOBE,Clam
Agrolatina,24A3003901,03/15/2025,Sale,-40.0,280.0,30,SWEET GLOBE,Clam
Agrolatina,24A3017973,01/11/2025,Entry,1360.0,1360.0,0,SWEET GLOBE,Clam
Agrolatina,24A3017973,01/11/2025,Entry,240.0,1600.0,0,SWEET GLOBE,Clam
Agrolatina,24A3017973,02/26/2025,Sale,-560.0,1040.0,46,SWEET GLOBE,Clam
Agrolatina,24A3017973,02/26/2025,Sale,-240.0,800.0,46,SWEET GLOBE,Clam
Agrolatina,24A3017973,02/27/2025,Sale,-240.0,560.0,47,SWEET GLOBE,Clam
Agrolatina,24A3017973,03/01/2025,Sale,-240.0,320.0,49,SWEET GLOBE,Clam
Agrolatina,24A3017973,03/11/2025,Sale,-320.0,0.0,59,SWEET GLOBE,Clam
Agrolatina,24A3025095,02/20/2025,Entry,1120.0,1120.0,0,COTTON CANDY,Clam
Agrolatina,24A3025095,02/20/2025,Entry,480.0,1600.0,0,COTTON CANDY,Clam
Agrolatina,24A3025095,03/11/2025,Sale,-80.0,1520.0,19,COTTON CANDY,Clam
Agrolatina,24A3025095,03/25/2025,Sale,-80.0,1440.0,33,COTTON CANDY,Clam
Agrolatina,24A3025095,03/28/2025,Sale,-300.0,1140.0,36,COTTON CANDY,Clam
Agrolatina,24A3025095,03/29/2025,Sale,-160.0,980.0,37,COTTON CANDY,Clam
Agrolatina,24A3025095,04/02/2025,Sale,-40.0,940.0,41,COTTON CANDY,Clam
Agrolatina,24A3025095,04/10/2025,Sale,-160.0,780.0,49,COTTON CANDY,Clam
Agrolatina,24A3031694,02/13/2025,Entry,1120.0,1120.0,0,SWEET GLOBE,Clam
Agrolatina,24A3031694,02/13/2025,Entry,480.0,1600.0,0,SWEET GLOBE,Clam
Agrolatina,24A3031694,02/19/2025,Sale,-160.0,1440.0,6,SWEET GLOBE,Clam
Agrolatina,24A3031694,02/19/2025,Sale,-160.0,1280.0,6,SWEET GLOBE,Clam
Agrolatina,24A3031694,02/20/2025,Sale,-320.0,960.0,7,SWEET GLOBE,Clam
Agrolatina,24A3031694,02/21/2025,Sale,-80.0,880.0,8,SWEET GLOBE,Clam
Agrolatina,24A3031694,02/25/2025,Sale,-120.0,760.0,12,SWEET GLOBE,Clam
Agrolatina,24A3031694,02/26/2025,Sale,-240.0,520.0,13,SWEET GLOBE,Clam
Agrolatina,24A3031694,02/27/2025,Sale,-20.0,500.0,14,SWEET GLOBE,Clam
Agrolatina,24A3031694,02/27/2025,Sale,-40.0,460.0,14,SWEET GLOBE,Clam
Agrolatina,24A3031694,03/03/2025,Sale,-320.0,140.0,18,SWEET GLOBE,Clam
Agrolatina,24A3031694,03/03/2025,Sale,-80.0,60.0,18,SWEET GLOBE,Clam
Agrolatina,24A3037497,01/16/2025,Entry,1440.0,1440.0,0,ALLISON,Clam
Agrolatina,24A3037497,01/16/2025,Entry,160.0,1600.0,0,ALLISON,Clam
Agrolatina,24A3037497,01/30/2025,Sale,-80.0,1520.0,14,ALLISON,Clam
Agrolatina,24A3037497,02/04/2025,Sale,-160.0,1360.0,19,ALLISON,Clam
Agrolatina,24A3037497,02/04/2025,Sale,-240.0,1120.0,19,ALLISON,Clam
Agrolatina,24A3037497,02/05/2025,Sale,-80.0,1040.0,20,ALLISON,Clam
Agrolatina,24A3037497,02/05/2025,Sale,-80.0,960.0,20,ALLISON,Clam
Agrolatina,24A3037497,02/05/2025,Sale,-400.0,560.0,20,ALLISON,Clam
Agrolatina,24A3037497,02/07/2025,Sale,-240.0,320.0,22,ALLISON,Clam
Agrolatina,24A3037497,02/10/2025,Sale,-240.0,80.0,25,ALLISON,Clam
Agrolatina,24A3037497,02/13/2025,Sale,-80.0,0.0,28,ALLISON,Clam
Agrolatina,24A3046539,01/16/2025,Entry,1280.0,1280.0,0,ALLISON,Clam
Agrolatina,24A3046539,01/16/2025,Entry,320.0,1600.0,0,ALLISON,Clam
Agrolatina,24A3046539,02/03/2025,Sale,-160.0,1440.0,18,ALLISON,Clam
Agrolatina,24A3046539,02/04/2025,Sale,-80.0,1360.0,19,ALLISON,Clam
Agrolatina,24A3046539,02/04/2025,Sale,-80.0,1280.0,19,ALLISON,Clam
Agrolatina,24A3046539,02/05/2025,Sale,-240.0,1040.0,20,ALLISON,Clam
Agrolatina,24A3046539,02/07/2025,Sale,-80.0,960.0,22,ALLISON,Clam
Agrolatina,24A3046539,02/08/2025,Sale,-400.0,560.0,23,ALLISON,Clam
Agrolatina,24A3046539,02/10/2025,Sale,-480.0,80.0,25,ALLISON,Clam
Agrolatina,24A3046539,02/11/2025,Sale,-80.0,0.0,26,ALLISON,Clam
Agrolatina,24A3164110,01/16/2025,Entry,1440.0,1440.0,0,SWEET GLOBE,Clam
Agrolatina,24A3164110,01/16/2025,Entry,160.0,1600.0,0,SWEET GLOBE,Clam
Agrolatina,24A3164110,02/05/2025,Sale,-80.0,1520.0,20,SWEET GLOBE,Clam
Agrolatina,24A3164110,02/05/2025,Sale,-240.0,1280.0,20,SWEET GLOBE,Clam
Agrolatina,24A3164110,02/05/2025,Sale,-240.0,1040.0,20,SWEET GLOBE,Clam
Agrolatina,24A3164110,02/05/2025,Sale,-240.0,800.0,20,SWEET GLOBE,Clam
Agrolatina,24A3164110,02/06/2025,Sale,-320.0,480.0,21,SWEET GLOBE,Clam
Agrolatina,24A3164110,02/06/2025,Sale,-80.0,400.0,21,SWEET GLOBE,Clam
Agrolatina,24A3164110,02/06/2025,Sale,-240.0,160.0,21,SWEET GLOBE,Clam
Agrolatina,24A3164110,02/11/2025,Sale,-80.0,80.0,26,SWEET GLOBE,Clam
Agrolatina,24A3164110,02/12/2025,Sale,-80.0,0.0,27,SWEET GLOBE,Clam
Agrolatina,24A3185133,01/01/2025,Entry,1440.0,1440.0,0,SWEET GLOBE,Clam
Agrolatina,24A3185133,01/01/2025,Entry,160.0,1600.0,0,SWEET GLOBE,Clam
Agrolatina,24A3185133,01/24/2025,Sale,-1120.0,480.0,23,SWEET GLOBE,Clam
Agrolatina,24A3185133,01/25/2025,Sale,-160.0,320.0,24,SWEET GLOBE,Clam
Agrolatina,24A3185133,01/25/2025,Sale,-80.0,240.0,24,SWEET GLOBE,Clam
Agrolatina,24A3185133,01/27/2025,Sale,-160.0,80.0,26,SWEET GLOBE,Clam
Agrolatina,24A3185133,01/27/2025,Sale,-80.0,0.0,26,SWEET GLOBE,Clam
Agrolatina,24A3201635,03/03/2025,Entry,1360.0,1360.0,0,IVORY,Clam
Agrolatina,24A3201635,03/03/2025,Entry,240.0,1600.0,0,IVORY,Clam
Agrolatina,24A3201635,03/19/2025,Sale,-2.0,1598.0,16,IVORY,Clam
Agrolatina,24A3201635,03/21/2025,Sale,-60.0,1538.0,18,IVORY,Clam
Agrolatina,24A3201635,03/22/2025,Sale,-80.0,1458.0,19,IVORY,Clam
Agrolatina,24A3201635,03/25/2025,Sale,-80.0,1378.0,22,IVORY,Clam
Agrolatina,24A3201635,03/29/2025,Sale,-80.0,1298.0,26,IVORY,Clam
Agrolatina,24A3201635,04/01/2025,Sale,-80.0,1218.0,29,IVORY,Clam
Agrolatina,24A3201635,04/02/2025,Sale,-400.0,818.0,30,IVORY,Clam
Agrolatina,24A3201635,04/02/2025,Sale,-106.0,712.0,30,IVORY,Clam
Agrolatina,24A3201635,04/02/2025,Sale,-40.0,672.0,30,IVORY,Clam
Agrolatina,24A3201635,04/05/2025,Sale,-80.0,592.0,33,IVORY,Clam
Agrolatina,24A3203860,01/16/2025,Entry,1520.0,1520.0,0,ALLISON,Clam
Agrolatina,24A3203860,01/16/2025,Entry,80.0,1600.0,0,ALLISON,Clam
Agrolatina,24A3203860,02/03/2025,Sale,-80.0,1520.0,18,ALLISON,Clam
Agrolatina,24A3203860,02/03/2025,Sale,-80.0,1440.0,18,ALLISON,Clam
Agrolatina,24A3203860,02/04/2025,Sale,-80.0,1360.0,19,ALLISON,Clam
Agrolatina,24A3203860,02/05/2025,Sale,-80.0,1280.0,20,ALLISON,Clam
Agrolatina,24A3203860,02/10/2025,Sale,-480.0,800.0,25,ALLISON,Clam
Agrolatina,24A3203860,02/11/2025,Sale,-240.0,560.0,26,ALLISON,Clam
Agrolatina,24A3203860,02/12/2025,Sale,-80.0,480.0,27,ALLISON,Clam
Agrolatina,24A3203860,02/14/2025,Sale,-80.0,400.0,29,ALLISON,Clam
Agrolatina,24A3203860,02/24/2025,Sale,-80.0,320.0,39,ALLISON,Clam
Agrolatina,24A3203860,02/25/2025,Sale,-160.0,160.0,40,ALLISON,Clam
Agrolatina,24A3203860,03/14/2025,Sale,-110.0,50.0,57,ALLISON,Clam
Agrolatina,24A3214653,02/03/2025,Entry,1280.0,1280.0,0,SWEET GLOBE,Clam
Agrolatina,24A3214653,02/03/2025,Entry,320.0,1600.0,0,SWEET GLOBE,Clam
Agrolatina,24A3214653,02/06/2025,Sale,-80.0,1520.0,3,SWEET GLOBE,Clam
Agrolatina,24A3214653,02/10/2025,Sale,-320.0,1200.0,7,SWEET GLOBE,Clam
Agrolatina,24A3214653,02/11/2025,Sale,-160.0,1040.0,8,SWEET GLOBE,Clam
Agrolatina,24A3214653,02/17/2025,Sale,-160.0,880.0,14,SWEET GLOBE,Clam
Agrolatina,24A3214653,02/17/2025,Sale,-320.0,560.0,14,SWEET GLOBE,Clam
Agrolatina,24A3214653,02/18/2025,Sale,-80.0,480.0,15,SWEET GLOBE,Clam
Agrolatina,24A3214653,02/28/2025,Sale,-80.0,400.0,25,SWEET GLOBE,Clam
Agrolatina,24A3214653,03/01/2025,Sale,-40.0,360.0,26,SWEET GLOBE,Clam
Agrolatina,24A3214653,03/05/2025,Sale,-20.0,340.0,30,SWEET GLOBE,Clam
Agrolatina,24A3214653,03/05/2025,Sale,-50.0,290.0,30,SWEET GLOBE,Clam
Agrolatina,24A3214653,03/12/2025,Sale,-40.0,250.0,37,SWEET GLOBE,Clam
Agrolatina,24A3214890,01/07/2025,Entry,1200.0,1200.0,0,SWEET GLOBE,Clam
Agrolatina,24A3214890,01/07/2025,Entry,400.0,1600.0,0,SWEET GLOBE,Clam
Agrolatina,24A3214890,02/04/2025,Sale,-87.0,1513.0,28,SWEET GLOBE,Clam
Agrolatina,24A3214890,02/04/2025,Sale,-480.0,1033.0,28,SWEET GLOBE,Clam
Agrolatina,24A3214890,02/04/2025,Sale,-80.0,953.0,28,SWEET GLOBE,Clam
Agrolatina,24A3214890,02/05/2025,Sale,-80.0,873.0,29,SWEET GLOBE,Clam
Agrolatina,24A3214890,02/05/2025,Sale,-231.0,642.0,29,SWEET GLOBE,Clam
Agrolatina,24A3214890,02/05/2025,Sale,-160.0,482.0,29,SWEET GLOBE,Clam
Agrolatina,24A3214890,02/05/2025,Sale,-80.0,402.0,29,SWEET GLOBE,Clam
Agrolatina,24A3214890,02/11/2025,Sale,-320.0,82.0,35,SWEET GLOBE,Clam
Agrolatina,24A3214890,02/12/2025,Sale,-80.0,2.0,36,SWEET GLOBE,Clam
Agrolatina,24A3216893,03/03/2025,Entry,1120.0,1120.0,0,COTTON CANDY,Clam
Agrolatina,24A3216893,03/03/2025,Entry,480.0,1600.0,0,COTTON CANDY,Clam
Agrolatina,24A3216893,03/26/2025,Sale,-160.0,1440.0,23,COTTON CANDY,Clam
Agrolatina,24A3216893,03/27/2025,Sale,-320.0,1120.0,24,COTTON CANDY,Clam
Agrolatina,24A3216893,04/21/2025,Sale,-640.0,480.0,49,COTTON CANDY,Clam
Agrolatina,24A3222406,02/20/2025,Entry,1040.0,1040.0,0,IVORY,Clam
Agrolatina,24A3222406,02/20/2025,Entry,320.0,1360.0,0,IVORY,Clam
Agrolatina,24A3222406,02/20/2025,Entry,240.0,1600.0,0,IVORY,Clam
Agrolatina,24A3222406,03/04/2025,Sale,-240.0,1360.0,12,IVORY,Clam
Agrolatina,24A3222406,03/14/2025,Sale,-240.0,1120.0,22,IVORY,Clam
Agrolatina,24A3222406,03/15/2025,Sale,-640.0,480.0,23,IVORY,Clam
Agrolatina,24A3222406,03/22/2025,Sale,-40.0,440.0,30,IVORY,Clam
Agrolatina,24A3222406,03/22/2025,Sale,-80.0,360.0,30,IVORY,Clam
Agrolatina,24A3222406,03/22/2025,Sale,-120.0,240.0,30,IVORY,Clam
Agrolatina,24A3222406,03/27/2025,Sale,-75.0,165.0,35,IVORY,Clam
Agrolatina,24A3223444,03/13/2025,Entry,240.0,240.0,0,AUTUMN CRISP,Clam
Agrolatina,24A3223444,03/13/2025,Entry,1360.0,1600.0,0,AUTUMN CRISP,Clam
Agrolatina,24A3223444,03/19/2025,Sale,-80.0,1520.0,6,AUTUMN CRISP,Clam
Agrolatina,24A3223444,03/19/2025,Sale,-160.0,1360.0,6,AUTUMN CRISP,Clam
Agrolatina,24A3223444,03/19/2025,Sale,-560.0,800.0,6,AUTUMN CRISP,Clam
Agrolatina,24A3223444,03/19/2025,Sale,-560.0,240.0,6,AUTUMN CRISP,Clam
Agrolatina,24A3223444,03/31/2025,Sale,-240.0,0.0,18,AUTUMN CRISP,Clam
Agrolatina,24A3258862,02/27/2025,Entry,960.0,960.0,0,SWEET GLOBE,Clam
Agrolatina,24A3258862,02/27/2025,Entry,640.0,1600.0,0,SWEET GLOBE,Clam
Agrolatina,24A3258862,03/06/2025,Sale,-160.0,1440.0,7,SWEET GLOBE,Clam
Agrolatina,24A3258862,03/08/2025,Sale,-160.0,1280.0,9,SWEET GLOBE,Clam
Agrolatina,24A3258862,03/10/2025,Sale,-40.0,1240.0,11,SWEET GLOBE,Clam
Agrolatina,24A3258862,03/12/2025,Sale,-80.0,1160.0,13,SWEET GLOBE,Clam
Agrolatina,24A3258862,03/15/2025,Sale,-80.0,1080.0,16,SWEET GLOBE,Clam
Agrolatina,24A3258862,03/15/2025,Sale,-240.0,840.0,16,SWEET GLOBE,Clam
Agrolatina,24A3258862,03/18/2025,Sale,-200.0,640.0,19,SWEET GLOBE,Clam
Agrolatina,24A3258862,03/19/2025,Sale,-320.0,320.0,20,SWEET GLOBE,Clam
Agrolatina,24A3260833,12/30/2024,Entry,1520.0,1520.0,0,CANDY SNAP,Clam
Agrolatina,24A3260833,12/30/2024,Entry,80.0,1600.0,0,CANDY SNAP,Clam
Agrolatina,24A3260833,01/18/2025,Sale,-240.0,1360.0,19,CANDY SNAP,Clam
Agrolatina,24A3260833,01/20/2025,Sale,-1280.0,80.0,21,CANDY SNAP,Clam
Agrolatina,24A3260833,01/20/2025,Sale,-80.0,0.0,21,CANDY SNAP,Clam
Agrolatina,24A3261892,02/03/2025,Entry,1140.0,1140.0,0,SWEET GLOBE,Bag
Agrolatina,24A3261892,02/03/2025,Entry,760.0,1900.0,0,SWEET GLOBE,Bag
Agrolatina,24A3261892,02/08/2025,Sale,-475.0,1425.0,5,SWEET GLOBE,Bag
Agrolatina,24A3261892,02/13/2025,Sale,-270.0,1155.0,10,SWEET GLOBE,Bag
Agrolatina,24A3261892,02/15/2025,Sale,-90.0,1065.0,12,SWEET GLOBE,Bag
Agrolatina,24A3261892,02/17/2025,Sale,-95.0,970.0,14,SWEET GLOBE,Bag
Agrolatina,24A3261892,02/18/2025,Sale,-95.0,875.0,15,SWEET GLOBE,Bag
Agrolatina,24A3261892,02/22/2025,Sale,-55.0,820.0,19,SWEET GLOBE,Bag
Agrolatina,24A3261892,02/27/2025,Sale,-270.0,550.0,24,SWEET GLOBE,Bag
Agrolatina,24A3261892,02/27/2025,Sale,-10.0,540.0,24,SWEET GLOBE,Bag
Agrolatina,24A3261892,02/28/2025,Sale,-130.0,410.0,25,SWEET GLOBE,Bag
Agrolatina,24A3261892,03/11/2025,Sale,-63.0,347.0,36,SWEET GLOBE,Bag
Agrolatina,24A3261892,03/11/2025,Sale,-20.0,327.0,36,SWEET GLOBE,Bag
Agrolatina,24A3261892,03/11/2025,Sale,-40.0,287.0,36,SWEET GLOBE,Clam
Agrolatina,24A3261892,03/12/2025,Sale,-19.0,268.0,37,SWEET GLOBE,Bag
Agrolatina,24A3261892,04/01/2025,Sale,-1.0,267.0,57,SWEET GLOBE,Bag
Agrolatina,24A3265748,02/24/2025,Entry,160.0,160.0,0,TIMCO,Clam
Agrolatina,24A3265748,02/24/2025,Entry,1440.0,1600.0,0,TIMCO,Clam
Agrolatina,24A3265748,03/24/2025,Sale,-160.0,1440.0,28,TIMCO,Clam
Agrolatina,24A3265748,04/03/2025,Sale,-1440.0,0.0,38,TIMCO,Clam
Agrolatina,24A3279870,01/02/2025,Entry,1440.0,1440.0,0,CANDY SNAP,Clam
Agrolatina,24A3279870,01/02/2025,Entry,160.0,1600.0,0,CANDY SNAP,Clam
Agrolatina,24A3279870,01/09/2025,Sale,-80.0,1520.0,7,CANDY SNAP,Clam
Agrolatina,24A3279870,01/09/2025,Sale,-1360.0,160.0,7,CANDY SNAP,Clam
Agrolatina,24A3279870,01/09/2025,Sale,-80.0,80.0,7,CANDY SNAP,Clam
Agrolatina,24A3279870,01/14/2025,Sale,-80.0,0.0,12,CANDY SNAP,Clam
Agrolatina,24A3280660,01/11/2025,Entry,1600.0,1600.0,0,SWEET GLOBE,Clam
Agrolatina,24A3280660,01/24/2025,Sale,-480.0,1120.0,13,SWEET GLOBE,Clam
Agrolatina,24A3280660,01/25/2025,Sale,-1120.0,0.0,14,SWEET GLOBE,Clam
Agrolatina,24A3281219,02/27/2025,Entry,1040.0,1040.0,0,SWEET GLOBE,Clam
Agrolatina,24A3281219,02/27/2025,Entry,560.0,1600.0,0,SWEET GLOBE,Clam
Agrolatina,24A3281219,03/01/2025,Sale,-400.0,1200.0,2,SWEET GLOBE,Clam
Agrolatina,24A3281219,03/01/2025,Sale,-480.0,720.0,2,SWEET GLOBE,Clam
Agrolatina,24A3281219,03/01/2025,Sale,-80.0,640.0,2,SWEET GLOBE,Clam
Agrolatina,24A3281219,03/01/2025,Sale,-320.0,320.0,2,SWEET GLOBE,Clam
Agrolatina,24A3281219,03/03/2025,Sale,-80.0,240.0,4,SWEET GLOBE,Clam
Agrolatina,24A3281219,03/06/2025,Sale,-60.0,180.0,7,SWEET GLOBE,Clam
Agrolatina,24A3281219,03/10/2025,Sale,-20.0,160.0,11,SWEET GLOBE,Clam
Agrolatina,24A3281219,03/10/2025,Sale,-40.0,120.0,11,SWEET GLOBE,Clam
Agrolatina,24A3281219,03/11/2025,Sale,-50.0,70.0,12,SWEET GLOBE,Clam
Agrolatina,24A3281219,03/12/2025,Sale,-10.0,60.0,13,SWEET GLOBE,Clam
Agrolatina,24A3289164,01/30/2025,Entry,1200.0,1200.0,0,SWEET GLOBE,Clam
Agrolatina,24A3289164,01/30/2025,Entry,400.0,1600.0,0,SWEET GLOBE,Clam
Agrolatina,24A3289164,02/06/2025,Sale,-240.0,1360.0,7,SWEET GLOBE,Clam
Agrolatina,24A3289164,02/07/2025,Sale,-80.0,1280.0,8,SWEET GLOBE,Clam
Agrolatina,24A3289164,02/07/2025,Sale,-80.0,1200.0,8,SWEET GLOBE,Clam
Agrolatina,24A3289164,02/08/2025,Sale,-80.0,1120.0,9,SWEET GLOBE,Clam
Agrolatina,24A3289164,02/10/2025,Sale,-80.0,1040.0,11,SWEET GLOBE,Clam
Agrolatina,24A3289164,02/10/2025,Sale,-80.0,960.0,11,SWEET GLOBE,Clam
Agrolatina,24A3289164,02/11/2025,Sale,-80.0,880.0,12,SWEET GLOBE,Clam
Agrolatina,24A3289164,02/11/2025,Sale,-80.0,800.0,12,SWEET GLOBE,Clam
Agrolatina,24A3289164,02/15/2025,Sale,-160.0,640.0,16,SWEET GLOBE,Clam
Agrolatina,24A3289164,02/15/2025,Sale,-240.0,400.0,16,SWEET GLOBE,Clam
Agrolatina,24A3289164,02/19/2025,Sale,-160.0,240.0,20,SWEET GLOBE,Clam
Agrolatina,24A3289164,02/24/2025,Sale,-55.0,185.0,25,SWEET GLOBE,Clam
Agrolatina,24A3289164,02/25/2025,Sale,-50.0,135.0,26,SWEET GLOBE,Clam
Agrolatina,24A3289164,03/05/2025,Sale,-40.0,95.0,34,SWEET GLOBE,Clam
Agrolatina,24A3291829,02/07/2025,Entry,1440.0,1440.0,0,SWEET GLOBE,Clam
Agrolatina,24A3291829,02/07/2025,Entry,160.0,1600.0,0,SWEET GLOBE,Clam
Agrolatina,24A3291829,02/19/2025,Sale,-80.0,1520.0,12,SWEET GLOBE,Clam
Agrolatina,24A3291829,02/20/2025,Sale,-400.0,1120.0,13,SWEET GLOBE,Clam
Agrolatina,24A3291829,02/20/2025,Sale,-320.0,800.0,13,SWEET GLOBE,Clam
Agrolatina,24A3291829,02/21/2025,Sale,-160.0,640.0,14,SWEET GLOBE,Clam
Agrolatina,24A3291829,02/21/2025,Sale,-80.0,560.0,14,SWEET GLOBE,Clam
Agrolatina,24A3291829,02/22/2025,Sale,-40.0,520.0,15,SWEET GLOBE,Clam
Agrolatina,24A3291829,02/22/2025,Sale,-90.0,430.0,15,SWEET GLOBE,Clam
Agrolatina,24A3291829,02/22/2025,Sale,-100.0,330.0,15,SWEET GLOBE,Clam
Agrolatina,24A3291829,02/24/2025,Sale,-80.0,250.0,17,SWEET GLOBE,Clam
Agrolatina,24A3291829,02/24/2025,Sale,-20.0,230.0,17,SWEET GLOBE,Clam
Agrolatina,24A3291829,02/25/2025,Sale,-20.0,210.0,18,SWEET GLOBE,Clam
Agrolatina,24A3291829,02/27/2025,Sale,-40.0,170.0,20,SWEET GLOBE,Clam
Agrolatina,24A3292229,03/03/2025,Entry,1280.0,1280.0,0,TIMCO,Clam
Agrolatina,24A3292229,03/03/2025,Entry,320.0,1600.0,0,TIMCO,Clam
Agrolatina,24A3292229,03/27/2025,Sale,-640.0,960.0,24,TIMCO,Clam
Agrolatina,24A3292229,03/28/2025,Sale,-80.0,880.0,25,TIMCO,Clam
Agrolatina,24A3292229,04/01/2025,Sale,-80.0,800.0,29,TIMCO,Clam
Agrolatina,24A3292229,04/01/2025,Sale,-80.0,720.0,29,TIMCO,Clam
Agrolatina,24A3292229,04/01/2025,Sale,-320.0,400.0,29,TIMCO,Clam
Agrolatina,24A3292229,04/02/2025,Sale,-160.0,240.0,30,TIMCO,Clam
Agrolatina,24A3292229,04/05/2025,Sale,-80.0,160.0,33,TIMCO,Clam
Agrolatina,24A3292229,04/07/2025,Sale,-160.0,0.0,35,TIMCO,Clam
Agrolatina,24A3323398,03/03/2025,Entry,1280.0,1280.0,0,TIMCO,Clam
Agrolatina,24A3323398,03/03/2025,Entry,320.0,1600.0,0,TIMCO,Clam
Agrolatina,24A3323398,03/24/2025,Sale,-80.0,1520.0,21,TIMCO,Clam
Agrolatina,24A3323398,03/28/2025,Sale,-80.0,1440.0,25,TIMCO,Clam
Agrolatina,24A3323398,03/28/2025,Sale,-240.0,1200.0,25,TIMCO,Clam
Agrolatina,24A3323398,03/29/2025,Sale,-640.0,560.0,26,TIMCO,Clam
Agrolatina,24A3323398,03/29/2025,Sale,-320.0,240.0,26,TIMCO,Clam
Agrolatina,24A3323398,04/03/2025,Sale,-80.0,160.0,31,TIMCO,Clam
Agrolatina,24A3323398,04/04/2025,Sale,-80.0,80.0,32,TIMCO,Clam
Agrolatina,24A3323398,04/05/2025,Sale,-80.0,0.0,33,TIMCO,Clam
Agrolatina,24A3325220,02/27/2025,Entry,1360.0,1360.0,0,COTTON CANDY,Clam
Agrolatina,24A3325220,02/27/2025,Entry,240.0,1600.0,0,COTTON CANDY,Clam
Agrolatina,24A3325220,03/05/2025,Sale,-1280.0,320.0,6,COTTON CANDY,Clam
Agrolatina,24A3325220,04/02/2025,Sale,-40.0,280.0,34,COTTON CANDY,Clam
Agrolatina,24A3325220,04/02/2025,Sale,-40.0,240.0,34,COTTON CANDY,Clam
Agrolatina,24A3327393,02/03/2025,Entry,1440.0,1440.0,0,SWEET GLOBE,Clam
Agrolatina,24A3327393,02/03/2025,Entry,160.0,1600.0,0,SWEET GLOBE,Clam
Agrolatina,24A3327393,02/08/2025,Sale,-160.0,1440.0,5,SWEET GLOBE,Clam
Agrolatina,24A3327393,02/08/2025,Sale,-320.0,1120.0,5,SWEET GLOBE,Clam
Agrolatina,24A3327393,02/10/2025,Sale,-560.0,560.0,7,SWEET GLOBE,Clam
Agrolatina,24A3327393,02/10/2025,Sale,-240.0,320.0,7,SWEET GLOBE,Clam
Agrolatina,24A3327393,02/11/2025,Sale,-80.0,240.0,8,SWEET GLOBE,Clam
Agrolatina,24A3327393,02/12/2025,Sale,-80.0,160.0,9,SWEET GLOBE,Clam
Agrolatina,24A3327393,02/17/2025,Sale,-80.0,80.0,14,SWEET GLOBE,Clam
Agrolatina,24A3327393,02/28/2025,Sale,-40.0,40.0,25,SWEET GLOBE,Clam
Agrolatina,24A3327393,03/05/2025,Sale,-50.0,-10.0,30,SWEET GLOBE,Clam
Agrolatina,24A3328888,03/03/2025,Entry,640.0,640.0,0,SWEET GLOBE,Clam
Agrolatina,24A3328888,03/03/2025,Entry,960.0,1600.0,0,SWEET GLOBE,Clam
Agrolatina,24A3328888,03/05/2025,Sale,-320.0,1280.0,2,SWEET GLOBE,Clam
Agrolatina,24A3328888,03/08/2025,Sale,-160.0,1120.0,5,SWEET GLOBE,Clam
Agrolatina,24A3328888,03/08/2025,Sale,-160.0,960.0,5,SWEET GLOBE,Clam
Agrolatina,24A3328888,03/14/2025,Sale,-360.0,600.0,11,SWEET GLOBE,Clam
Agrolatina,24A3328888,03/15/2025,Sale,-80.0,520.0,12,SWEET GLOBE,Clam
Agrolatina,24A3328888,03/15/2025,Sale,-229.0,291.0,12,SWEET GLOBE,Clam
Agrolatina,24A3328888,03/17/2025,Sale,-40.0,251.0,14,SWEET GLOBE,Clam
Agrolatina,24A3340409,02/03/2025,Entry,560.0,560.0,0,ALLISON,Clam
Agrolatina,24A3340409,02/03/2025,Entry,1040.0,1600.0,0,ALLISON,Clam
Agrolatina,24A3340409,02/06/2025,Sale,-480.0,1120.0,3,ALLISON,Clam
Agrolatina,24A3340409,02/06/2025,Sale,-80.0,1040.0,3,ALLISON,Clam
Agrolatina,24A3340409,02/10/2025,Sale,-720.0,320.0,7,ALLISON,Clam
Agrolatina,24A3340409,02/11/2025,Sale,-320.0,0.0,8,ALLISON,Clam
Agrolatina,24A3383123,02/20/2025,Entry,720.0,720.0,0,ALLISON,Clam
Agrolatina,24A3383123,02/20/2025,Entry,880.0,1600.0,0,ALLISON,Clam
Agrolatina,24A3383123,03/06/2025,Sale,-880.0,720.0,14,ALLISON,Clam
Agrolatina,24A3383123,03/11/2025,Sale,-560.0,160.0,19,ALLISON,Clam
Agrolatina,24A3383123,03/11/2025,Sale,-160.0,0.0,19,ALLISON,Clam
Agrolatina,24A3383592,12/31/2024,Entry,1520.0,1520.0,0,CANDY SNAP,Clam
Agrolatina,24A3383592,12/31/2024,Entry,80.0,1600.0,0,CANDY SNAP,Clam
Agrolatina,24A3383592,02/24/2025,Sale,-880.0,720.0,55,CANDY SNAP,Clam
Agrolatina,24A3383592,02/24/2025,Sale,-240.0,480.0,55,CANDY SNAP,Clam
Agrolatina,24A3383592,02/28/2025,Sale,-105.0,375.0,59,CANDY SNAP,Clam
Agrolatina,24A3383592,03/03/2025,Sale,-3.0,372.0,62,CANDY SNAP,Clam
Agrolatina,24A3383592,03/31/2025,Sale,-27.0,345.0,90,CANDY SNAP,Clam
Agrolatina,24A3395989,02/27/2025,Entry,1360.0,1360.0,0,COTTON CANDY,Clam
Agrolatina,24A3395989,02/27/2025,Entry,240.0,1600.0,0,COTTON CANDY,Clam
Agrolatina,24A3395989,03/04/2025,Sale,-240.0,1360.0,5,COTTON CANDY,Clam
Agrolatina,24A3395989,03/12/2025,Sale,-135.0,1225.0,13,COTTON CANDY,Clam
Agrolatina,24A3395989,03/28/2025,Sale,-198.0,1027.0,29,COTTON CANDY,Clam
Agrolatina,24A3395989,04/02/2025,Sale,-240.0,787.0,34,COTTON CANDY,Clam
Agrolatina,24A3395989,04/02/2025,Sale,-80.0,707.0,34,COTTON CANDY,Clam
Agrolatina,24A3395989,04/10/2025,Sale,-80.0,627.0,42,COTTON CANDY,Clam
Agrolatina,24A3418960,03/03/2025,Entry,1020.0,1020.0,0,TIMCO,Clam
Agrolatina,24A3418960,03/03/2025,Entry,680.0,1700.0,0,TIMCO,Clam
Agrolatina,24A3418960,03/25/2025,Sale,-340.0,1360.0,22,TIMCO,Clam
Agrolatina,24A3418960,04/09/2025,Sale,-270.0,1090.0,37,TIMCO,Bag
Agrolatina,24A3418960,04/10/2025,Sale,-270.0,820.0,38,TIMCO,Bag
Agrolatina,24A3418960,04/10/2025,Sale,-152.0,668.0,38,TIMCO,Bag
Agrolatina,24A3418960,04/14/2025,Sale,-420.0,248.0,42,TIMCO,Bag
Agrolatina,24A3419015,02/20/2025,Entry,1200.0,1200.0,0,IVORY,Clam
Agrolatina,24A3419015,02/20/2025,Entry,160.0,1360.0,0,IVORY,Clam
Agrolatina,24A3419015,02/20/2025,Entry,240.0,1600.0,0,IVORY,Clam
Agrolatina,24A3419015,03/01/2025,Sale,-240.0,1360.0,9,IVORY,Clam
Agrolatina,24A3419015,03/04/2025,Sale,-80.0,1280.0,12,IVORY,Clam
Agrolatina,24A3419015,03/04/2025,Sale,-160.0,1120.0,12,IVORY,Clam
Agrolatina,24A3419015,03/14/2025,Sale,-80.0,1040.0,22,IVORY,Clam
Agrolatina,24A3419015,03/22/2025,Sale,-80.0,960.0,30,IVORY,Clam
Agrolatina,24A3419015,03/22/2025,Sale,-80.0,880.0,30,IVORY,Clam
Agrolatina,24A3419015,03/22/2025,Sale,-80.0,800.0,30,IVORY,Clam
Agrolatina,24A3419015,03/22/2025,Sale,-80.0,720.0,30,IVORY,Clam
Agrolatina,24A3419015,03/24/2025,Sale,-80.0,640.0,32,IVORY,Clam
Agrolatina,24A3419015,03/25/2025,Sale,-160.0,480.0,33,IVORY,Clam
Agrolatina,24A3419015,03/25/2025,Sale,-80.0,400.0,33,IVORY,Clam
Agrolatina,24A3419015,03/28/2025,Sale,-40.0,360.0,36,IVORY,Clam
Agrolatina,24A3419015,03/29/2025,Sale,-40.0,320.0,37,IVORY,Clam
Agrolatina,24A3419015,03/31/2025,Sale,-40.0,280.0,39,IVORY,Clam
Agrolatina,24A3423078,03/03/2025,Entry,1280.0,1280.0,0,IVORY,Clam
Agrolatina,24A3423078,03/03/2025,Entry,320.0,1600.0,0,IVORY,Clam
Agrolatina,24A3423078,03/22/2025,Sale,-240.0,1360.0,19,IVORY,Clam
Agrolatina,24A3423078,03/25/2025,Sale,-212.0,1148.0,22,IVORY,Clam
Agrolatina,24A3423078,03/25/2025,Sale,-304.0,844.0,22,IVORY,Clam
Agrolatina,24A3423078,03/27/2025,Sale,-240.0,604.0,24,IVORY,Clam
Agrolatina,24A3423078,04/01/2025,Sale,-120.0,484.0,29,IVORY,Clam
Agrolatina,24A3427941,02/13/2025,Entry,1615.0,1615.0,0,SWEET GLOBE,Clam
Agrolatina,24A3427941,02/13/2025,Entry,85.0,1700.0,0,SWEET GLOBE,Clam
Agrolatina,24A3427941,03/19/2025,Sale,-765.0,935.0,34,SWEET GLOBE,Clam
Agrolatina,24A3427941,03/20/2025,Sale,-117.0,818.0,35,SWEET GLOBE,Clam
Agrolatina,24A3427941,04/03/2025,Sale,-45.0,773.0,49,SWEET GLOBE,Bag
Agrolatina,24A3427941,04/08/2025,Sale,-186.0,587.0,54,SWEET GLOBE,Bag
Agrolatina,24A3433517,01/28/2025,Entry,1520.0,1520.0,0,ALLISON,Clam
Agrolatina,24A3433517,01/28/2025,Entry,80.0,1600.0,0,ALLISON,Clam
Agrolatina,24A3433517,02/01/2025,Sale,-80.0,1520.0,4,ALLISON,Clam
Agrolatina,24A3433517,02/03/2025,Sale,-320.0,1200.0,6,ALLISON,Clam
Agrolatina,24A3433517,02/04/2025,Sale,-80.0,1120.0,7,ALLISON,Clam
Agrolatina,24A3433517,02/04/2025,Sale,-80.0,1040.0,7,ALLISON,Clam
Agrolatina,24A3433517,02/08/2025,Sale,-80.0,960.0,11,ALLISON,Clam
Agrolatina,24A3433517,02/10/2025,Sale,-160.0,800.0,13,ALLISON,Clam
Agrolatina,24A3433517,02/11/2025,Sale,-480.0,320.0,14,ALLISON,Clam
Agrolatina,24A3433517,02/12/2025,Sale,-80.0,240.0,15,ALLISON,Clam
Agrolatina,24A3433517,02/13/2025,Sale,-80.0,160.0,16,ALLISON,Clam
Agrolatina,24A3433517,02/17/2025,Sale,-160.0,0.0,20,ALLISON,Clam
Agrolatina,24A3438268,01/16/2025,Entry,1040.0,1040.0,0,ALLISON,Clam
Agrolatina,24A3438268,01/16/2025,Entry,560.0,1600.0,0,ALLISON,Clam
Agrolatina,24A3438268,03/25/2025,Sale,-240.0,1360.0,68,ALLISON,Clam
Agrolatina,24A3438268,03/25/2025,Sale,-634.0,726.0,68,ALLISON,Clam
Agrolatina,24A3438268,03/25/2025,Sale,-320.0,406.0,68,ALLISON,Clam
Agrolatina,24A3438268,03/27/2025,Sale,-80.0,326.0,70,ALLISON,Clam
Agrolatina,24A3440012,02/13/2025,Entry,570.0,570.0,0,SWEET FAVORS,Bag
Agrolatina,24A3440012,02/13/2025,Entry,95.0,665.0,0,SWEET FAVORS,Bag
Agrolatina,24A3440012,02/13/2025,Entry,475.0,1140.0,0,SWEET GLOBE,Bag
Agrolatina,24A3440012,02/13/2025,Entry,760.0,1900.0,0,SWEET GLOBE,Bag
Agrolatina,24A3440012,02/22/2025,Sale,-570.0,1330.0,9,SWEET FAVORS,Bag
Agrolatina,24A3440012,02/24/2025,Sale,-20.0,1310.0,11,SWEET GLOBE,Bag
Agrolatina,24A3440012,02/24/2025,Sale,-340.0,970.0,11,SWEET GLOBE,Bag
Agrolatina,24A3440012,02/28/2025,Sale,-250.0,720.0,15,SWEET GLOBE,Bag
Agrolatina,24A3440012,02/28/2025,Sale,-360.0,360.0,15,SWEET GLOBE,Bag
Agrolatina,24A3440012,03/14/2025,Sale,-90.0,270.0,29,SWEET GLOBE,Bag
Agrolatina,24A3440012,04/14/2025,Sale,-95.0,175.0,60,SWEET FAVORS,Bag
Agrolatina,24A3472112,01/09/2025,Entry,1520.0,1520.0,0,SWEET GLOBE,Clam
Agrolatina,24A3472112,01/09/2025,Entry,80.0,1600.0,0,SWEET GLOBE,Clam
Agrolatina,24A3472112,01/16/2025,Sale,-80.0,1520.0,7,SWEET GLOBE,Clam
Agrolatina,24A3472112,01/16/2025,Sale,-80.0,1440.0,7,SWEET GLOBE,Clam
Agrolatina,24A3472112,01/16/2025,Sale,-80.0,1360.0,7,SWEET GLOBE,Clam
Agrolatina,24A3472112,01/17/2025,Sale,-880.0,480.0,8,SWEET GLOBE,Clam
Agrolatina,24A3472112,01/21/2025,Sale,-80.0,400.0,12,SWEET GLOBE,Clam
Agrolatina,24A3472112,01/30/2025,Sale,-400.0,0.0,21,SWEET GLOBE,Clam
Agrolatina,24A3483950,12/23/2024,Entry,960.0,960.0,0,SWEET GLOBE,Clam
Agrolatina,24A3483950,12/23/2024,Entry,80.0,1040.0,0,SWEET GLOBE,Clam
Agrolatina,24A3483950,12/23/2024,Entry,560.0,1600.0,0,SWEET GLOBE,Clam
Agrolatina,24A3483950,01/15/2025,Sale,-560.0,1040.0,23,SWEET GLOBE,Clam
Agrolatina,24A3483950,01/15/2025,Sale,-400.0,640.0,23,SWEET GLOBE,Clam
Agrolatina,24A3483950,01/15/2025,Sale,-80.0,560.0,23,SWEET GLOBE,Clam
Agrolatina,24A3483950,01/15/2025,Sale,-560.0,0.0,23,SWEET GLOBE,Clam
Agrolatina,24A3485254,12/26/2024,Entry,1440.0,1440.0,0,ALLISON,Clam
Agrolatina,24A3485254,12/26/2024,Entry,80.0,1520.0,0,ALLISON,Clam
Agrolatina,24A3485254,12/26/2024,Entry,80.0,1600.0,0,ALLISON,Clam
Agrolatina,24A3485254,01/09/2025,Sale,-1440.0,160.0,14,ALLISON,Clam
Agrolatina,24A3485254,01/09/2025,Sale,-80.0,80.0,14,ALLISON,Clam
Agrolatina,24A3485254,01/09/2025,Sale,-80.0,0.0,14,ALLISON,Clam
Agrolatina,24A3486754,01/11/2025,Entry,1600.0,1600.0,0,ALLISON,Clam
Agrolatina,24A3486754,01/31/2025,Sale,-1520.0,80.0,20,ALLISON,Clam
Agrolatina,24A3486754,02/03/2025,Sale,-80.0,0.0,23,ALLISON,Clam
Agrolatina,24A3490230,02/20/2025,Entry,1040.0,1040.0,0,SWEET GLOBE,Clam
Agrolatina,24A3490230,02/20/2025,Entry,560.0,1600.0,0,SWEET GLOBE,Clam
Agrolatina,24A3490230,02/27/2025,Sale,-880.0,720.0,7,SWEET GLOBE,Clam
Agrolatina,24A3490230,02/27/2025,Sale,-40.0,680.0,7,SWEET GLOBE,Clam
Agrolatina,24A3490230,02/28/2025,Sale,-80.0,600.0,8,SWEET GLOBE,Clam
Agrolatina,24A3490230,03/03/2025,Sale,-80.0,520.0,11,SWEET GLOBE,Clam
Agrolatina,24A3490230,03/03/2025,Sale,-80.0,440.0,11,SWEET GLOBE,Clam
Agrolatina,24A3490230,03/10/2025,Sale,-80.0,360.0,18,SWEET GLOBE,Clam
Agrolatina,24A3490230,03/11/2025,Sale,-10.0,350.0,19,SWEET GLOBE,Clam
Agrolatina,24A3490230,03/11/2025,Sale,-40.0,310.0,19,SWEET GLOBE,Clam
Agrolatina,24A3490230,03/12/2025,Sale,-110.0,200.0,20,SWEET GLOBE,Clam
Agrolatina,24A3490230,03/17/2025,Sale,-40.0,160.0,25,SWEET GLOBE,Clam
Agrolatina,24A3514199,12/31/2024,Entry,1440.0,1440.0,0,CANDY SNAP,Clam
Agrolatina,24A3514199,12/31/2024,Entry,160.0,1600.0,0,CANDY SNAP,Clam
Agrolatina,24A3514199,01/10/2025,Sale,-480.0,1120.0,10,CANDY SNAP,Clam
Agrolatina,24A3514199,01/11/2025,Sale,-960.0,160.0,11,CANDY SNAP,Clam
Agrolatina,24A3514199,01/14/2025,Sale,-160.0,0.0,14,CANDY SNAP,Clam
Agrolatina,24A3516592,01/02/2025,Entry,1440.0,1440.0,0,CANDY SNAP,Clam
Agrolatina,24A3516592,01/02/2025,Entry,160.0,1600.0,0,CANDY SNAP,Clam
Agrolatina,24A3516592,01/15/2025,Sale,-1200.0,400.0,13,CANDY SNAP,Clam
Agrolatina,24A3516592,01/18/2025,Sale,-80.0,320.0,16,CANDY SNAP,Clam
Agrolatina,24A3516592,01/18/2025,Sale,-160.0,160.0,16,CANDY SNAP,Clam
Agrolatina,24A3516592,01/18/2025,Sale,-160.0,0.0,16,CANDY SNAP,Clam
Agrolatina,24A3530693,01/30/2025,Entry,1120.0,1120.0,0,SWEET GLOBE,Clam
Agrolatina,24A3530693,01/30/2025,Entry,480.0,1600.0,0,SWEET GLOBE,Clam
Agrolatina,24A3530693,02/10/2025,Sale,-160.0,1440.0,11,SWEET GLOBE,Clam
Agrolatina,24A3530693,02/11/2025,Sale,-80.0,1360.0,12,SWEET GLOBE,Clam
Agrolatina,24A3530693,02/15/2025,Sale,-80.0,1280.0,16,SWEET GLOBE,Clam
Agrolatina,24A3530693,02/18/2025,Sale,-240.0,1040.0,19,SWEET GLOBE,Clam
Agrolatina,24A3530693,02/20/2025,Sale,-320.0,720.0,21,SWEET GLOBE,Clam
Agrolatina,24A3530693,02/21/2025,Sale,-160.0,560.0,22,SWEET GLOBE,Clam
Agrolatina,24A3530693,02/21/2025,Sale,-80.0,480.0,22,SWEET GLOBE,Clam
Agrolatina,24A3530693,02/22/2025,Sale,-103.0,377.0,23,SWEET GLOBE,Clam
Agrolatina,24A3530693,02/26/2025,Sale,-40.0,337.0,27,SWEET GLOBE,Clam
Agrolatina,24A3530693,02/27/2025,Sale,-130.0,207.0,28,SWEET GLOBE,Clam
Agrolatina,24A3530693,02/28/2025,Sale,-40.0,167.0,29,SWEET GLOBE,Clam
Agrolatina,24A3534235,02/24/2025,Entry,880.0,880.0,0,SWEET GLOBE,Clam
Agrolatina,24A3534235,02/24/2025,Entry,720.0,1600.0,0,SWEET GLOBE,Clam
Agrolatina,24A3534235,03/17/2025,Sale,-880.0,720.0,21,SWEET GLOBE,Clam
Agrolatina,24A3534235,03/17/2025,Sale,-720.0,0.0,21,SWEET GLOBE,Clam
Agrolatina,24A3538924,01/30/2025,Entry,640.0,640.0,0,SWEET GLOBE,Clam
Agrolatina,24A3538924,01/30/2025,Entry,960.0,1600.0,0,SWEET GLOBE,Clam
Agrolatina,24A3538924,02/08/2025,Sale,-80.0,1520.0,9,SWEET GLOBE,Clam
Agrolatina,24A3538924,02/08/2025,Sale,-80.0,1440.0,9,SWEET GLOBE,Clam
Agrolatina,24A3538924,02/10/2025,Sale,-160.0,1280.0,11,SWEET GLOBE,Clam
Agrolatina,24A3538924,02/11/2025,Sale,-80.0,1200.0,12,SWEET GLOBE,Clam
Agrolatina,24A3538924,02/11/2025,Sale,-80.0,1120.0,12,SWEET GLOBE,Clam
Agrolatina,24A3538924,02/12/2025,Sale,-240.0,880.0,13,SWEET GLOBE,Clam
Agrolatina,24A3538924,02/12/2025,Sale,-240.0,640.0,13,SWEET GLOBE,Clam
Agrolatina,24A3538924,02/13/2025,Sale,-240.0,400.0,14,SWEET GLOBE,Clam
Agrolatina,24A3538924,02/18/2025,Sale,-80.0,320.0,19,SWEET GLOBE,Clam
Agrolatina,24A3538924,02/20/2025,Sale,-80.0,240.0,21,SWEET GLOBE,Clam
Agrolatina,24A3538924,02/25/2025,Sale,-40.0,200.0,26,SWEET GLOBE,Clam
Agrolatina,24A3538924,02/25/2025,Sale,-30.0,170.0,26,SWEET GLOBE,Clam
Agrolatina,24A3538924,03/01/2025,Sale,-80.0,90.0,30,SWEET GLOBE,Clam
Agrolatina,24A3538924,03/10/2025,Sale,-50.0,40.0,39,SWEET GLOBE,Clam
Agrolatina,24A3540412,12/30/2024,Entry,1200.0,1200.0,0,IVORY,Clam
Agrolatina,24A3540412,12/30/2024,Entry,320.0,1520.0,0,IVORY,Clam
Agrolatina,24A3540412,12/30/2024,Entry,80.0,1600.0,0,IVORY,Clam
Agrolatina,24A3540412,01/17/2025,Sale,-1200.0,400.0,18,IVORY,Clam
Agrolatina,24A3540412,01/17/2025,Sale,-320.0,80.0,18,IVORY,Clam
Agrolatina,24A3540412,01/17/2025,Sale,-80.0,0.0,18,IVORY,Clam
Agrolatina,24A3555120,12/30/2024,Entry,1600.0,1600.0,0,CANDY SNAP,Clam
Agrolatina,24A3555120,01/20/2025,Sale,-240.0,1360.0,21,CANDY SNAP,Clam
Agrolatina,24A3555120,01/21/2025,Sale,-1360.0,0.0,22,CANDY SNAP,Clam
Agrolatina,24A3556297,01/16/2025,Entry,1360.0,1360.0,0,ALLISON,Clam
Agrolatina,24A3556297,01/16/2025,Entry,240.0,1600.0,0,ALLISON,Clam
Agrolatina,24A3556297,02/03/2025,Sale,-80.0,1520.0,18,ALLISON,Clam
Agrolatina,24A3556297,02/04/2025,Sale,-80.0,1440.0,19,ALLISON,Clam
Agrolatina,24A3556297,02/04/2025,Sale,-80.0,1360.0,19,ALLISON,Clam
Agrolatina,24A3556297,02/05/2025,Sale,-80.0,1280.0,20,ALLISON,Clam
Agrolatina,24A3556297,02/08/2025,Sale,-400.0,880.0,23,ALLISON,Clam
Agrolatina,24A3556297,02/11/2025,Sale,-240.0,640.0,26,ALLISON,Clam
Agrolatina,24A3556297,02/11/2025,Sale,-160.0,480.0,26,ALLISON,Clam
Agrolatina,24A3556297,02/13/2025,Sale,-160.0,320.0,28,ALLISON,Clam
Agrolatina,24A3556297,02/14/2025,Sale,-80.0,240.0,29,ALLISON,Clam
Agrolatina,24A3556297,02/24/2025,Sale,-240.0,0.0,39,ALLISON,Clam
Agrolatina,24A3556358,01/11/2025,Entry,1520.0,1520.0,0,SWEET GLOBE,Clam
Agrolatina,24A3556358,01/11/2025,Entry,80.0,1600.0,0,SWEET GLOBE,Clam
Agrolatina,24A3556358,01/25/2025,Sale,-240.0,1360.0,14,SWEET GLOBE,Clam
Agrolatina,24A3556358,01/25/2025,Sale,-640.0,720.0,14,SWEET GLOBE,Clam
Agrolatina,24A3556358,01/25/2025,Sale,-80.0,640.0,14,SWEET GLOBE,Clam
Agrolatina,24A3556358,01/27/2025,Sale,-400.0,240.0,16,SWEET GLOBE,Clam
Agrolatina,24A3556358,01/28/2025,Sale,-240.0,0.0,17,SWEET GLOBE,Clam
Agrolatina,24A3557210,02/13/2025,Entry,1200.0,1200.0,0,SWEET GLOBE,Clam
Agrolatina,24A3557210,02/13/2025,Entry,400.0,1600.0,0,SWEET GLOBE,Clam
Agrolatina,24A3557210,02/21/2025,Sale,-80.0,1520.0,8,SWEET GLOBE,Clam
Agrolatina,24A3557210,02/21/2025,Sale,-240.0,1280.0,8,SWEET GLOBE,Clam
Agrolatina,24A3557210,02/22/2025,Sale,-560.0,720.0,9,SWEET GLOBE,Clam
Agrolatina,24A3557210,02/22/2025,Sale,-160.0,560.0,9,SWEET GLOBE,Clam
Agrolatina,24A3557210,02/24/2025,Sale,-400.0,160.0,11,SWEET GLOBE,Clam
Agrolatina,24A3557210,02/28/2025,Sale,-60.0,100.0,15,SWEET GLOBE,Clam
Agrolatina,24A3557210,03/05/2025,Sale,-80.0,20.0,20,SWEET GLOBE,Clam
Agrolatina,24A3566490,02/03/2025,Entry,1200.0,1200.0,0,SWEET GLOBE,Clam
Agrolatina,24A3566490,02/03/2025,Entry,400.0,1600.0,0,SWEET GLOBE,Clam
Agrolatina,24A3566490,02/10/2025,Sale,-80.0,1520.0,7,SWEET GLOBE,Clam
Agrolatina,24A3566490,02/14/2025,Sale,-480.0,1040.0,11,SWEET GLOBE,Clam
Agrolatina,24A3566490,02/18/2025,Sale,-80.0,960.0,15,SWEET GLOBE,Clam
Agrolatina,24A3566490,02/18/2025,Sale,-160.0,800.0,15,SWEET GLOBE,Clam
Agrolatina,24A3566490,02/20/2025,Sale,-80.0,720.0,17,SWEET GLOBE,Clam
Agrolatina,24A3566490,02/24/2025,Sale,-135.0,585.0,21,SWEET GLOBE,Clam
Agrolatina,24A3566490,02/25/2025,Sale,-27.0,558.0,22,SWEET GLOBE,Clam
Agrolatina,24A3566490,02/27/2025,Sale,-80.0,478.0,24,SWEET GLOBE,Clam
Agrolatina,24A3566490,02/28/2025,Sale,-80.0,398.0,25,SWEET GLOBE,Clam
Agrolatina,24A3566490,03/01/2025,Sale,-8.0,390.0,26,SWEET GLOBE,Clam
Agrolatina,24A3566490,03/03/2025,Sale,-60.0,330.0,28,SWEET GLOBE,Clam
Agrolatina,24A3566490,03/05/2025,Sale,-40.0,290.0,30,SWEET GLOBE,Clam
Agrolatina,24A3572997,02/13/2025,Entry,960.0,960.0,0,SWEET GLOBE,Clam
Agrolatina,24A3572997,02/13/2025,Entry,640.0,1600.0,0,SWEET GLOBE,Clam
Agrolatina,24A3572997,02/24/2025,Sale,-80.0,1520.0,11,SWEET GLOBE,Clam
Agrolatina,24A3572997,02/24/2025,Sale,-880.0,640.0,11,SWEET GLOBE,Clam
Agrolatina,24A3572997,02/26/2025,Sale,-55.0,585.0,13,SWEET GLOBE,Clam
Agrolatina,24A3572997,02/26/2025,Sale,-30.0,555.0,13,SWEET GLOBE,Clam
Agrolatina,24A3572997,02/27/2025,Sale,-120.0,435.0,14,SWEET GLOBE,Clam
Agrolatina,24A3572997,02/27/2025,Sale,-180.0,255.0,14,SWEET GLOBE,Clam
Agrolatina,24A3572997,02/28/2025,Sale,-80.0,175.0,15,SWEET GLOBE,Clam
Agrolatina,24A3575321,02/13/2025,Entry,1040.0,1040.0,0,SWEET GLOBE,Clam
Agrolatina,24A3575321,02/13/2025,Entry,560.0,1600.0,0,SWEET GLOBE,Clam
Agrolatina,24A3575321,02/21/2025,Sale,-80.0,1520.0,8,SWEET GLOBE,Clam
Agrolatina,24A3575321,02/22/2025,Sale,-80.0,1440.0,9,SWEET GLOBE,Clam
Agrolatina,24A3575321,02/24/2025,Sale,-160.0,1280.0,11,SWEET GLOBE,Clam
Agrolatina,24A3575321,02/24/2025,Sale,-640.0,640.0,11,SWEET GLOBE,Clam
Agrolatina,24A3575321,02/24/2025,Sale,-80.0,560.0,11,SWEET GLOBE,Clam
Agrolatina,24A3575321,02/25/2025,Sale,-40.0,520.0,12,SWEET GLOBE,Clam
Agrolatina,24A3575321,02/25/2025,Sale,-90.0,430.0,12,SWEET GLOBE,Clam
Agrolatina,24A3575321,02/26/2025,Sale,-40.0,390.0,13,SWEET GLOBE,Clam
Agrolatina,24A3575321,02/27/2025,Sale,-80.0,310.0,14,SWEET GLOBE,Clam
Agrolatina,24A3575321,02/27/2025,Sale,-30.0,280.0,14,SWEET GLOBE,Clam
Agrolatina,24A3575321,03/01/2025,Sale,-80.0,200.0,16,SWEET GLOBE,Clam
Agrolatina,24A3575321,03/10/2025,Sale,-110.0,90.0,25,SWEET GLOBE,Clam
Agrolatina,24A3577480,02/13/2025,Entry,1120.0,1120.0,0,SWEET GLOBE,Clam
Agrolatina,24A3577480,02/13/2025,Entry,480.0,1600.0,0,SWEET GLOBE,Clam
Agrolatina,24A3577480,02/24/2025,Sale,-1040.0,560.0,11,SWEET GLOBE,Clam
Agrolatina,24A3577480,02/27/2025,Sale,-110.0,450.0,14,SWEET GLOBE,Clam
Agrolatina,24A3577480,02/28/2025,Sale,-80.0,370.0,15,SWEET GLOBE,Clam
Agrolatina,24A3577480,03/01/2025,Sale,-80.0,290.0,16,SWEET GLOBE,Clam
Agrolatina,24A3592632,01/16/2025,Entry,1520.0,1520.0,0,ALLISON,Clam
Agrolatina,24A3592632,01/16/2025,Entry,80.0,1600.0,0,ALLISON,Clam
Agrolatina,24A3592632,02/04/2025,Sale,-560.0,1040.0,19,ALLISON,Clam
Agrolatina,24A3592632,02/11/2025,Sale,-320.0,720.0,26,ALLISON,Clam
Agrolatina,24A3592632,02/11/2025,Sale,-80.0,640.0,26,ALLISON,Clam
Agrolatina,24A3592632,02/13/2025,Sale,-80.0,560.0,28,ALLISON,Clam
Agrolatina,24A3592632,02/14/2025,Sale,-160.0,400.0,29,ALLISON,Clam
Agrolatina,24A3592632,02/17/2025,Sale,-80.0,320.0,32,ALLISON,Clam
Agrolatina,24A3592632,02/19/2025,Sale,-160.0,160.0,34,ALLISON,Clam
Agrolatina,24A3592632,02/25/2025,Sale,-80.0,80.0,40,ALLISON,Clam
Agrolatina,24A3592632,02/27/2025,Sale,-80.0,0.0,42,ALLISON,Clam
Agrolatina,24A3594126,03/10/2025,Entry,1280.0,1280.0,0,TIMCO,Clam
Agrolatina,24A3594126,03/10/2025,Entry,320.0,1600.0,0,TIMCO,Clam
Agrolatina,24A3594126,04/01/2025,Sale,-320.0,1280.0,22,TIMCO,Clam
Agrolatina,24A3594126,04/09/2025,Sale,-320.0,960.0,30,TIMCO,Clam
Agrolatina,24A3594126,04/10/2025,Sale,-80.0,880.0,31,TIMCO,Clam
Agrolatina,24A3594126,04/10/2025,Sale,-80.0,800.0,31,TIMCO,Clam
Agrolatina,24A3594126,04/11/2025,Sale,-800.0,0.0,32,TIMCO,Clam
Agrolatina,24A3613972,12/30/2024,Entry,1200.0,1200.0,0,SWEET GLOBE,Clam
Agrolatina,24A3613972,12/30/2024,Entry,320.0,1520.0,0,SWEET GLOBE,Clam
Agrolatina,24A3613972,12/30/2024,Entry,80.0,1600.0,0,SWEET GLOBE,Clam
Agrolatina,24A3613972,01/18/2025,Sale,-80.0,1520.0,19,SWEET GLOBE,Clam
Agrolatina,24A3613972,01/18/2025,Sale,-80.0,1440.0,19,SWEET GLOBE,Clam
Agrolatina,24A3613972,01/19/2025,Sale,-1040.0,400.0,20,SWEET GLOBE,Clam
Agrolatina,24A3613972,01/21/2025,Sale,-240.0,160.0,22,SWEET GLOBE,Clam
Agrolatina,24A3613972,01/22/2025,Sale,-80.0,80.0,23,SWEET GLOBE,Clam
Agrolatina,24A3613972,01/23/2025,Sale,-80.0,0.0,24,SWEET GLOBE,Clam
Agrolatina,24A3627641,02/24/2025,Entry,1040.0,1040.0,0,TIMCO,Clam
Agrolatina,24A3627641,02/24/2025,Entry,560.0,1600.0,0,TIMCO,Clam
Agrolatina,24A3627641,03/10/2025,Sale,-1040.0,560.0,14,TIMCO,Clam
Agrolatina,24A3627641,03/17/2025,Sale,-560.0,0.0,21,TIMCO,Clam
Agrolatina,24A3628231,01/30/2025,Entry,1120.0,1120.0,0,SWEET GLOBE,Clam
Agrolatina,24A3628231,01/30/2025,Entry,480.0,1600.0,0,SWEET GLOBE,Clam
Agrolatina,24A3628231,02/08/2025,Sale,-80.0,1520.0,9,SWEET GLOBE,Clam
Agrolatina,24A3628231,02/08/2025,Sale,-80.0,1440.0,9,SWEET GLOBE,Clam
Agrolatina,24A3628231,02/15/2025,Sale,-80.0,1360.0,16,SWEET GLOBE,Clam
Agrolatina,24A3628231,02/18/2025,Sale,-80.0,1280.0,19,SWEET GLOBE,Clam
Agrolatina,24A3628231,02/19/2025,Sale,-160.0,1120.0,20,SWEET GLOBE,Clam
Agrolatina,24A3628231,02/20/2025,Sale,-240.0,880.0,21,SWEET GLOBE,Clam
Agrolatina,24A3628231,02/20/2025,Sale,-240.0,640.0,21,SWEET GLOBE,Clam
Agrolatina,24A3628231,02/20/2025,Sale,-80.0,560.0,21,SWEET GLOBE,Clam
Agrolatina,24A3628231,02/21/2025,Sale,-80.0,480.0,22,SWEET GLOBE,Clam
Agrolatina,24A3628231,02/26/2025,Sale,-120.0,360.0,27,SWEET GLOBE,Clam
Agrolatina,24A3628231,02/27/2025,Sale,-80.0,280.0,28,SWEET GLOBE,Clam
Agrolatina,24A3628231,02/27/2025,Sale,-20.0,260.0,28,SWEET GLOBE,Clam
Agrolatina,24A3628231,03/01/2025,Sale,-80.0,180.0,30,SWEET GLOBE,Clam
Agrolatina,24A3628231,03/03/2025,Sale,-40.0,140.0,32,SWEET GLOBE,Clam
Agrolatina,24A3628231,03/04/2025,Sale,-5.0,135.0,33,SWEET GLOBE,Clam
Agrolatina,24A3628822,12/31/2024,Entry,640.0,640.0,0,ALLISON,Clam
Agrolatina,24A3628822,12/31/2024,Entry,80.0,720.0,0,ALLISON,Clam
Agrolatina,24A3628822,12/31/2024,Entry,880.0,1600.0,0,ALLISON,Clam
Agrolatina,24A3628822,01/10/2025,Sale,-160.0,1440.0,10,ALLISON,Clam
Agrolatina,24A3628822,01/10/2025,Sale,-480.0,960.0,10,ALLISON,Clam
Agrolatina,24A3628822,01/10/2025,Sale,-80.0,880.0,10,ALLISON,Clam
Agrolatina,24A3628822,01/10/2025,Sale,-800.0,80.0,10,ALLISON,Clam
Agrolatina,24A3628822,01/14/2025,Sale,-80.0,0.0,14,ALLISON,Clam
Agrolatina,24A3630115,12/07/2024,Entry,1360.0,1360.0,0,CANDY SNAP,Clam
Agrolatina,24A3630115,12/07/2024,Entry,240.0,1600.0,0,CANDY SNAP,Clam
Agrolatina,24A3630115,01/18/2025,Sale,-1360.0,240.0,42,CANDY SNAP,Clam
Agrolatina,24A3630115,01/20/2025,Sale,-240.0,0.0,44,CANDY SNAP,Clam
Agrolatina,24A3630922,02/07/2025,Entry,1040.0,1040.0,0,SWEET GLOBE,Clam
Agrolatina,24A3630922,02/07/2025,Entry,560.0,1600.0,0,SWEET GLOBE,Clam
Agrolatina,24A3630922,02/21/2025,Sale,-400.0,1200.0,14,SWEET GLOBE,Clam
Agrolatina,24A3630922,02/21/2025,Sale,-400.0,800.0,14,SWEET GLOBE,Clam
Agrolatina,24A3630922,02/22/2025,Sale,-240.0,560.0,15,SWEET GLOBE,Clam
Agrolatina,24A3630922,02/24/2025,Sale,-160.0,400.0,17,SWEET GLOBE,Clam
Agrolatina,24A3630922,02/25/2025,Sale,-65.0,335.0,18,SWEET GLOBE,Clam
Agrolatina,24A3630922,02/26/2025,Sale,-80.0,255.0,19,SWEET GLOBE,Clam
Agrolatina,24A3630922,02/27/2025,Sale,-40.0,215.0,20,SWEET GLOBE,Clam
Agrolatina,24A3630922,02/27/2025,Sale,-40.0,175.0,20,SWEET GLOBE,Clam
Agrolatina,24A3630922,03/03/2025,Sale,-80.0,95.0,24,SWEET GLOBE,Clam
Agrolatina,24A3631600,01/09/2025,Entry,1200.0,1200.0,0,IVORY,Clam
Agrolatina,24A3631600,01/09/2025,Entry,320.0,1520.0,0,IVORY,Clam
Agrolatina,24A3631600,01/09/2025,Entry,80.0,1600.0,0,IVORY,Clam
Agrolatina,24A3631600,01/18/2025,Sale,-1200.0,400.0,9,IVORY,Clam
Agrolatina,24A3631600,01/20/2025,Sale,-80.0,320.0,11,IVORY,Clam
Agrolatina,24A3631600,01/21/2025,Sale,-320.0,0.0,12,IVORY,Clam
Agrolatina,24A3636026,01/30/2025,Entry,1360.0,1360.0,0,SWEET GLOBE,Clam
Agrolatina,24A3636026,01/30/2025,Entry,240.0,1600.0,0,SWEET GLOBE,Clam
Agrolatina,24A3636026,02/06/2025,Sale,-80.0,1520.0,7,SWEET GLOBE,Clam
Agrolatina,24A3636026,02/06/2025,Sale,-160.0,1360.0,7,SWEET GLOBE,Clam
Agrolatina,24A3636026,02/07/2025,Sale,-80.0,1280.0,8,SWEET GLOBE,Clam
Agrolatina,24A3636026,02/08/2025,Sale,-80.0,1200.0,9,SWEET GLOBE,Clam
Agrolatina,24A3636026,02/10/2025,Sale,-240.0,960.0,11,SWEET GLOBE,Clam
Agrolatina,24A3636026,02/10/2025,Sale,-80.0,880.0,11,SWEET GLOBE,Clam
Agrolatina,24A3636026,02/11/2025,Sale,-160.0,720.0,12,SWEET GLOBE,Clam
Agrolatina,24A3636026,02/15/2025,Sale,-80.0,640.0,16,SWEET GLOBE,Clam
Agrolatina,24A3636026,02/19/2025,Sale,-80.0,560.0,20,SWEET GLOBE,Clam
Agrolatina,24A3636026,02/19/2025,Sale,-160.0,400.0,20,SWEET GLOBE,Clam
Agrolatina,24A3636026,02/20/2025,Sale,-80.0,320.0,21,SWEET GLOBE,Clam
Agrolatina,24A3636026,02/20/2025,Sale,-80.0,240.0,21,SWEET GLOBE,Clam
Agrolatina,24A3636026,03/05/2025,Sale,-80.0,160.0,34,SWEET GLOBE,Clam
Agrolatina,24A3636026,03/06/2025,Sale,-40.0,120.0,35,SWEET GLOBE,Clam
Agrolatina,24A3637070,03/03/2025,Entry,1440.0,1440.0,0,TIMCO,Clam
Agrolatina,24A3637070,03/03/2025,Entry,160.0,1600.0,0,TIMCO,Clam
Agrolatina,24A3637070,03/24/2025,Sale,-80.0,1520.0,21,TIMCO,Clam
Agrolatina,24A3637070,03/25/2025,Sale,-80.0,1440.0,22,TIMCO,Clam
Agrolatina,24A3637070,03/28/2025,Sale,-1040.0,400.0,25,TIMCO,Clam
Agrolatina,24A3637070,03/28/2025,Sale,-160.0,240.0,25,TIMCO,Clam
Agrolatina,24A3637070,03/28/2025,Sale,-160.0,80.0,25,TIMCO,Clam
Agrolatina,24A3637070,03/29/2025,Sale,-80.0,0.0,26,TIMCO,Clam
Agrolatina,24A3640659,03/13/2025,Entry,240.0,240.0,0,AUTUMN CRISP,Clam
Agrolatina,24A3640659,03/13/2025,Entry,1360.0,1600.0,0,AUTUMN CRISP,Clam
Agrolatina,24A3640659,03/19/2025,Sale,-240.0,1360.0,6,AUTUMN CRISP,Clam
Agrolatina,24A3640659,03/21/2025,Sale,-1.0,1359.0,8,AUTUMN CRISP,Clam
Agrolatina,24A3640659,03/28/2025,Sale,-160.0,1199.0,15,AUTUMN CRISP,Clam
Agrolatina,24A3640659,03/29/2025,Sale,-240.0,959.0,16,AUTUMN CRISP,Clam
Agrolatina,24A3640659,03/29/2025,Sale,-240.0,719.0,16,AUTUMN CRISP,Clam
Agrolatina,24A3640659,04/01/2025,Sale,-319.0,400.0,19,AUTUMN CRISP,Clam
Agrolatina,24A3640659,04/01/2025,Sale,-320.0,80.0,19,AUTUMN CRISP,Clam
Agrolatina,24A3652789,03/10/2025,Entry,80.0,80.0,0,AUTUMN CRISP,Clam
Agrolatina,24A3652789,03/10/2025,Entry,1520.0,1600.0,0,AUTUMN CRISP,Clam
Agrolatina,24A3652789,03/19/2025,Sale,-80.0,1520.0,9,AUTUMN CRISP,Clam
Agrolatina,24A3652789,03/19/2025,Sale,-80.0,1440.0,9,AUTUMN CRISP,Clam
Agrolatina,24A3652789,03/19/2025,Sale,-480.0,960.0,9,AUTUMN CRISP,Clam
Agrolatina,24A3652789,03/19/2025,Sale,-960.0,0.0,9,AUTUMN CRISP,Clam
Agrolatina,24A3655366,02/07/2025,Entry,1120.0,1120.0,0,SWEET GLOBE,Clam
Agrolatina,24A3655366,02/07/2025,Entry,480.0,1600.0,0,SWEET GLOBE,Clam
Agrolatina,24A3655366,02/19/2025,Sale,-480.0,1120.0,12,SWEET GLOBE,Clam
Agrolatina,24A3655366,02/19/2025,Sale,-320.0,800.0,12,SWEET GLOBE,Clam
Agrolatina,24A3655366,02/24/2025,Sale,-80.0,720.0,17,SWEET GLOBE,Clam
Agrolatina,24A3655366,02/27/2025,Sale,-120.0,600.0,20,SWEET GLOBE,Clam
Agrolatina,24A3655366,03/01/2025,Sale,-240.0,360.0,22,SWEET GLOBE,Clam
Agrolatina,24A3655366,03/03/2025,Sale,-80.0,280.0,24,SWEET GLOBE,Clam
Agrolatina,24A3655366,03/04/2025,Sale,-40.0,240.0,25,SWEET GLOBE,Clam
Agrolatina,24A3655366,03/11/2025,Sale,-140.0,100.0,32,SWEET GLOBE,Clam
Agrolatina,24A3665240,12/31/2024,Entry,1600.0,1600.0,0,ALLISON,Clam
Agrolatina,24A3665240,01/15/2025,Sale,-80.0,1520.0,15,ALLISON,Clam
Agrolatina,24A3665240,01/15/2025,Sale,-480.0,1040.0,15,ALLISON,Clam
Agrolatina,24A3665240,01/15/2025,Sale,-1040.0,0.0,15,ALLISON,Clam
Agrolatina,24A3677010,02/20/2025,Entry,1200.0,1200.0,0,IVORY,Clam
Agrolatina,24A3677010,02/20/2025,Entry,240.0,1440.0,0,IVORY,Clam
Agrolatina,24A3677010,02/20/2025,Entry,160.0,1600.0,0,IVORY,Clam
Agrolatina,24A3677010,02/25/2025,Sale,-320.0,1280.0,5,IVORY,Clam
Agrolatina,24A3677010,02/25/2025,Sale,-160.0,1120.0,5,IVORY,Clam
Agrolatina,24A3677010,02/26/2025,Sale,-320.0,800.0,6,IVORY,Clam
Agrolatina,24A3677010,02/26/2025,Sale,-480.0,320.0,6,IVORY,Clam
Agrolatina,24A3677010,02/26/2025,Sale,-80.0,240.0,6,IVORY,Clam
Agrolatina,24A3677010,02/26/2025,Sale,-80.0,160.0,6,IVORY,Clam
Agrolatina,24A3677010,03/29/2025,Sale,-40.0,120.0,37,IVORY,Clam
Agrolatina,24A3677010,04/01/2025,Sale,-35.0,85.0,40,IVORY,Clam
Agrolatina,24A3691131,02/03/2025,Entry,480.0,480.0,0,CANDY DREAMS,Clam
Agrolatina,24A3691131,02/03/2025,Entry,1120.0,1600.0,0,CANDY DREAMS,Clam
Agrolatina,24A3691131,02/08/2025,Sale,-80.0,1520.0,5,CANDY DREAMS,Clam
Agrolatina,24A3691131,02/10/2025,Sale,-80.0,1440.0,7,CANDY DREAMS,Clam
Agrolatina,24A3691131,02/10/2025,Sale,-160.0,1280.0,7,CANDY DREAMS,Clam
Agrolatina,24A3691131,02/11/2025,Sale,-80.0,1200.0,8,CANDY DREAMS,Clam
Agrolatina,24A3691131,02/13/2025,Sale,-80.0,1120.0,10,CANDY DREAMS,Clam
Agrolatina,24A3691131,02/17/2025,Sale,-80.0,1040.0,14,CANDY DREAMS,Clam
Agrolatina,24A3691131,02/18/2025,Sale,-80.0,960.0,15,CANDY DREAMS,Clam
Agrolatina,24A3691131,02/18/2025,Sale,-160.0,800.0,15,CANDY DREAMS,Clam
Agrolatina,24A3691131,02/19/2025,Sale,-80.0,720.0,16,CANDY DREAMS,Clam
Agrolatina,24A3691131,02/19/2025,Sale,-80.0,640.0,16,CANDY DREAMS,Clam
Agrolatina,24A3691131,02/20/2025,Sale,-80.0,560.0,17,CANDY DREAMS,Clam
Agrolatina,24A3691131,02/20/2025,Sale,-320.0,240.0,17,CANDY DREAMS,Clam
Agrolatina,24A3691131,02/25/2025,Sale,-40.0,200.0,22,CANDY DREAMS,Clam
Agrolatina,24A3691131,02/25/2025,Sale,-160.0,40.0,22,CANDY DREAMS,Clam
Agrolatina,24A3691131,02/26/2025,Sale,-20.0,20.0,23,CANDY DREAMS,Clam
Agrolatina,24A3693730,02/24/2025,Entry,1200.0,1200.0,0,IVORY,Clam
Agrolatina,24A3693730,02/24/2025,Entry,160.0,1360.0,0,IVORY,Clam
Agrolatina,24A3693730,02/24/2025,Entry,80.0,1440.0,0,SWEET GLOBE,Clam
Agrolatina,24A3693730,02/24/2025,Entry,160.0,1600.0,0,SWEET GLOBE,Clam
Agrolatina,24A3693730,03/11/2025,Sale,-40.0,1560.0,15,SWEET GLOBE,Clam
Agrolatina,24A3693730,03/14/2025,Sale,-40.0,1520.0,18,SWEET GLOBE,Clam
Agrolatina,24A3693730,03/14/2025,Sale,-60.0,1460.0,18,SWEET GLOBE,Clam
Agrolatina,24A3693730,03/22/2025,Sale,-160.0,1300.0,26,IVORY,Clam
Agrolatina,24A3693730,03/22/2025,Sale,-180.0,1120.0,26,IVORY,Clam
Agrolatina,24A3693730,03/22/2025,Sale,-120.0,1000.0,26,IVORY,Clam
Agrolatina,24A3693730,03/22/2025,Sale,-240.0,760.0,26,IVORY,Clam
Agrolatina,24A3693730,03/22/2025,Sale,-80.0,680.0,26,IVORY,Clam
Agrolatina,24A3693730,03/22/2025,Sale,-160.0,520.0,26,IVORY,Clam
Agrolatina,24A3693730,03/28/2025,Sale,-40.0,480.0,32,IVORY,Clam
Agrolatina,24A3693730,03/29/2025,Sale,-25.0,455.0,33,IVORY,Clam
Agrolatina,24A3717597,03/10/2025,Entry,80.0,80.0,0,AUTUMN CRISP,Clam
Agrolatina,24A3717597,03/10/2025,Entry,1520.0,1600.0,0,AUTUMN CRISP,Clam
Agrolatina,24A3717597,03/17/2025,Sale,-320.0,1280.0,7,AUTUMN CRISP,Clam
Agrolatina,24A3717597,03/19/2025,Sale,-80.0,1200.0,9,AUTUMN CRISP,Clam
Agrolatina,24A3717597,03/19/2025,Sale,-400.0,800.0,9,AUTUMN CRISP,Clam
Agrolatina,24A3717597,03/19/2025,Sale,-320.0,480.0,9,AUTUMN CRISP,Clam
Agrolatina,24A3717597,03/19/2025,Sale,-80.0,400.0,9,AUTUMN CRISP,Clam
Agrolatina,24A3717597,03/19/2025,Sale,-400.0,0.0,9,AUTUMN CRISP,Clam
Agrolatina,24A3720651,02/13/2025,Entry,480.0,480.0,0,SWEET GLOBE,Clam
Agrolatina,24A3720651,02/13/2025,Entry,1120.0,1600.0,0,SWEET GLOBE,Clam
Agrolatina,24A3720651,02/19/2025,Sale,-400.0,1200.0,6,SWEET GLOBE,Clam
Agrolatina,24A3720651,02/21/2025,Sale,-80.0,1120.0,8,SWEET GLOBE,Clam
Agrolatina,24A3720651,02/26/2025,Sale,-80.0,1040.0,13,SWEET GLOBE,Clam
Agrolatina,24A3720651,02/26/2025,Sale,-80.0,960.0,13,SWEET GLOBE,Clam
Agrolatina,24A3720651,02/27/2025,Sale,-15.0,945.0,14,SWEET GLOBE,Clam
Agrolatina,24A3720651,02/27/2025,Sale,-70.0,875.0,14,SWEET GLOBE,Clam
Agrolatina,24A3720651,02/28/2025,Sale,-80.0,795.0,15,SWEET GLOBE,Clam
Agrolatina,24A3720651,03/05/2025,Sale,-47.0,748.0,20,SWEET GLOBE,Clam
Agrolatina,24A3720651,03/06/2025,Sale,-240.0,508.0,21,SWEET GLOBE,Clam
Agrolatina,24A3720651,03/06/2025,Sale,-80.0,428.0,21,SWEET GLOBE,Clam
Agrolatina,24A3720651,03/15/2025,Sale,-40.0,388.0,30,SWEET GLOBE,Clam
Agrolatina,24A3734589,12/31/2024,Entry,1040.0,1040.0,0,ALLISON,Clam
Agrolatina,24A3734589,12/31/2024,Entry,560.0,1600.0,0,ALLISON,Clam
Agrolatina,24A3734589,01/14/2025,Sale,-480.0,1120.0,14,ALLISON,Clam
Agrolatina,24A3734589,01/14/2025,Sale,-480.0,640.0,14,ALLISON,Clam
Agrolatina,24A3734589,01/14/2025,Sale,-160.0,480.0,14,ALLISON,Clam
Agrolatina,24A3734589,01/16/2025,Sale,-80.0,400.0,16,ALLISON,Clam
Agrolatina,24A3734589,01/17/2025,Sale,-400.0,0.0,17,ALLISON,Clam
Agrolatina,24A3753830,02/20/2025,Entry,880.0,880.0,0,SWEET GLOBE,Clam
Agrolatina,24A3753830,02/20/2025,Entry,720.0,1600.0,0,SWEET GLOBE,Clam
Agrolatina,24A3753830,02/28/2025,Sale,-80.0,1520.0,8,SWEET GLOBE,Clam
Agrolatina,24A3753830,03/01/2025,Sale,-160.0,1360.0,9,SWEET GLOBE,Clam
Agrolatina,24A3753830,03/03/2025,Sale,-640.0,720.0,11,SWEET GLOBE,Clam
Agrolatina,24A3753830,03/05/2025,Sale,-40.0,680.0,13,SWEET GLOBE,Clam
Agrolatina,24A3753830,03/06/2025,Sale,-140.0,540.0,14,SWEET GLOBE,Clam
Agrolatina,24A3753830,03/10/2025,Sale,-40.0,500.0,18,SWEET GLOBE,Clam
Agrolatina,24A3753830,03/10/2025,Sale,-300.0,200.0,18,SWEET GLOBE,Clam
Agrolatina,24A3753830,03/15/2025,Sale,-60.0,140.0,23,SWEET GLOBE,Clam
Agrolatina,24A3755112,03/03/2025,Entry,880.0,880.0,0,IVORY,Clam
Agrolatina,24A3755112,03/03/2025,Entry,720.0,1600.0,0,IVORY,Clam
Agrolatina,24A3755112,03/14/2025,Sale,-480.0,1120.0,11,IVORY,Clam
Agrolatina,24A3755112,03/15/2025,Sale,-160.0,960.0,12,IVORY,Clam
Agrolatina,24A3755112,03/15/2025,Sale,-80.0,880.0,12,IVORY,Clam
Agrolatina,24A3755112,03/25/2025,Sale,-40.0,840.0,22,IVORY,Clam
Agrolatina,24A3755112,03/27/2025,Sale,-80.0,760.0,24,IVORY,Clam
Agrolatina,24A3755112,03/29/2025,Sale,-80.0,680.0,26,IVORY,Clam
Agrolatina,24A3755112,03/29/2025,Sale,-40.0,640.0,26,IVORY,Clam
Agrolatina,24A3755112,04/02/2025,Sale,-240.0,400.0,30,IVORY,Clam
Agrolatina,24A3755112,04/02/2025,Sale,-48.0,352.0,30,IVORY,Clam
Agrolatina,24A3755112,04/02/2025,Sale,-120.0,232.0,30,IVORY,Clam
Agrolatina,24A3767108,01/28/2025,Entry,1120.0,1120.0,0,CANDY SNAP,Clam
Agrolatina,24A3767108,01/28/2025,Entry,480.0,1600.0,0,CANDY SNAP,Clam
Agrolatina,24A3767108,02/12/2025,Sale,-640.0,960.0,15,CANDY SNAP,Clam
Agrolatina,24A3767108,02/13/2025,Sale,-80.0,880.0,16,CANDY SNAP,Clam
Agrolatina,24A3767108,02/17/2025,Sale,-240.0,640.0,20,CANDY SNAP,Clam
Agrolatina,24A3767108,02/17/2025,Sale,-480.0,160.0,20,CANDY SNAP,Clam
Agrolatina,24A3767108,03/06/2025,Sale,-50.0,110.0,37,CANDY SNAP,Clam
Agrolatina,24A3767514,01/09/2025,Entry,1120.0,1120.0,0,IVORY,Clam
Agrolatina,24A3767514,01/09/2025,Entry,480.0,1600.0,0,IVORY,Clam
Agrolatina,24A3767514,01/18/2025,Sale,-1120.0,480.0,9,IVORY,Clam
Agrolatina,24A3767514,01/21/2025,Sale,-480.0,0.0,12,IVORY,Clam
Agrolatina,24A3785776,02/03/2025,Entry,1360.0,1360.0,0,SWEET GLOBE,Clam
Agrolatina,24A3785776,02/03/2025,Entry,240.0,1600.0,0,SWEET GLOBE,Clam
Agrolatina,24A3785776,02/14/2025,Sale,-320.0,1280.0,11,SWEET GLOBE,Clam
Agrolatina,24A3785776,02/15/2025,Sale,-80.0,1200.0,12,SWEET GLOBE,Clam
Agrolatina,24A3785776,02/17/2025,Sale,-160.0,1040.0,14,SWEET GLOBE,Clam
Agrolatina,24A3785776,02/17/2025,Sale,-160.0,880.0,14,SWEET GLOBE,Clam
Agrolatina,24A3785776,02/18/2025,Sale,-160.0,720.0,15,SWEET GLOBE,Clam
Agrolatina,24A3785776,02/28/2025,Sale,-240.0,480.0,25,SWEET GLOBE,Clam
Agrolatina,24A3785776,02/28/2025,Sale,-200.0,280.0,25,SWEET GLOBE,Clam
Agrolatina,24A3785776,03/05/2025,Sale,-40.0,240.0,30,SWEET GLOBE,Clam
Agrolatina,24A3786108,12/07/2024,Entry,1520.0,1520.0,0,CANDY SNAP,Clam
Agrolatina,24A3786108,12/07/2024,Entry,80.0,1600.0,0,CANDY SNAP,Clam
Agrolatina,24A3786108,01/06/2025,Sale,-1360.0,240.0,30,CANDY SNAP,Clam
Agrolatina,24A3786108,01/06/2025,Sale,-80.0,160.0,30,CANDY SNAP,Clam
Agrolatina,24A3786108,01/07/2025,Sale,-160.0,0.0,31,CANDY SNAP,Clam
Agrolatina,24A3809965,02/24/2025,Entry,560.0,560.0,0,AUTUMN CRISP,Clam
Agrolatina,24A3809965,02/24/2025,Entry,1040.0,1600.0,0,AUTUMN CRISP,Clam
Agrolatina,24A3814719,02/27/2025,Entry,1440.0,1440.0,0,IVORY,Clam
Agrolatina,24A3814719,02/27/2025,Entry,160.0,1600.0,0,IVORY,Clam
Agrolatina,24A3814719,03/01/2025,Sale,-240.0,1360.0,2,IVORY,Clam
Agrolatina,24A3814719,03/04/2025,Sale,-160.0,1200.0,5,IVORY,Clam
Agrolatina,24A3814719,03/04/2025,Sale,-80.0,1120.0,5,IVORY,Clam
Agrolatina,24A3814719,03/21/2025,Sale,-80.0,1040.0,22,IVORY,Clam
Agrolatina,24A3814719,03/22/2025,Sale,-40.0,1000.0,23,IVORY,Clam
Agrolatina,24A3814719,03/22/2025,Sale,-160.0,840.0,23,IVORY,Clam
Agrolatina,24A3814719,03/22/2025,Sale,-20.0,820.0,23,IVORY,Clam
Agrolatina,24A3814719,03/25/2025,Sale,-160.0,660.0,26,IVORY,Clam
Agrolatina,24A3814719,03/25/2025,Sale,-61.0,599.0,26,IVORY,Clam
Agrolatina,24A3814719,03/26/2025,Sale,-160.0,439.0,27,IVORY,Clam
Agrolatina,24A3814719,03/27/2025,Sale,-60.0,379.0,28,IVORY,Clam
Agrolatina,24A3817425,01/09/2025,Entry,1200.0,1200.0,0,SWEET GLOBE,Clam
Agrolatina,24A3817425,01/09/2025,Entry,80.0,1280.0,0,SWEET GLOBE,Clam
Agrolatina,24A3817425,01/09/2025,Entry,320.0,1600.0,0,SWEET GLOBE,Clam
Agrolatina,24A3817425,01/16/2025,Sale,-80.0,1520.0,7,SWEET GLOBE,Clam
Agrolatina,24A3817425,01/17/2025,Sale,-480.0,1040.0,8,SWEET GLOBE,Clam
Agrolatina,24A3817425,01/21/2025,Sale,-320.0,720.0,12,SWEET GLOBE,Clam
Agrolatina,24A3817425,01/29/2025,Sale,-80.0,640.0,20,SWEET GLOBE,Clam
Agrolatina,24A3817425,01/30/2025,Sale,-80.0,560.0,21,SWEET GLOBE,Clam
Agrolatina,24A3817425,01/30/2025,Sale,-480.0,80.0,21,SWEET GLOBE,Clam
Agrolatina,24A3817425,01/31/2025,Sale,-80.0,0.0,22,SWEET GLOBE,Clam
Agrolatina,24A3827969,02/20/2025,Entry,720.0,720.0,0,SWEET GLOBE,Clam
Agrolatina,24A3827969,02/20/2025,Entry,880.0,1600.0,0,SWEET GLOBE,Clam
Agrolatina,24A3827969,03/03/2025,Sale,-80.0,1520.0,11,SWEET GLOBE,Clam
Agrolatina,24A3827969,03/03/2025,Sale,-480.0,1040.0,11,SWEET GLOBE,Clam
Agrolatina,24A3827969,03/04/2025,Sale,-140.0,900.0,12,SWEET GLOBE,Clam
Agrolatina,24A3827969,03/06/2025,Sale,-80.0,820.0,14,SWEET GLOBE,Clam
Agrolatina,24A3827969,03/10/2025,Sale,-40.0,780.0,18,SWEET GLOBE,Clam
Agrolatina,24A3827969,03/11/2025,Sale,-220.0,560.0,19,SWEET GLOBE,Clam
Agrolatina,24A3827969,03/11/2025,Sale,-20.0,540.0,19,SWEET GLOBE,Clam
Agrolatina,24A3827969,03/11/2025,Sale,-10.0,530.0,19,SWEET GLOBE,Clam
Agrolatina,24A3827969,03/12/2025,Sale,-10.0,520.0,20,SWEET GLOBE,Clam
Agrolatina,24A3827969,03/14/2025,Sale,-40.0,480.0,22,SWEET GLOBE,Clam
Agrolatina,24A3827969,03/14/2025,Sale,-20.0,460.0,22,SWEET GLOBE,Clam
Agrolatina,24A3827969,03/15/2025,Sale,-30.0,430.0,23,SWEET GLOBE,Clam
Agrolatina,24A3827969,03/15/2025,Sale,-40.0,390.0,23,SWEET GLOBE,Clam
Agrolatina,24A3827969,03/17/2025,Sale,-80.0,310.0,25,SWEET GLOBE,Clam
Agrolatina,24A3829811,12/26/2024,Entry,1120.0,1120.0,0,CANDY SNAP,Clam
Agrolatina,24A3829811,12/26/2024,Entry,480.0,1600.0,0,CANDY SNAP,Clam
Agrolatina,24A3829811,01/02/2025,Sale,-160.0,1440.0,7,CANDY SNAP,Clam
Agrolatina,24A3829811,01/02/2025,Sale,-160.0,1280.0,7,CANDY SNAP,Clam
Agrolatina,24A3829811,01/03/2025,Sale,-1120.0,160.0,8,CANDY SNAP,Clam
Agrolatina,24A3829811,01/03/2025,Sale,-160.0,0.0,8,CANDY SNAP,Clam
Agrolatina,24A3838238,12/30/2024,Entry,1600.0,1600.0,0,ALLISON,Clam
Agrolatina,24A3838238,01/18/2025,Sale,-400.0,1200.0,19,ALLISON,Clam
Agrolatina,24A3838238,01/18/2025,Sale,-1200.0,0.0,19,ALLISON,Clam
Agrolatina,24A3838454,01/16/2025,Entry,1200.0,1200.0,0,SWEET GLOBE,Clam
Agrolatina,24A3838454,01/16/2025,Entry,400.0,1600.0,0,SWEET GLOBE,Clam
Agrolatina,24A3838454,02/04/2025,Sale,-160.0,1440.0,19,SWEET GLOBE,Clam
Agrolatina,24A3838454,02/05/2025,Sale,-80.0,1360.0,20,SWEET GLOBE,Clam
Agrolatina,24A3838454,02/05/2025,Sale,-249.0,1111.0,20,SWEET GLOBE,Clam
Agrolatina,24A3838454,02/05/2025,Sale,-80.0,1031.0,20,SWEET GLOBE,Clam
Agrolatina,24A3838454,02/05/2025,Sale,-80.0,951.0,20,SWEET GLOBE,Clam
Agrolatina,24A3838454,02/05/2025,Sale,-80.0,871.0,20,SWEET GLOBE,Clam
Agrolatina,24A3838454,02/06/2025,Sale,-80.0,791.0,21,SWEET GLOBE,Clam
Agrolatina,24A3838454,02/06/2025,Sale,-80.0,711.0,21,SWEET GLOBE,Clam
Agrolatina,24A3838454,02/06/2025,Sale,-240.0,471.0,21,SWEET GLOBE,Clam
Agrolatina,24A3838454,02/07/2025,Sale,-160.0,311.0,22,SWEET GLOBE,Clam
Agrolatina,24A3838454,02/07/2025,Sale,-66.0,245.0,22,SWEET GLOBE,Clam
Agrolatina,24A3838454,02/08/2025,Sale,-80.0,165.0,23,SWEET GLOBE,Clam
Agrolatina,24A3838454,02/12/2025,Sale,-160.0,5.0,27,SWEET GLOBE,Clam
Agrolatina,24A3838454,02/13/2025,Sale,-80.0,-75.0,28,SWEET GLOBE,Clam
Agrolatina,24A3849377,02/11/2025,Entry,1425.0,1425.0,0,SWEET GLOBE,Bag
Agrolatina,24A3849377,02/11/2025,Entry,475.0,1900.0,0,SWEET GLOBE,Bag
Agrolatina,24A3849377,02/14/2025,Sale,-95.0,1805.0,3,SWEET GLOBE,Bag
Agrolatina,24A3849377,02/14/2025,Sale,-380.0,1425.0,3,SWEET GLOBE,Bag
Agrolatina,24A3849377,02/25/2025,Sale,-475.0,950.0,14,SWEET GLOBE,Bag
Agrolatina,24A3849377,03/18/2025,Sale,-285.0,665.0,35,SWEET GLOBE,Bag
Agrolatina,24A3849377,03/21/2025,Sale,-285.0,380.0,38,SWEET GLOBE,Bag
Agrolatina,24A3849377,03/25/2025,Sale,-190.0,190.0,42,SWEET GLOBE,Bag
Agrolatina,24A3854394,12/26/2024,Entry,960.0,960.0,0,ALLISON,Clam
Agrolatina,24A3854394,12/26/2024,Entry,640.0,1600.0,0,ALLISON,Clam
Agrolatina,24A3854394,01/06/2025,Sale,-240.0,1360.0,11,ALLISON,Clam
Agrolatina,24A3854394,01/07/2025,Sale,-240.0,1120.0,12,ALLISON,Clam
Agrolatina,24A3854394,01/07/2025,Sale,-720.0,400.0,12,ALLISON,Clam
Agrolatina,24A3854394,01/07/2025,Sale,-400.0,0.0,12,ALLISON,Clam
Agrolatina,24A3859647,02/03/2025,Entry,1120.0,1120.0,0,SWEET GLOBE,Clam
Agrolatina,24A3859647,02/03/2025,Entry,480.0,1600.0,0,SWEET GLOBE,Clam
Agrolatina,24A3859647,02/10/2025,Sale,-80.0,1520.0,7,SWEET GLOBE,Clam
Agrolatina,24A3859647,02/11/2025,Sale,-160.0,1360.0,8,SWEET GLOBE,Clam
Agrolatina,24A3859647,02/14/2025,Sale,-160.0,1200.0,11,SWEET GLOBE,Clam
Agrolatina,24A3859647,02/15/2025,Sale,-80.0,1120.0,12,SWEET GLOBE,Clam
Agrolatina,24A3859647,02/17/2025,Sale,-80.0,1040.0,14,SWEET GLOBE,Clam
Agrolatina,24A3859647,02/18/2025,Sale,-80.0,960.0,15,SWEET GLOBE,Clam
Agrolatina,24A3859647,02/18/2025,Sale,-160.0,800.0,15,SWEET GLOBE,Clam
Agrolatina,24A3859647,02/24/2025,Sale,-200.0,600.0,21,SWEET GLOBE,Clam
Agrolatina,24A3859647,02/26/2025,Sale,-44.0,556.0,23,SWEET GLOBE,Clam
Agrolatina,24A3859647,02/28/2025,Sale,-60.0,496.0,25,SWEET GLOBE,Clam
Agrolatina,24A3859647,03/03/2025,Sale,-40.0,456.0,28,SWEET GLOBE,Clam
Agrolatina,24A3859647,03/05/2025,Sale,-40.0,416.0,30,SWEET GLOBE,Clam
Agrolatina,24A3859647,03/12/2025,Sale,-40.0,376.0,37,SWEET GLOBE,Clam
Agrolatina,24A3872084,02/03/2025,Entry,960.0,960.0,0,SWEET GLOBE,Clam
Agrolatina,24A3872084,02/03/2025,Entry,640.0,1600.0,0,SWEET GLOBE,Clam
Agrolatina,24A3872084,02/18/2025,Sale,-80.0,1520.0,15,SWEET GLOBE,Clam
Agrolatina,24A3872084,02/19/2025,Sale,-80.0,1440.0,16,SWEET GLOBE,Clam
Agrolatina,24A3872084,02/20/2025,Sale,-240.0,1200.0,17,SWEET GLOBE,Clam
Agrolatina,24A3872084,02/20/2025,Sale,-80.0,1120.0,17,SWEET GLOBE,Clam
Agrolatina,24A3872084,02/22/2025,Sale,-320.0,800.0,19,SWEET GLOBE,Clam
Agrolatina,24A3872084,02/22/2025,Sale,-160.0,640.0,19,SWEET GLOBE,Clam
Agrolatina,24A3872084,02/26/2025,Sale,-50.0,590.0,23,SWEET GLOBE,Clam
Agrolatina,24A3872084,02/27/2025,Sale,-10.0,580.0,24,SWEET GLOBE,Clam
Agrolatina,24A3872084,03/05/2025,Sale,-400.0,180.0,30,SWEET GLOBE,Clam
Agrolatina,24A3872084,03/10/2025,Sale,-40.0,140.0,35,SWEET GLOBE,Clam
Agrolatina,24A3872084,03/11/2025,Sale,-10.0,130.0,36,SWEET GLOBE,Clam
Agrolatina,24A3872084,03/12/2025,Sale,-10.0,120.0,37,SWEET GLOBE,Clam
Agrolatina,24A3874045,02/20/2025,Entry,1040.0,1040.0,0,IVORY,Clam
Agrolatina,24A3874045,02/20/2025,Entry,560.0,1600.0,0,IVORY,Clam
Agrolatina,24A3874045,02/25/2025,Sale,-80.0,1520.0,5,IVORY,Clam
Agrolatina,24A3874045,02/25/2025,Sale,-480.0,1040.0,5,IVORY,Clam
Agrolatina,24A3874045,03/19/2025,Sale,-97.0,943.0,27,IVORY,Clam
Agrolatina,24A3874045,03/19/2025,Sale,-240.0,703.0,27,IVORY,Clam
Agrolatina,24A3874045,03/21/2025,Sale,-80.0,623.0,29,IVORY,Clam
Agrolatina,24A3874045,03/22/2025,Sale,-40.0,583.0,30,IVORY,Clam
Agrolatina,24A3874045,03/22/2025,Sale,-80.0,503.0,30,IVORY,Clam
Agrolatina,24A3874045,03/22/2025,Sale,-60.0,443.0,30,IVORY,Clam
Agrolatina,24A3874045,03/29/2025,Sale,-60.0,383.0,37,IVORY,Clam
Agrolatina,24A3878333,01/02/2025,Entry,1360.0,1360.0,0,CANDY SNAP,Clam
Agrolatina,24A3878333,01/02/2025,Entry,240.0,1600.0,0,CANDY SNAP,Clam
Agrolatina,24A3878333,01/17/2025,Sale,-560.0,1040.0,15,CANDY SNAP,Clam
Agrolatina,24A3878333,01/18/2025,Sale,-80.0,960.0,16,CANDY SNAP,Clam
Agrolatina,24A3878333,01/18/2025,Sale,-480.0,480.0,16,CANDY SNAP,Clam
Agrolatina,24A3878333,01/18/2025,Sale,-240.0,240.0,16,CANDY SNAP,Clam
Agrolatina,24A3878333,01/21/2025,Sale,-80.0,160.0,19,CANDY SNAP,Clam
Agrolatina,24A3878333,01/21/2025,Sale,-160.0,0.0,19,CANDY SNAP,Clam
Agrolatina,24A3885142,02/24/2025,Entry,160.0,160.0,0,TIMCO,Clam
Agrolatina,24A3885142,02/24/2025,Entry,1440.0,1600.0,0,TIMCO,Clam
Agrolatina,24A3885142,04/04/2025,Sale,-1440.0,160.0,39,TIMCO,Clam
Agrolatina,24A3895407,12/31/2024,Entry,1360.0,1360.0,0,CANDY SNAP,Clam
Agrolatina,24A3895407,12/31/2024,Entry,240.0,1600.0,0,CANDY SNAP,Clam
Agrolatina,24A3895407,01/10/2025,Sale,-480.0,1120.0,10,CANDY SNAP,Clam
Agrolatina,24A3895407,01/10/2025,Sale,-880.0,240.0,10,CANDY SNAP,Clam
Agrolatina,24A3895407,01/14/2025,Sale,-80.0,160.0,14,CANDY SNAP,Clam
Agrolatina,24A3895407,01/14/2025,Sale,-160.0,0.0,14,CANDY SNAP,Clam
Agrolatina,24A3899803,01/16/2025,Entry,1520.0,1520.0,0,ALLISON,Clam
Agrolatina,24A3899803,01/16/2025,Entry,80.0,1600.0,0,ALLISON,Clam
Agrolatina,24A3899803,02/03/2025,Sale,-320.0,1280.0,18,ALLISON,Clam
Agrolatina,24A3899803,02/04/2025,Sale,-80.0,1200.0,19,ALLISON,Clam
Agrolatina,24A3899803,02/04/2025,Sale,-320.0,880.0,19,ALLISON,Clam
Agrolatina,24A3899803,02/05/2025,Sale,-80.0,800.0,20,ALLISON,Clam
Agrolatina,24A3899803,02/07/2025,Sale,-80.0,720.0,22,ALLISON,Clam
Agrolatina,24A3899803,02/11/2025,Sale,-160.0,560.0,26,ALLISON,Clam
Agrolatina,24A3899803,02/13/2025,Sale,-240.0,320.0,28,ALLISON,Clam
Agrolatina,24A3899803,02/19/2025,Sale,-160.0,160.0,34,ALLISON,Clam
Agrolatina,24A3899803,02/27/2025,Sale,-80.0,80.0,42,ALLISON,Clam
Agrolatina,24A3899803,03/04/2025,Sale,-80.0,0.0,47,ALLISON,Clam
Agrolatina,24A3923319,02/24/2025,Entry,640.0,640.0,0,AUTUMN CRISP,Clam
Agrolatina,24A3923319,02/24/2025,Entry,960.0,1600.0,0,AUTUMN CRISP,Clam
Agrolatina,24A3923319,04/04/2025,Sale,-420.0,1180.0,39,AUTUMN CRISP,Clam
Agrolatina,24A3923319,04/04/2025,Sale,-712.0,468.0,39,AUTUMN CRISP,Clam
Agrolatina,24A3925311,02/20/2025,Entry,1045.0,1045.0,0,COTTON CANDY,Bag
Agrolatina,24A3925311,02/20/2025,Entry,855.0,1900.0,0,COTTON CANDY,Bag
Agrolatina,24A3925311,02/28/2025,Sale,-810.0,1090.0,8,COTTON CANDY,Bag
Agrolatina,24A3925311,03/04/2025,Sale,-190.0,900.0,12,COTTON CANDY,Bag
Agrolatina,24A3925311,03/04/2025,Sale,-285.0,615.0,12,COTTON CANDY,Bag
Agrolatina,24A3925311,03/08/2025,Sale,-95.0,520.0,16,COTTON CANDY,Bag
Agrolatina,24A3925311,03/08/2025,Sale,-95.0,425.0,16,COTTON CANDY,Bag
Agrolatina,24A3925311,03/10/2025,Sale,-61.0,364.0,18,COTTON CANDY,Bag
Agrolatina,24A3925311,04/03/2025,Sale,-35.0,329.0,42,COTTON CANDY,Bag
Agrolatina,24A3938387,12/30/2024,Entry,1520.0,1520.0,0,CANDY SNAP,Clam
Agrolatina,24A3938387,12/30/2024,Entry,80.0,1600.0,0,CANDY SNAP,Clam
Agrolatina,24A3938387,01/20/2025,Sale,-80.0,1520.0,21,CANDY SNAP,Clam
Agrolatina,24A3938387,01/21/2025,Sale,-720.0,800.0,22,CANDY SNAP,Clam
Agrolatina,24A3938387,01/22/2025,Sale,-800.0,0.0,23,CANDY SNAP,Clam
Agrolatina,24A3941360,02/03/2025,Entry,1330.0,1330.0,0,SWEET GLOBE,Bag
Agrolatina,24A3941360,02/03/2025,Entry,95.0,1425.0,0,SWEET GLOBE,Bag
Agrolatina,24A3941360,02/03/2025,Entry,475.0,1900.0,0,SWEET GLOBE,Bag
Agrolatina,24A3941360,03/31/2025,Sale,-90.0,1810.0,56,SWEET GLOBE,Bag
Agrolatina,24A3941360,04/01/2025,Sale,-95.0,1715.0,57,SWEET GLOBE,Bag
Agrolatina,24A3941360,04/01/2025,Sale,-933.0,782.0,57,SWEET GLOBE,Bag
Agrolatina,24A3941360,04/03/2025,Sale,-270.0,512.0,59,SWEET GLOBE,Bag
Agrolatina,24A3943146,01/12/2025,Entry,1360.0,1360.0,0,SWEET GLOBE,Clam
Agrolatina,24A3943146,01/12/2025,Entry,240.0,1600.0,0,SWEET GLOBE,Clam
Agrolatina,24A3943146,01/16/2025,Sale,-240.0,1360.0,4,SWEET GLOBE,Clam
Agrolatina,24A3943146,01/17/2025,Sale,-160.0,1200.0,5,SWEET GLOBE,Clam
Agrolatina,24A3943146,01/17/2025,Sale,-80.0,1120.0,5,SWEET GLOBE,Clam
Agrolatina,24A3943146,01/21/2025,Sale,-240.0,880.0,9,SWEET GLOBE,Clam
Agrolatina,24A3943146,01/30/2025,Sale,-160.0,720.0,18,SWEET GLOBE,Clam
Agrolatina,24A3943146,01/31/2025,Sale,-720.0,0.0,19,SWEET GLOBE,Clam
Agrolatina,24A3943911,02/20/2025,Entry,800.0,800.0,0,SWEET GLOBE,Clam
Agrolatina,24A3943911,02/20/2025,Entry,800.0,1600.0,0,SWEET GLOBE,Clam
Agrolatina,24A3943911,02/28/2025,Sale,-80.0,1520.0,8,SWEET GLOBE,Clam
Agrolatina,24A3943911,03/03/2025,Sale,-80.0,1440.0,11,SWEET GLOBE,Clam
Agrolatina,24A3943911,03/05/2025,Sale,-79.0,1361.0,13,SWEET GLOBE,Clam
Agrolatina,24A3943911,03/06/2025,Sale,-100.0,1261.0,14,SWEET GLOBE,Clam
Agrolatina,24A3943911,03/06/2025,Sale,-80.0,1181.0,14,SWEET GLOBE,Clam
Agrolatina,24A3943911,03/06/2025,Sale,-130.0,1051.0,14,SWEET GLOBE,Clam
Agrolatina,24A3943911,03/10/2025,Sale,-40.0,1011.0,18,SWEET GLOBE,Clam
Agrolatina,24A3943911,03/10/2025,Sale,-120.0,891.0,18,SWEET GLOBE,Clam
Agrolatina,24A3943911,03/11/2025,Sale,-320.0,571.0,19,SWEET GLOBE,Clam
Agrolatina,24A3943911,03/11/2025,Sale,-120.0,451.0,19,SWEET GLOBE,Clam
Agrolatina,24A3943911,03/11/2025,Sale,-100.0,351.0,19,SWEET GLOBE,Clam
Agrolatina,24A3943911,03/12/2025,Sale,-20.0,331.0,20,SWEET GLOBE,Clam
Agrolatina,24A3943911,03/15/2025,Sale,-60.0,271.0,23,SWEET GLOBE,Clam
Agrolatina,24A3944306,12/30/2024,Entry,960.0,960.0,0,ALLISON,Clam
Agrolatina,24A3944306,12/30/2024,Entry,640.0,1600.0,0,ALLISON,Clam
Agrolatina,24A3944306,01/13/2025,Sale,-640.0,960.0,14,ALLISON,Clam
Agrolatina,24A3944306,01/14/2025,Sale,-960.0,0.0,15,ALLISON,Clam
Agrolatina,24A3946361,03/03/2025,Entry,560.0,560.0,0,SWEET GLOBE,Clam
Agrolatina,24A3946361,03/03/2025,Entry,1040.0,1600.0,0,SWEET GLOBE,Clam
Agrolatina,24A3946361,03/15/2025,Sale,-80.0,1520.0,12,SWEET GLOBE,Clam
Agrolatina,24A3946361,03/15/2025,Sale,-240.0,1280.0,12,SWEET GLOBE,Clam
Agrolatina,24A3946361,03/15/2025,Sale,-80.0,1200.0,12,SWEET GLOBE,Clam
Agrolatina,24A3946361,03/15/2025,Sale,-40.0,1160.0,12,SWEET GLOBE,Clam
Agrolatina,24A3946361,03/15/2025,Sale,-281.0,879.0,12,SWEET GLOBE,Clam
Agrolatina,24A3946361,03/15/2025,Sale,-68.0,811.0,12,SWEET GLOBE,Clam
Agrolatina,24A3946361,03/17/2025,Sale,-120.0,691.0,14,SWEET GLOBE,Clam
Agrolatina,24A3946361,03/19/2025,Sale,-60.0,631.0,16,SWEET GLOBE,Clam
Agrolatina,24A3975009,01/02/2025,Entry,800.0,800.0,0,ALLISON,Clam
Agrolatina,24A3975009,01/02/2025,Entry,800.0,1600.0,0,ALLISON,Clam
Agrolatina,24A3975009,01/09/2025,Sale,-80.0,1520.0,7,ALLISON,Clam
Agrolatina,24A3975009,01/09/2025,Sale,-80.0,1440.0,7,ALLISON,Clam
Agrolatina,24A3975009,01/09/2025,Sale,-640.0,800.0,7,ALLISON,Clam
Agrolatina,24A3975009,01/09/2025,Sale,-800.0,0.0,7,ALLISON,Clam
Agrolatina,24A3977634,02/03/2025,Entry,1200.0,1200.0,0,SWEET GLOBE,Clam
Agrolatina,24A3977634,02/03/2025,Entry,400.0,1600.0,0,SWEET GLOBE,Clam
Agrolatina,24A3977634,02/12/2025,Sale,-640.0,960.0,9,SWEET GLOBE,Clam
Agrolatina,24A3977634,02/18/2025,Sale,-560.0,400.0,15,SWEET GLOBE,Clam
Agrolatina,24A3977634,02/19/2025,Sale,-400.0,0.0,16,SWEET GLOBE,Clam
Agrolatina,24A3978008,02/20/2025,Entry,1425.0,1425.0,0,IVORY,Bag
Agrolatina,24A3978008,02/20/2025,Entry,190.0,1615.0,0,IVORY,Bag
Agrolatina,24A3978008,02/20/2025,Entry,285.0,1900.0,0,IVORY,Bag
Agrolatina,24A3978008,03/01/2025,Sale,-190.0,1710.0,9,IVORY,Bag
Agrolatina,24A3978008,03/06/2025,Sale,-1140.0,570.0,14,IVORY,Bag
Agrolatina,24A3978008,03/08/2025,Sale,-235.0,335.0,16,IVORY,Bag
Agrolatina,24A3978008,03/12/2025,Sale,-20.0,315.0,20,IVORY,Bag
Agrolatina,24A3978008,03/12/2025,Sale,-55.0,260.0,20,IVORY,Bag
Agrolatina,24A3978008,03/25/2025,Sale,-95.0,165.0,33,IVORY,Bag
Agrolatina,24A3978008,03/27/2025,Sale,-95.0,70.0,35,IVORY,Bag
Agrolatina,24A3999382,01/30/2025,Entry,80.0,80.0,0,CANDY DREAMS,Clam
Agrolatina,24A3999382,01/30/2025,Entry,1520.0,1600.0,0,CANDY DREAMS,Clam
Agrolatina,24A3999382,03/24/2025,Sale,-320.0,1280.0,53,CANDY DREAMS,Clam
Agrolatina,24A3999382,03/27/2025,Sale,-320.0,960.0,56,CANDY DREAMS,Clam
Agrolatina,24A3999382,03/31/2025,Sale,-80.0,880.0,60,CANDY DREAMS,Clam
Agrolatina,24A3999382,03/31/2025,Sale,-160.0,720.0,60,CANDY DREAMS,Clam
Agrolatina,24A3999382,04/02/2025,Sale,-160.0,560.0,62,CANDY DREAMS,Clam
Agrolatina,24A3999382,04/02/2025,Sale,-560.0,0.0,62,CANDY DREAMS,Clam
Agrolatina,24A4001478,01/16/2025,Entry,1120.0,1120.0,0,CANDY DREAMS,Clam
Agrolatina,24A4001478,01/16/2025,Entry,480.0,1600.0,0,CANDY DREAMS,Clam
Agrolatina,24A4001478,02/08/2025,Sale,-320.0,1280.0,23,CANDY DREAMS,Clam
Agrolatina,24A4001478,02/10/2025,Sale,-80.0,1200.0,25,CANDY DREAMS,Clam
Agrolatina,24A4001478,02/11/2025,Sale,-160.0,1040.0,26,CANDY DREAMS,Clam
Agrolatina,24A4001478,02/11/2025,Sale,-80.0,960.0,26,CANDY DREAMS,Clam
Agrolatina,24A4001478,02/11/2025,Sale,-400.0,560.0,26,CANDY DREAMS,Clam
Agrolatina,24A4001478,02/13/2025,Sale,-80.0,480.0,28,CANDY DREAMS,Clam
Agrolatina,24A4001478,02/25/2025,Sale,-20.0,460.0,40,CANDY DREAMS,Clam
Agrolatina,24A4001478,02/25/2025,Sale,-150.0,310.0,40,CANDY DREAMS,Clam
Agrolatina,24A4001478,02/25/2025,Sale,-10.0,300.0,40,CANDY DREAMS,Clam
Agrolatina,24A4001478,02/26/2025,Sale,-10.0,290.0,41,CANDY DREAMS,Clam
Agrolatina,24A4001478,02/27/2025,Sale,-140.0,150.0,42,CANDY DREAMS,Clam
Agrolatina,24A4001478,03/01/2025,Sale,-10.0,140.0,44,CANDY DREAMS,Clam
Agrolatina,24A4001478,03/03/2025,Sale,-80.0,60.0,46,CANDY DREAMS,Clam
Agrolatina,24A4016570,12/31/2024,Entry,880.0,880.0,0,ALLISON,Clam
Agrolatina,24A4016570,12/31/2024,Entry,720.0,1600.0,0,ALLISON,Clam
Agrolatina,24A4016570,01/09/2025,Sale,-880.0,720.0,9,ALLISON,Clam
Agrolatina,24A4016570,01/09/2025,Sale,-80.0,640.0,9,ALLISON,Clam
Agrolatina,24A4016570,01/10/2025,Sale,-640.0,0.0,10,ALLISON,Clam
Agrolatina,24A4034321,02/13/2025,Entry,1200.0,1200.0,0,SWEET GLOBE,Clam
Agrolatina,24A4034321,02/13/2025,Entry,400.0,1600.0,0,SWEET GLOBE,Clam
Agrolatina,24A4034321,02/20/2025,Sale,-240.0,1360.0,7,SWEET GLOBE,Clam
Agrolatina,24A4034321,02/22/2025,Sale,-160.0,1200.0,9,SWEET GLOBE,Clam
Agrolatina,24A4034321,02/22/2025,Sale,-50.0,1150.0,9,SWEET GLOBE,Clam
Agrolatina,24A4034321,02/24/2025,Sale,-90.0,1060.0,11,SWEET GLOBE,Clam
Agrolatina,24A4034321,02/24/2025,Sale,-400.0,660.0,11,SWEET GLOBE,Clam
Agrolatina,24A4034321,02/24/2025,Sale,-70.0,590.0,11,SWEET GLOBE,Clam
Agrolatina,24A4034321,02/26/2025,Sale,-80.0,510.0,13,SWEET GLOBE,Clam
Agrolatina,24A4034321,02/27/2025,Sale,-80.0,430.0,14,SWEET GLOBE,Clam
Agrolatina,24A4034321,02/27/2025,Sale,-20.0,410.0,14,SWEET GLOBE,Clam
Agrolatina,24A4034321,03/12/2025,Sale,-60.0,350.0,27,SWEET GLOBE,Clam
Agrolatina,24A4035483,12/30/2024,Entry,1360.0,1360.0,0,SWEET GLOBE,Clam
Agrolatina,24A4035483,12/30/2024,Entry,240.0,1600.0,0,SWEET GLOBE,Clam
Agrolatina,24A4035483,01/17/2025,Sale,-1040.0,560.0,18,SWEET GLOBE,Clam
Agrolatina,24A4035483,01/18/2025,Sale,-320.0,240.0,19,SWEET GLOBE,Clam
Agrolatina,24A4035483,01/18/2025,Sale,-240.0,0.0,19,SWEET GLOBE,Clam
Agrolatina,24A4045500,01/16/2025,Entry,1200.0,1200.0,0,ALLISON,Clam
Agrolatina,24A4045500,01/16/2025,Entry,400.0,1600.0,0,ALLISON,Clam
Agrolatina,24A4045500,02/04/2025,Sale,-80.0,1520.0,19,ALLISON,Clam
Agrolatina,24A4045500,02/04/2025,Sale,-80.0,1440.0,19,ALLISON,Clam
Agrolatina,24A4045500,02/05/2025,Sale,-240.0,1200.0,20,ALLISON,Clam
Agrolatina,24A4045500,02/11/2025,Sale,-160.0,1040.0,26,ALLISON,Clam
Agrolatina,24A4045500,02/11/2025,Sale,-240.0,800.0,26,ALLISON,Clam
Agrolatina,24A4045500,02/13/2025,Sale,-212.0,588.0,28,ALLISON,Clam
Agrolatina,24A4045500,02/13/2025,Sale,-240.0,348.0,28,ALLISON,Clam
Agrolatina,24A4045500,02/19/2025,Sale,-80.0,268.0,34,ALLISON,Clam
Agrolatina,24A4045500,02/19/2025,Sale,-160.0,108.0,34,ALLISON,Clam
Agrolatina,24A4045500,03/04/2025,Sale,-80.0,28.0,47,ALLISON,Clam
Agrolatina,24A4045500,03/14/2025,Sale,-10.0,18.0,57,ALLISON,Clam
Agrolatina,24A4048670,02/03/2025,Entry,400.0,400.0,0,CANDY DREAMS,Clam
Agrolatina,24A4048670,02/03/2025,Entry,1200.0,1600.0,0,CANDY DREAMS,Clam
Agrolatina,24A4048670,02/10/2025,Sale,-80.0,1520.0,7,CANDY DREAMS,Clam
Agrolatina,24A4048670,02/10/2025,Sale,-160.0,1360.0,7,CANDY DREAMS,Clam
Agrolatina,24A4048670,02/11/2025,Sale,-80.0,1280.0,8,CANDY DREAMS,Clam
Agrolatina,24A4048670,02/13/2025,Sale,-80.0,1200.0,10,CANDY DREAMS,Clam
Agrolatina,24A4048670,02/15/2025,Sale,-80.0,1120.0,12,CANDY DREAMS,Clam
Agrolatina,24A4048670,02/17/2025,Sale,-80.0,1040.0,14,CANDY DREAMS,Clam
Agrolatina,24A4048670,02/18/2025,Sale,-80.0,960.0,15,CANDY DREAMS,Clam
Agrolatina,24A4048670,02/18/2025,Sale,-80.0,880.0,15,CANDY DREAMS,Clam
Agrolatina,24A4048670,02/18/2025,Sale,-80.0,800.0,15,CANDY DREAMS,Clam
Agrolatina,24A4048670,02/19/2025,Sale,-80.0,720.0,16,CANDY DREAMS,Clam
Agrolatina,24A4048670,02/20/2025,Sale,-240.0,480.0,17,CANDY DREAMS,Clam
Agrolatina,24A4048670,02/20/2025,Sale,-240.0,240.0,17,CANDY DREAMS,Clam
Agrolatina,24A4048670,02/22/2025,Sale,-80.0,160.0,19,CANDY DREAMS,Clam
Agrolatina,24A4048670,02/25/2025,Sale,-10.0,150.0,22,CANDY DREAMS,Clam
Agrolatina,24A4048670,02/25/2025,Sale,-10.0,140.0,22,CANDY DREAMS,Clam
Agrolatina,24A4048670,02/27/2025,Sale,-50.0,90.0,24,CANDY DREAMS,Clam
Agrolatina,24A4067011,03/03/2025,Entry,1200.0,1200.0,0,TIMCO,Clam
Agrolatina,24A4067011,03/03/2025,Entry,400.0,1600.0,0,TIMCO,Clam
Agrolatina,24A4067011,03/25/2025,Sale,-80.0,1520.0,22,TIMCO,Clam
Agrolatina,24A4067011,03/28/2025,Sale,-80.0,1440.0,25,TIMCO,Clam
Agrolatina,24A4067011,03/29/2025,Sale,-80.0,1360.0,26,TIMCO,Clam
Agrolatina,24A4067011,03/29/2025,Sale,-160.0,1200.0,26,TIMCO,Clam
Agrolatina,24A4067011,04/01/2025,Sale,-400.0,800.0,29,TIMCO,Clam
Agrolatina,24A4067011,04/01/2025,Sale,-80.0,720.0,29,TIMCO,Clam
Agrolatina,24A4067011,04/02/2025,Sale,-80.0,640.0,30,TIMCO,Clam
Agrolatina,24A4067011,04/03/2025,Sale,-320.0,320.0,31,TIMCO,Clam
Agrolatina,24A4067011,04/05/2025,Sale,-80.0,240.0,33,TIMCO,Clam
Agrolatina,24A4067011,04/07/2025,Sale,-240.0,0.0,35,TIMCO,Clam
Agrolatina,24A4076765,01/30/2025,Entry,560.0,560.0,0,CANDY DREAMS,Clam
Agrolatina,24A4076765,01/30/2025,Entry,1040.0,1600.0,0,CANDY DREAMS,Clam
Agrolatina,24A4076765,02/25/2025,Sale,-80.0,1520.0,26,CANDY DREAMS,Clam
Agrolatina,24A4076765,02/25/2025,Sale,-80.0,1440.0,26,CANDY DREAMS,Clam
Agrolatina,24A4076765,02/25/2025,Sale,-160.0,1280.0,26,CANDY DREAMS,Clam
Agrolatina,24A4076765,03/01/2025,Sale,-320.0,960.0,30,CANDY DREAMS,Clam
Agrolatina,24A4076765,03/01/2025,Sale,-194.0,766.0,30,CANDY DREAMS,Clam
Agrolatina,24A4076765,03/03/2025,Sale,-560.0,206.0,32,CANDY DREAMS,Clam
Agrolatina,24A4076765,03/04/2025,Sale,-70.0,136.0,33,CANDY DREAMS,Clam
Agrolatina,24A4076765,03/06/2025,Sale,-73.0,63.0,35,CANDY DREAMS,Clam
Agrolatina,24A4076873,01/30/2025,Entry,960.0,960.0,0,ALLISON,Clam
Agrolatina,24A4076873,01/30/2025,Entry,640.0,1600.0,0,ALLISON,Clam
Agrolatina,24A4076873,02/06/2025,Sale,-160.0,1440.0,7,ALLISON,Clam
Agrolatina,24A4076873,02/07/2025,Sale,-80.0,1360.0,8,ALLISON,Clam
Agrolatina,24A4076873,02/10/2025,Sale,-640.0,720.0,11,ALLISON,Clam
Agrolatina,24A4076873,02/11/2025,Sale,-400.0,320.0,12,ALLISON,Clam
Agrolatina,24A4076873,02/11/2025,Sale,-80.0,240.0,12,ALLISON,Clam
Agrolatina,24A4076873,02/18/2025,Sale,-80.0,160.0,19,ALLISON,Clam
Agrolatina,24A4076873,02/19/2025,Sale,-160.0,0.0,20,ALLISON,Clam
Agrolatina,24A4077210,02/05/2025,Entry,1330.0,1330.0,0,SWEET GLOBE,Bag
Agrolatina,24A4077210,02/05/2025,Entry,190.0,1520.0,0,SWEET GLOBE,Bag
Agrolatina,24A4077210,02/05/2025,Entry,380.0,1900.0,0,SWEET GLOBE,Bag
Agrolatina,24A4077210,02/06/2025,Sale,-95.0,1805.0,1,SWEET GLOBE,Bag
Agrolatina,24A4077210,02/07/2025,Sale,-570.0,1235.0,2,SWEET GLOBE,Bag
Agrolatina,24A4077210,02/10/2025,Sale,-95.0,1140.0,5,SWEET GLOBE,Bag
Agrolatina,24A4077210,02/11/2025,Sale,-285.0,855.0,6,SWEET GLOBE,Bag
Agrolatina,24A4077210,02/11/2025,Sale,-380.0,475.0,6,SWEET GLOBE,Bag
Agrolatina,24A4077210,02/12/2025,Sale,-190.0,285.0,7,SWEET GLOBE,Bag
Agrolatina,24A4077210,02/14/2025,Sale,-95.0,190.0,9,SWEET GLOBE,Bag
Agrolatina,24A4077210,02/25/2025,Sale,-190.0,0.0,20,SWEET GLOBE,Bag
Agrolatina,24A4077529,12/26/2024,Entry,1040.0,1040.0,0,SWEET GLOBE,Clam
Agrolatina,24A4077529,12/26/2024,Entry,560.0,1600.0,0,SWEET GLOBE,Clam
Agrolatina,24A4077529,01/06/2025,Sale,-320.0,1280.0,11,SWEET GLOBE,Clam
Agrolatina,24A4077529,01/07/2025,Sale,-240.0,1040.0,12,SWEET GLOBE,Clam
Agrolatina,24A4077529,01/07/2025,Sale,-80.0,960.0,12,SWEET GLOBE,Clam
Agrolatina,24A4077529,01/08/2025,Sale,-800.0,160.0,13,SWEET GLOBE,Clam
Agrolatina,24A4077529,01/11/2025,Sale,-160.0,0.0,16,SWEET GLOBE,Clam
Agrolatina,24A4077566,01/13/2025,Entry,1040.0,1040.0,0,ALLISON,Clam
Agrolatina,24A4077566,01/13/2025,Entry,560.0,1600.0,0,ALLISON,Clam
Agrolatina,24A4077566,01/16/2025,Sale,-720.0,880.0,3,ALLISON,Clam
Agrolatina,24A4077566,01/16/2025,Sale,-320.0,560.0,3,ALLISON,Clam
Agrolatina,24A4077566,01/17/2025,Sale,-320.0,240.0,4,ALLISON,Clam
Agrolatina,24A4077566,01/20/2025,Sale,-240.0,0.0,7,ALLISON,Clam
Agrolatina,24A4077571,01/13/2025,Entry,1360.0,1360.0,0,CANDY SNAP,Clam
Agrolatina,24A4077571,01/13/2025,Entry,240.0,1600.0,0,CANDY SNAP,Clam
Agrolatina,24A4077571,01/22/2025,Sale,-720.0,880.0,9,CANDY SNAP,Clam
Agrolatina,24A4077571,01/23/2025,Sale,-560.0,320.0,10,CANDY SNAP,Clam
Agrolatina,24A4077571,01/24/2025,Sale,-80.0,240.0,11,CANDY SNAP,Clam
Agrolatina,24A4077571,01/28/2025,Sale,-240.0,0.0,15,CANDY SNAP,Clam
Agrolatina,24A4078602,01/30/2025,Entry,1280.0,1280.0,0,SWEET GLOBE,Clam
Agrolatina,24A4078602,01/30/2025,Entry,320.0,1600.0,0,SWEET GLOBE,Clam
Agrolatina,24A4078602,03/14/2025,Sale,-1280.0,320.0,43,SWEET GLOBE,Clam
Agrolatina,24A4078602,03/14/2025,Sale,-320.0,0.0,43,SWEET GLOBE,Clam
Agrolatina,24A4078984,01/13/2025,Entry,1440.0,1440.0,0,CANDY SNAP,Clam
Agrolatina,24A4078984,01/13/2025,Entry,160.0,1600.0,0,CANDY SNAP,Clam
Agrolatina,24A4078984,01/23/2025,Sale,-320.0,1280.0,10,CANDY SNAP,Clam
Agrolatina,24A4078984,01/24/2025,Sale,-400.0,880.0,11,CANDY SNAP,Clam
Agrolatina,24A4078984,01/25/2025,Sale,-640.0,240.0,12,CANDY SNAP,Clam
Agrolatina,24A4078984,01/25/2025,Sale,-80.0,160.0,12,CANDY SNAP,Clam
Agrolatina,24A4078984,01/28/2025,Sale,-160.0,0.0,15,CANDY SNAP,Clam
Agrolatina,24A4079070,01/13/2025,Entry,1120.0,1120.0,0,ALLISON,Clam
Agrolatina,24A4079070,01/13/2025,Entry,480.0,1600.0,0,ALLISON,Clam
Agrolatina,24A4079070,01/20/2025,Sale,-480.0,1120.0,7,ALLISON,Clam
Agrolatina,24A4079070,01/23/2025,Sale,-1120.0,0.0,10,ALLISON,Clam
Agrolatina,24A4079086,01/13/2025,Entry,1360.0,1360.0,0,CANDY SNAP,Clam
Agrolatina,24A4079086,01/13/2025,Entry,240.0,1600.0,0,CANDY SNAP,Clam
Agrolatina,24A4079086,01/25/2025,Sale,-240.0,1360.0,12,CANDY SNAP,Clam
Agrolatina,24A4079086,01/25/2025,Sale,-320.0,1040.0,12,CANDY SNAP,Clam
Agrolatina,24A4079086,01/25/2025,Sale,-560.0,480.0,12,CANDY SNAP,Clam
Agrolatina,24A4079086,01/27/2025,Sale,-80.0,400.0,14,CANDY SNAP,Clam
Agrolatina,24A4079086,01/28/2025,Sale,-80.0,320.0,15,CANDY SNAP,Clam
Agrolatina,24A4079086,01/28/2025,Sale,-160.0,160.0,15,CANDY SNAP,Clam
Agrolatina,24A4079086,01/30/2025,Sale,-80.0,80.0,17,CANDY SNAP,Clam
Agrolatina,24A4079086,02/01/2025,Sale,-80.0,0.0,19,CANDY SNAP,Clam
Agrolatina,24A4079898,03/03/2025,Entry,720.0,720.0,0,COTTON CANDY,Clam
Agrolatina,24A4079898,03/03/2025,Entry,880.0,1600.0,0,COTTON CANDY,Clam
Agrolatina,24A4079898,03/17/2025,Sale,-160.0,1440.0,14,COTTON CANDY,Clam
Agrolatina,24A4079898,04/02/2025,Sale,-80.0,1360.0,30,COTTON CANDY,Clam
Agrolatina,24A4080019,01/30/2025,Entry,720.0,720.0,0,AUTUMN CRISP,Clam
Agrolatina,24A4080019,01/30/2025,Entry,880.0,1600.0,0,AUTUMN CRISP,Clam
Agrolatina,24A4080019,02/17/2025,Sale,-720.0,880.0,18,AUTUMN CRISP,Clam
Agrolatina,24A4080019,02/17/2025,Sale,-880.0,0.0,18,AUTUMN CRISP,Clam
Agrolatina,24A4081000,03/24/2025,Entry,1600.0,1600.0,0,JACK SALUTE,Clam
Agrolatina,24A4081000,04/13/2025,Sale,-1520.0,80.0,20,JACK SALUTE,Clam
Agrolatina,24A4081000,04/15/2025,Sale,-80.0,0.0,22,JACK SALUTE,Clam
Agrolatina,24A4081864,03/24/2025,Entry,720.0,720.0,0,JACK SALUTE,Clam
Agrolatina,24A4081864,03/24/2025,Entry,880.0,1600.0,0,JACK SALUTE,Clam
Agrolatina,24A4081864,04/12/2025,Sale,-320.0,1280.0,19,JACK SALUTE,Clam
Agrolatina,24A4081864,04/13/2025,Sale,-400.0,880.0,20,JACK SALUTE,Clam
Agrolatina,24A4081864,04/16/2025,Sale,-880.0,0.0,23,JACK SALUTE,Clam
Agrolatina,24A4087234,01/28/2025,Entry,1360.0,1360.0,0,IVORY,Clam
Agrolatina,24A4087234,01/28/2025,Entry,80.0,1440.0,0,IVORY,Clam
Agrolatina,24A4087234,01/28/2025,Entry,160.0,1600.0,0,IVORY,Clam
Agrolatina,24A4087234,02/04/2025,Sale,-720.0,880.0,7,IVORY,Clam
Agrolatina,24A4087234,02/04/2025,Sale,-160.0,720.0,7,IVORY,Clam
Agrolatina,24A4087234,02/05/2025,Sale,-97.0,623.0,8,IVORY,Clam
Agrolatina,24A4087234,02/05/2025,Sale,-80.0,543.0,8,IVORY,Clam
Agrolatina,24A4087234,02/05/2025,Sale,-80.0,463.0,8,IVORY,Clam
Agrolatina,24A4087754,01/13/2025,Entry,880.0,880.0,0,SWEET GLOBE,Clam
Agrolatina,24A4087754,01/13/2025,Entry,720.0,1600.0,0,SWEET GLOBE,Clam
Agrolatina,24A4087754,01/21/2025,Sale,-160.0,1440.0,8,SWEET GLOBE,Clam
Agrolatina,24A4087754,01/21/2025,Sale,-480.0,960.0,8,SWEET GLOBE,Clam
Agrolatina,24A4087754,01/22/2025,Sale,-720.0,240.0,9,SWEET GLOBE,Clam
Agrolatina,24A4087754,01/22/2025,Sale,-240.0,0.0,9,SWEET GLOBE,Clam
Agrolatina,24A4087775,01/30/2025,Entry,800.0,800.0,0,SWEET GLOBE,Clam
Agrolatina,24A4087775,01/30/2025,Entry,800.0,1600.0,0,SWEET GLOBE,Clam
Agrolatina,24A4087775,02/08/2025,Sale,-720.0,880.0,9,SWEET GLOBE,Clam
Agrolatina,24A4087775,02/10/2025,Sale,-720.0,160.0,11,SWEET GLOBE,Clam
Agrolatina,24A4087775,02/11/2025,Sale,-80.0,80.0,12,SWEET GLOBE,Clam
Agrolatina,24A4087775,02/12/2025,Sale,-80.0,0.0,13,SWEET GLOBE,Clam
Agrolatina,24A4087846,02/03/2025,Entry,1360.0,1360.0,0,SWEET GLOBE,Clam
Agrolatina,24A4087846,02/03/2025,Entry,240.0,1600.0,0,SWEET GLOBE,Clam
Agrolatina,24A4087846,02/10/2025,Sale,-160.0,1440.0,7,SWEET GLOBE,Clam
Agrolatina,24A4087846,02/14/2025,Sale,-80.0,1360.0,11,SWEET GLOBE,Clam
Agrolatina,24A4087846,02/15/2025,Sale,-80.0,1280.0,12,SWEET GLOBE,Clam
Agrolatina,24A4087846,02/15/2025,Sale,-80.0,1200.0,12,SWEET GLOBE,Clam
Agrolatina,24A4087846,02/17/2025,Sale,-240.0,960.0,14,SWEET GLOBE,Clam
Agrolatina,24A4087846,02/18/2025,Sale,-80.0,880.0,15,SWEET GLOBE,Clam
Agrolatina,24A4087846,02/18/2025,Sale,-160.0,720.0,15,SWEET GLOBE,Clam
Agrolatina,24A4087846,02/25/2025,Sale,-120.0,600.0,22,SWEET GLOBE,Clam
Agrolatina,24A4087846,02/25/2025,Sale,-20.0,580.0,22,SWEET GLOBE,Clam
Agrolatina,24A4087846,02/28/2025,Sale,-120.0,460.0,25,SWEET GLOBE,Clam
Agrolatina,24A4087846,02/28/2025,Sale,-280.0,180.0,25,SWEET GLOBE,Clam
Agrolatina,24A4105282,03/03/2025,Entry,1280.0,1280.0,0,TIMCO,Clam
Agrolatina,24A4105282,03/03/2025,Entry,320.0,1600.0,0,TIMCO,Clam
Agrolatina,24A4105282,03/29/2025,Sale,-1040.0,560.0,26,TIMCO,Clam
Agrolatina,24A4105282,03/29/2025,Sale,-160.0,400.0,26,TIMCO,Clam
Agrolatina,24A4105282,03/29/2025,Sale,-160.0,240.0,26,TIMCO,Clam
Agrolatina,24A4105282,04/05/2025,Sale,-80.0,160.0,33,TIMCO,Clam
Agrolatina,24A4105282,04/08/2025,Sale,-80.0,80.0,36,TIMCO,Clam
Agrolatina,24A4105282,04/10/2025,Sale,-80.0,0.0,38,TIMCO,Clam
Agrolatina,24A4108872,02/20/2025,Entry,880.0,880.0,0,SWEET GLOBE,Clam
Agrolatina,24A4108872,02/20/2025,Entry,720.0,1600.0,0,SWEET GLOBE,Clam
Agrolatina,24A4108872,02/27/2025,Sale,-400.0,1200.0,7,SWEET GLOBE,Clam
Agrolatina,24A4108872,02/27/2025,Sale,-320.0,880.0,7,SWEET GLOBE,Clam
Agrolatina,24A4108872,03/01/2025,Sale,-160.0,720.0,9,SWEET GLOBE,Clam
Agrolatina,24A4108872,03/01/2025,Sale,-400.0,320.0,9,SWEET GLOBE,Clam
Agrolatina,24A4108872,03/03/2025,Sale,-80.0,240.0,11,SWEET GLOBE,Clam
Agrolatina,24A4108872,03/06/2025,Sale,-10.0,230.0,14,SWEET GLOBE,Clam
Agrolatina,24A4108872,03/06/2025,Sale,-50.0,180.0,14,SWEET GLOBE,Clam
Agrolatina,24A4108872,03/11/2025,Sale,-104.0,76.0,19,SWEET GLOBE,Clam
Agrolatina,24A4108872,03/12/2025,Sale,-23.0,53.0,20,SWEET GLOBE,Clam
Agrolatina,24A4122628,02/13/2025,Entry,640.0,640.0,0,SWEET GLOBE,Clam
Agrolatina,24A4122628,02/13/2025,Entry,960.0,1600.0,0,SWEET GLOBE,Clam
Agrolatina,24A4122628,02/22/2025,Sale,-560.0,1040.0,9,SWEET GLOBE,Clam
Agrolatina,24A4122628,02/26/2025,Sale,-80.0,960.0,13,SWEET GLOBE,Clam
Agrolatina,24A4122628,03/01/2025,Sale,-80.0,880.0,16,SWEET GLOBE,Clam
Agrolatina,24A4122628,03/01/2025,Sale,-80.0,800.0,16,SWEET GLOBE,Clam
Agrolatina,24A4122628,03/03/2025,Sale,-80.0,720.0,18,SWEET GLOBE,Clam
Agrolatina,24A4122628,03/05/2025,Sale,-67.0,653.0,20,SWEET GLOBE,Clam
Agrolatina,24A4122628,03/06/2025,Sale,-80.0,573.0,21,SWEET GLOBE,Clam
Agrolatina,24A4122628,03/06/2025,Sale,-80.0,493.0,21,SWEET GLOBE,Clam
Agrolatina,24A4122628,03/10/2025,Sale,-50.0,443.0,25,SWEET GLOBE,Clam
Agrolatina,24A4122628,03/11/2025,Sale,-140.0,303.0,26,SWEET GLOBE,Clam
Agrolatina,24A4122628,03/11/2025,Sale,-40.0,263.0,26,SWEET GLOBE,Clam
Agrolatina,24A4122628,03/12/2025,Sale,-100.0,163.0,27,SWEET GLOBE,Clam
Agrolatina,24A4152221,01/09/2025,Entry,1360.0,1360.0,0,SWEET GLOBE,Clam
Agrolatina,24A4152221,01/09/2025,Entry,80.0,1440.0,0,SWEET GLOBE,Clam
Agrolatina,24A4152221,01/09/2025,Entry,160.0,1600.0,0,SWEET GLOBE,Clam
Agrolatina,24A4152221,01/20/2025,Sale,-560.0,1040.0,11,SWEET GLOBE,Clam
Agrolatina,24A4152221,01/20/2025,Sale,-160.0,880.0,11,SWEET GLOBE,Clam
Agrolatina,24A4152221,01/21/2025,Sale,-800.0,80.0,12,SWEET GLOBE,Clam
Agrolatina,24A4152221,01/22/2025,Sale,-80.0,0.0,13,SWEET GLOBE,Clam
Agrolatina,24A4168655,02/20/2025,Entry,1440.0,1440.0,0,IVORY,Clam
Agrolatina,24A4168655,02/20/2025,Entry,160.0,1600.0,0,IVORY,Clam
Agrolatina,24A4168655,03/01/2025,Sale,-1120.0,480.0,9,IVORY,Clam
Agrolatina,24A4168655,03/14/2025,Sale,-160.0,320.0,22,IVORY,Clam
Agrolatina,24A4168655,03/19/2025,Sale,-40.0,280.0,27,IVORY,Clam
Agrolatina,24A4168655,03/22/2025,Sale,-40.0,240.0,30,IVORY,Clam
Agrolatina,24A4168655,03/22/2025,Sale,-120.0,120.0,30,IVORY,Clam
Agrolatina,24A4170797,02/03/2025,Entry,960.0,960.0,0,SWEET GLOBE,Clam
Agrolatina,24A4170797,02/03/2025,Entry,640.0,1600.0,0,SWEET GLOBE,Clam
Agrolatina,24A4170797,02/07/2025,Sale,-240.0,1360.0,4,SWEET GLOBE,Clam
Agrolatina,24A4170797,02/07/2025,Sale,-80.0,1280.0,4,SWEET GLOBE,Clam
Agrolatina,24A4170797,02/08/2025,Sale,-80.0,1200.0,5,SWEET GLOBE,Clam
Agrolatina,24A4170797,02/10/2025,Sale,-80.0,1120.0,7,SWEET GLOBE,Clam
Agrolatina,24A4170797,02/10/2025,Sale,-80.0,1040.0,7,SWEET GLOBE,Clam
Agrolatina,24A4170797,02/10/2025,Sale,-9.0,1031.0,7,SWEET GLOBE,Clam
Agrolatina,24A4170797,02/11/2025,Sale,-63.0,968.0,8,SWEET GLOBE,Clam
Agrolatina,24A4170797,02/17/2025,Sale,-55.0,913.0,14,SWEET GLOBE,Clam
Agrolatina,24A4170797,02/18/2025,Sale,-240.0,673.0,15,SWEET GLOBE,Clam
Agrolatina,24A4170797,02/18/2025,Sale,-74.0,599.0,15,SWEET GLOBE,Clam
Agrolatina,24A4170797,02/19/2025,Sale,-80.0,519.0,16,SWEET GLOBE,Clam
Agrolatina,24A4170797,02/20/2025,Sale,-80.0,439.0,17,SWEET GLOBE,Clam
Agrolatina,24A4170797,02/21/2025,Sale,-80.0,359.0,18,SWEET GLOBE,Clam
Agrolatina,24A4170797,02/28/2025,Sale,-10.0,349.0,25,SWEET GLOBE,Clam
Agrolatina,24A4170797,03/01/2025,Sale,-100.0,249.0,26,SWEET GLOBE,Clam
Agrolatina,24A4170797,03/05/2025,Sale,-40.0,209.0,30,SWEET GLOBE,Clam
Agrolatina,24A4170797,03/05/2025,Sale,-50.0,159.0,30,SWEET GLOBE,Clam
Agrolatina,24A4175335,03/03/2025,Entry,1040.0,1040.0,0,COTTON CANDY,Clam
Agrolatina,24A4175335,03/03/2025,Entry,560.0,1600.0,0,COTTON CANDY,Clam
Agrolatina,24A4175335,03/17/2025,Sale,-80.0,1520.0,14,COTTON CANDY,Clam
Agrolatina,24A4175335,03/17/2025,Sale,-160.0,1360.0,14,COTTON CANDY,Clam
Agrolatina,24A4175335,03/24/2025,Sale,-160.0,1200.0,21,COTTON CANDY,Clam
Agrolatina,24A4175335,04/02/2025,Sale,-80.0,1120.0,30,COTTON CANDY,Clam
Agrolatina,24A4179120,02/13/2025,Entry,1120.0,1120.0,0,SWEET GLOBE,Clam
Agrolatina,24A4179120,02/13/2025,Entry,480.0,1600.0,0,SWEET GLOBE,Clam
Agrolatina,24A4179120,02/22/2025,Sale,-800.0,800.0,9,SWEET GLOBE,Clam
Agrolatina,24A4179120,02/25/2025,Sale,-120.0,680.0,12,SWEET GLOBE,Clam
Agrolatina,24A4179120,02/25/2025,Sale,-30.0,650.0,12,SWEET GLOBE,Clam
Agrolatina,24A4179120,02/27/2025,Sale,-55.0,595.0,14,SWEET GLOBE,Clam
Agrolatina,24A4179120,02/28/2025,Sale,-30.0,565.0,15,SWEET GLOBE,Clam
Agrolatina,24A4179120,03/01/2025,Sale,-160.0,405.0,16,SWEET GLOBE,Clam
Agrolatina,24A4179120,03/10/2025,Sale,-80.0,325.0,25,SWEET GLOBE,Clam
Agrolatina,24A4179120,03/11/2025,Sale,-80.0,245.0,26,SWEET GLOBE,Clam
Agrolatina,24A4179120,03/12/2025,Sale,-100.0,145.0,27,SWEET GLOBE,Clam
Agrolatina,24A4196847,01/16/2025,Entry,1520.0,1520.0,0,ALLISON,Clam
Agrolatina,24A4196847,01/16/2025,Entry,80.0,1600.0,0,ALLISON,Clam
Agrolatina,24A4196847,02/03/2025,Sale,-240.0,1360.0,18,ALLISON,Clam
Agrolatina,24A4196847,02/04/2025,Sale,-240.0,1120.0,19,ALLISON,Clam
Agrolatina,24A4196847,02/04/2025,Sale,-80.0,1040.0,19,ALLISON,Clam
Agrolatina,24A4196847,02/08/2025,Sale,-160.0,880.0,23,ALLISON,Clam
Agrolatina,24A4196847,02/11/2025,Sale,-80.0,800.0,26,ALLISON,Clam
Agrolatina,24A4196847,02/11/2025,Sale,-160.0,640.0,26,ALLISON,Clam
Agrolatina,24A4196847,02/13/2025,Sale,-160.0,480.0,28,ALLISON,Clam
Agrolatina,24A4196847,02/14/2025,Sale,-80.0,400.0,29,ALLISON,Clam
Agrolatina,24A4196847,02/17/2025,Sale,-80.0,320.0,32,ALLISON,Clam
Agrolatina,24A4196847,02/20/2025,Sale,-160.0,160.0,35,ALLISON,Clam
Agrolatina,24A4196847,02/20/2025,Sale,-80.0,80.0,35,ALLISON,Clam
Agrolatina,24A4196847,02/25/2025,Sale,-80.0,0.0,40,ALLISON,Clam
Agrolatina,24A4196847,02/27/2025,Sale,-80.0,-80.0,42,ALLISON,Clam
Agrolatina,24A4217699,12/30/2024,Entry,960.0,960.0,0,ALLISON,Clam
Agrolatina,24A4217699,12/30/2024,Entry,640.0,1600.0,0,ALLISON,Clam
Agrolatina,24A4217699,01/18/2025,Sale,-960.0,640.0,19,ALLISON,Clam
Agrolatina,24A4217699,01/18/2025,Sale,-80.0,560.0,19,ALLISON,Clam
Agrolatina,24A4217699,01/18/2025,Sale,-480.0,80.0,19,ALLISON,Clam
Agrolatina,24A4217699,01/21/2025,Sale,-80.0,0.0,22,ALLISON,Clam
Agrolatina,24A4245387,01/16/2025,Entry,1120.0,1120.0,0,SWEET GLOBE,Clam
Agrolatina,24A4245387,01/16/2025,Entry,480.0,1600.0,0,SWEET GLOBE,Clam
Agrolatina,24A4245387,01/29/2025,Sale,-160.0,1440.0,13,SWEET GLOBE,Clam
Agrolatina,24A4245387,01/29/2025,Sale,-320.0,1120.0,13,SWEET GLOBE,Clam
Agrolatina,24A4245387,01/29/2025,Sale,-80.0,1040.0,13,SWEET GLOBE,Clam
Agrolatina,24A4245387,01/29/2025,Sale,-80.0,960.0,13,SWEET GLOBE,Clam
Agrolatina,24A4245387,01/30/2025,Sale,-80.0,880.0,14,SWEET GLOBE,Clam
Agrolatina,24A4245387,01/30/2025,Sale,-320.0,560.0,14,SWEET GLOBE,Clam
Agrolatina,24A4245387,01/31/2025,Sale,-80.0,480.0,15,SWEET GLOBE,Clam
Agrolatina,24A4245387,02/03/2025,Sale,-80.0,400.0,18,SWEET GLOBE,Clam
Agrolatina,24A4245387,02/03/2025,Sale,-160.0,240.0,18,SWEET GLOBE,Clam
Agrolatina,24A4245387,02/03/2025,Sale,-240.0,0.0,18,SWEET GLOBE,Clam
Agrolatina,24A4248426,12/30/2024,Entry,1040.0,1040.0,0,ALLISON,Clam
Agrolatina,24A4248426,12/30/2024,Entry,560.0,1600.0,0,ALLISON,Clam
Agrolatina,24A4248426,01/18/2025,Sale,-320.0,1280.0,19,ALLISON,Clam
Agrolatina,24A4248426,01/18/2025,Sale,-560.0,720.0,19,ALLISON,Clam
Agrolatina,24A4248426,01/20/2025,Sale,-720.0,0.0,21,ALLISON,Clam
Agrolatina,24A4256993,03/13/2025,Entry,400.0,400.0,0,AUTUMN CRISP,Clam
Agrolatina,24A4256993,03/13/2025,Entry,1200.0,1600.0,0,AUTUMN CRISP,Clam
Agrolatina,24A4256993,03/29/2025,Sale,-400.0,1200.0,16,AUTUMN CRISP,Clam
Agrolatina,24A4256993,03/29/2025,Sale,-320.0,880.0,16,AUTUMN CRISP,Clam
Agrolatina,24A4256993,03/31/2025,Sale,-480.0,400.0,18,AUTUMN CRISP,Clam
Agrolatina,24A4256993,04/01/2025,Sale,-400.0,0.0,19,AUTUMN CRISP,Clam
Agrolatina,24A4259020,02/27/2025,Entry,1200.0,1200.0,0,IVORY,Clam
Agrolatina,24A4259020,02/27/2025,Entry,400.0,1600.0,0,IVORY,Clam
Agrolatina,24A4259020,03/21/2025,Sale,-40.0,1560.0,22,IVORY,Clam
Agrolatina,24A4259020,03/22/2025,Sale,-240.0,1320.0,23,IVORY,Clam
Agrolatina,24A4259020,03/22/2025,Sale,-60.0,1260.0,23,IVORY,Clam
Agrolatina,24A4259020,03/22/2025,Sale,-40.0,1220.0,23,IVORY,Clam
Agrolatina,24A4259020,03/24/2025,Sale,-80.0,1140.0,25,IVORY,Clam
Agrolatina,24A4259020,03/25/2025,Sale,-160.0,980.0,26,IVORY,Clam
Agrolatina,24A4259020,03/25/2025,Sale,-80.0,900.0,26,IVORY,Clam
Agrolatina,24A4259020,03/26/2025,Sale,-80.0,820.0,27,IVORY,Clam
Agrolatina,24A4259020,03/27/2025,Sale,-160.0,660.0,28,IVORY,Clam
Agrolatina,24A4259020,03/27/2025,Sale,-260.0,400.0,28,IVORY,Clam
Agrolatina,24A4259020,03/28/2025,Sale,-80.0,320.0,29,IVORY,Clam
Agrolatina,24A4260231,02/20/2025,Entry,800.0,800.0,0,TIMCO,Clam
Agrolatina,24A4260231,02/20/2025,Entry,800.0,1600.0,0,TIMCO,Clam
Agrolatina,24A4267616,02/20/2025,Entry,1280.0,1280.0,0,COTTON CANDY,Clam
Agrolatina,24A4267616,02/20/2025,Entry,320.0,1600.0,0,COTTON CANDY,Clam
Agrolatina,24A4267616,03/04/2025,Sale,-240.0,1360.0,12,COTTON CANDY,Clam
Agrolatina,24A4267616,03/21/2025,Sale,-20.0,1340.0,29,COTTON CANDY,Clam
Agrolatina,24A4267616,03/22/2025,Sale,-20.0,1320.0,30,COTTON CANDY,Clam
Agrolatina,24A4267616,03/28/2025,Sale,-240.0,1080.0,36,COTTON CANDY,Clam
Agrolatina,24A4267616,03/29/2025,Sale,-80.0,1000.0,37,COTTON CANDY,Clam
Agrolatina,24A4267616,03/29/2025,Sale,-80.0,920.0,37,COTTON CANDY,Clam
Agrolatina,24A4267616,03/31/2025,Sale,-160.0,760.0,39,COTTON CANDY,Clam
Agrolatina,24A4267616,04/02/2025,Sale,-80.0,680.0,41,COTTON CANDY,Clam
Agrolatina,24A4267616,04/02/2025,Sale,-160.0,520.0,41,COTTON CANDY,Clam
Agrolatina,24A4267616,04/02/2025,Sale,-30.0,490.0,41,COTTON CANDY,Clam
Agrolatina,24A4286880,02/20/2025,Entry,1040.0,1040.0,0,SWEET GLOBE,Clam
Agrolatina,24A4286880,02/20/2025,Entry,560.0,1600.0,0,SWEET GLOBE,Clam
Agrolatina,24A4286880,02/27/2025,Sale,-80.0,1520.0,7,SWEET GLOBE,Clam
Agrolatina,24A4286880,02/27/2025,Sale,-40.0,1480.0,7,SWEET GLOBE,Clam
Agrolatina,24A4286880,02/28/2025,Sale,-800.0,680.0,8,SWEET GLOBE,Clam
Agrolatina,24A4286880,03/01/2025,Sale,-80.0,600.0,9,SWEET GLOBE,Clam
Agrolatina,24A4286880,03/06/2025,Sale,-60.0,540.0,14,SWEET GLOBE,Clam
Agrolatina,24A4286880,03/10/2025,Sale,-120.0,420.0,18,SWEET GLOBE,Clam
Agrolatina,24A4286880,03/11/2025,Sale,-60.0,360.0,19,SWEET GLOBE,Clam
Agrolatina,24A4286880,03/11/2025,Sale,-7.0,353.0,19,SWEET GLOBE,Clam
Agrolatina,24A4286880,03/12/2025,Sale,-220.0,133.0,20,SWEET GLOBE,Clam
Agrolatina,24A4295897,02/20/2025,Entry,1440.0,1440.0,0,IVORY,Clam
Agrolatina,24A4295897,02/20/2025,Entry,160.0,1600.0,0,IVORY,Clam
Agrolatina,24A4295897,02/26/2025,Sale,-80.0,1520.0,6,IVORY,Clam
Agrolatina,24A4295897,02/26/2025,Sale,-880.0,640.0,6,IVORY,Clam
Agrolatina,24A4295897,02/26/2025,Sale,-160.0,480.0,6,IVORY,Clam
Agrolatina,24A4295897,03/22/2025,Sale,-160.0,320.0,30,IVORY,Clam
Agrolatina,24A4295897,03/22/2025,Sale,-80.0,240.0,30,IVORY,Clam
Agrolatina,24A4295897,03/22/2025,Sale,-80.0,160.0,30,IVORY,Clam
Agrolatina,24A4295897,03/25/2025,Sale,-80.0,80.0,33,IVORY,Clam
Agrolatina,24A4305070,02/24/2025,Entry,640.0,640.0,0,TIMCO,Clam
Agrolatina,24A4305070,02/24/2025,Entry,960.0,1600.0,0,TIMCO,Clam
Agrolatina,24A4305070,04/16/2025,Sale,-320.0,1280.0,51,TIMCO,Clam
Agrolatina,24A4305070,04/24/2025,Sale,-553.0,727.0,59,TIMCO,Clam
Agrolatina,24A4305070,04/24/2025,Sale,-435.0,292.0,59,TIMCO,Clam
Agrolatina,24A4305070,05/03/2025,Sale,-30.0,262.0,68,TIMCO,Clam
Agrolatina,24A4305070,05/07/2025,Sale,-60.0,202.0,72,TIMCO,Clam
Agrolatina,24A4306950,01/16/2025,Entry,1120.0,1120.0,0,ALLISON,Clam
Agrolatina,24A4306950,01/16/2025,Entry,480.0,1600.0,0,ALLISON,Clam
Agrolatina,24A4306950,01/29/2025,Sale,-720.0,880.0,13,ALLISON,Clam
Agrolatina,24A4306950,01/30/2025,Sale,-80.0,800.0,14,ALLISON,Clam
Agrolatina,24A4306950,01/31/2025,Sale,-160.0,640.0,15,ALLISON,Clam
Agrolatina,24A4306950,02/01/2025,Sale,-80.0,560.0,16,ALLISON,Clam
Agrolatina,24A4306950,02/04/2025,Sale,-80.0,480.0,19,ALLISON,Clam
Agrolatina,24A4306950,02/05/2025,Sale,-80.0,400.0,20,ALLISON,Clam
Agrolatina,24A4306950,02/05/2025,Sale,-80.0,320.0,20,ALLISON,Clam
Agrolatina,24A4306950,02/13/2025,Sale,-80.0,240.0,28,ALLISON,Clam
Agrolatina,24A4306950,02/13/2025,Sale,-80.0,160.0,28,ALLISON,Clam
Agrolatina,24A4306950,02/17/2025,Sale,-160.0,0.0,32,ALLISON,Clam
Agrolatina,24A4307339,01/28/2025,Entry,1520.0,1520.0,0,IVORY,Clam
Agrolatina,24A4307339,01/28/2025,Entry,80.0,1600.0,0,IVORY,Clam
Agrolatina,24A4307339,02/04/2025,Sale,-80.0,1520.0,7,IVORY,Clam
Agrolatina,24A4307339,02/04/2025,Sale,-640.0,880.0,7,IVORY,Clam
Agrolatina,24A4307339,02/04/2025,Sale,-160.0,720.0,7,IVORY,Clam
Agrolatina,24A4307339,02/05/2025,Sale,-206.0,514.0,8,IVORY,Clam
Agrolatina,24A4307339,02/05/2025,Sale,-80.0,434.0,8,IVORY,Clam
Agrolatina,24A4313115,02/20/2025,Entry,880.0,880.0,0,SWEET GLOBE,Clam
Agrolatina,24A4313115,02/20/2025,Entry,720.0,1600.0,0,SWEET GLOBE,Clam
Agrolatina,24A4313115,03/07/2025,Sale,-80.0,1520.0,15,SWEET GLOBE,Clam
Agrolatina,24A4313115,03/08/2025,Sale,-640.0,880.0,16,SWEET GLOBE,Clam
Agrolatina,24A4313115,03/10/2025,Sale,-320.0,560.0,18,SWEET GLOBE,Clam
Agrolatina,24A4313115,03/11/2025,Sale,-55.0,505.0,19,SWEET GLOBE,Clam
Agrolatina,24A4313115,03/11/2025,Sale,-240.0,265.0,19,SWEET GLOBE,Clam
Agrolatina,24A4313115,03/13/2025,Sale,-60.0,205.0,21,SWEET GLOBE,Clam
Agrolatina,24A4315484,01/16/2025,Entry,1600.0,1600.0,0,ALLISON,Clam
Agrolatina,24A4315484,02/03/2025,Sale,-80.0,1520.0,18,ALLISON,Clam
Agrolatina,24A4315484,02/04/2025,Sale,-240.0,1280.0,19,ALLISON,Clam
Agrolatina,24A4315484,02/11/2025,Sale,-320.0,960.0,26,ALLISON,Clam
Agrolatina,24A4315484,02/13/2025,Sale,-400.0,560.0,28,ALLISON,Clam
Agrolatina,24A4315484,02/17/2025,Sale,-240.0,320.0,32,ALLISON,Clam
Agrolatina,24A4315484,02/19/2025,Sale,-160.0,160.0,34,ALLISON,Clam
Agrolatina,24A4315484,02/19/2025,Sale,-80.0,80.0,34,ALLISON,Clam
Agrolatina,24A4315484,02/27/2025,Sale,-80.0,0.0,42,ALLISON,Clam
Agrolatina,24A4318375,02/20/2025,Entry,880.0,880.0,0,SWEET GLOBE,Clam
Agrolatina,24A4318375,02/20/2025,Entry,720.0,1600.0,0,SWEET GLOBE,Clam
Agrolatina,24A4318375,02/27/2025,Sale,-880.0,720.0,7,SWEET GLOBE,Clam
Agrolatina,24A4318375,03/11/2025,Sale,-720.0,0.0,19,SWEET GLOBE,Clam
Agrolatina,24A4324130,12/31/2024,Entry,720.0,720.0,0,ALLISON,Clam
Agrolatina,24A4324130,12/31/2024,Entry,880.0,1600.0,0,ALLISON,Clam
Agrolatina,24A4324130,01/10/2025,Sale,-640.0,960.0,10,ALLISON,Clam
Agrolatina,24A4324130,01/10/2025,Sale,-80.0,880.0,10,ALLISON,Clam
Agrolatina,24A4324130,01/10/2025,Sale,-720.0,160.0,10,ALLISON,Clam
Agrolatina,24A4324130,01/10/2025,Sale,-160.0,0.0,10,ALLISON,Clam
Agrolatina,24A4336403,02/24/2025,Entry,80.0,80.0,0,ALLISON,Clam
Agrolatina,24A4336403,02/24/2025,Entry,1040.0,1120.0,0,TIMCO,Clam
Agrolatina,24A4336403,02/24/2025,Entry,480.0,1600.0,0,TIMCO,Clam
Agrolatina,24A4336403,03/31/2025,Sale,-11.0,1589.0,35,TIMCO,Clam
Agrolatina,24A4336403,04/03/2025,Sale,-80.0,1509.0,38,ALLISON,Clam
Agrolatina,24A4336403,04/20/2025,Sale,-960.0,549.0,55,TIMCO,Clam
Agrolatina,24A4336403,04/22/2025,Sale,-69.0,480.0,57,TIMCO,Clam
Agrolatina,24A4336403,04/24/2025,Sale,-480.0,0.0,59,TIMCO,Clam
Agrolatina,24A4345004,03/10/2025,Entry,1520.0,1520.0,0,TIMCO,Clam
Agrolatina,24A4345004,03/10/2025,Entry,80.0,1600.0,0,TIMCO,Clam
Agrolatina,24A4345004,04/01/2025,Sale,-80.0,1520.0,22,TIMCO,Clam
Agrolatina,24A4345004,04/07/2025,Sale,-80.0,1440.0,28,TIMCO,Clam
Agrolatina,24A4345004,04/14/2025,Sale,-1440.0,0.0,35,TIMCO,Clam
Agrolatina,24A4348894,02/27/2025,Entry,340.0,340.0,0,SWEET GLOBE,Clam
Agrolatina,24A4348894,02/27/2025,Entry,1360.0,1700.0,0,SWEET GLOBE,Clam
Agrolatina,24A4348894,03/19/2025,Sale,-85.0,1615.0,20,SWEET GLOBE,Clam
Agrolatina,24A4348894,03/20/2025,Sale,-77.0,1538.0,21,SWEET GLOBE,Clam
Agrolatina,24A4348894,04/03/2025,Sale,-369.0,1169.0,35,SWEET GLOBE,Bag
Agrolatina,24A4348894,04/07/2025,Sale,-180.0,989.0,39,SWEET GLOBE,Bag
Agrolatina,24A4348894,04/08/2025,Sale,-25.0,964.0,40,SWEET GLOBE,Bag
Agrolatina,24A4348894,04/08/2025,Sale,-44.0,920.0,40,SWEET GLOBE,Bag
Agrolatina,24A4348894,04/15/2025,Sale,-40.0,880.0,47,SWEET GLOBE,Bag
Agrolatina,24A4363970,01/16/2025,Entry,1200.0,1200.0,0,SWEET GLOBE,Clam
Agrolatina,24A4363970,01/16/2025,Entry,400.0,1600.0,0,SWEET GLOBE,Clam
Agrolatina,24A4363970,02/04/2025,Sale,-160.0,1440.0,19,SWEET GLOBE,Clam
Agrolatina,24A4363970,02/05/2025,Sale,-240.0,1200.0,20,SWEET GLOBE,Clam
Agrolatina,24A4363970,02/05/2025,Sale,-240.0,960.0,20,SWEET GLOBE,Clam
Agrolatina,24A4363970,02/05/2025,Sale,-400.0,560.0,20,SWEET GLOBE,Clam
Agrolatina,24A4363970,02/07/2025,Sale,-160.0,400.0,22,SWEET GLOBE,Clam
Agrolatina,24A4363970,02/11/2025,Sale,-240.0,160.0,26,SWEET GLOBE,Clam
Agrolatina,24A4363970,02/12/2025,Sale,-160.0,0.0,27,SWEET GLOBE,Clam
Agrolatina,24A4373454,02/20/2025,Entry,800.0,800.0,0,COTTON CANDY,Clam
Agrolatina,24A4373454,02/20/2025,Entry,800.0,1600.0,0,COTTON CANDY,Clam
Agrolatina,24A4373454,02/28/2025,Sale,-160.0,1440.0,8,COTTON CANDY,Clam
Agrolatina,24A4373454,03/01/2025,Sale,-80.0,1360.0,9,COTTON CANDY,Clam
Agrolatina,24A4373454,03/04/2025,Sale,-80.0,1280.0,12,COTTON CANDY,Clam
Agrolatina,24A4373454,03/07/2025,Sale,-80.0,1200.0,15,COTTON CANDY,Clam
Agrolatina,24A4373454,03/12/2025,Sale,-80.0,1120.0,20,COTTON CANDY,Clam
Agrolatina,24A4373454,03/17/2025,Sale,-160.0,960.0,25,COTTON CANDY,Clam
Agrolatina,24A4373454,04/02/2025,Sale,-100.0,860.0,41,COTTON CANDY,Clam
Agrolatina,24A4380915,02/24/2025,Entry,960.0,960.0,0,SWEET FAVORS,Clam
Agrolatina,24A4380915,02/24/2025,Entry,640.0,1600.0,0,SWEET FAVORS,Clam
Agrolatina,24A4380915,03/14/2025,Sale,-960.0,640.0,18,SWEET FAVORS,Clam
Agrolatina,24A4380915,03/27/2025,Sale,-640.0,0.0,31,SWEET FAVORS,Clam
Agrolatina,24A4384150,02/03/2025,Entry,1235.0,1235.0,0,SWEET FAVORS,Bag
Agrolatina,24A4384150,02/03/2025,Entry,665.0,1900.0,0,SWEET FAVORS,Bag
Agrolatina,24A4384150,02/12/2025,Sale,-90.0,1810.0,9,SWEET FAVORS,Bag
Agrolatina,24A4384150,02/13/2025,Sale,-95.0,1715.0,10,SWEET FAVORS,Bag
Agrolatina,24A4384150,02/14/2025,Sale,-90.0,1625.0,11,SWEET FAVORS,Bag
Agrolatina,24A4384150,02/20/2025,Sale,-190.0,1435.0,17,SWEET FAVORS,Bag
Agrolatina,24A4384150,02/21/2025,Sale,-475.0,960.0,18,SWEET FAVORS,Bag
Agrolatina,24A4384150,02/22/2025,Sale,-380.0,580.0,19,SWEET FAVORS,Bag
Agrolatina,24A4384150,02/27/2025,Sale,-20.0,560.0,24,SWEET FAVORS,Bag
Agrolatina,24A4384150,02/28/2025,Sale,-190.0,370.0,25,SWEET FAVORS,Bag
Agrolatina,24A4384150,03/01/2025,Sale,-65.0,305.0,26,SWEET FAVORS,Clam
Agrolatina,24A4384150,03/26/2025,Sale,-90.0,215.0,51,SWEET FAVORS,Bag
Agrolatina,24A4384150,04/14/2025,Sale,-106.0,109.0,70,SWEET FAVORS,Bag
Agrolatina,24A4384150,04/17/2025,Sale,-4.0,105.0,73,SWEET FAVORS,Bag
Agrolatina,24A4384150,04/17/2025,Sale,-5.0,100.0,73,SWEET FAVORS,Bag
Agrolatina,24A4400040,01/28/2025,Entry,1040.0,1040.0,0,CANDY DREAMS,Clam
Agrolatina,24A4400040,01/28/2025,Entry,560.0,1600.0,0,CANDY DREAMS,Clam
Agrolatina,24A4400040,02/08/2025,Sale,-560.0,1040.0,11,CANDY DREAMS,Clam
Agrolatina,24A4400040,02/08/2025,Sale,-80.0,960.0,11,CANDY DREAMS,Clam
Agrolatina,24A4400040,02/08/2025,Sale,-40.0,920.0,11,CANDY DREAMS,Clam
Agrolatina,24A4400040,02/10/2025,Sale,-320.0,600.0,13,CANDY DREAMS,Clam
Agrolatina,24A4400040,02/13/2025,Sale,-480.0,120.0,16,CANDY DREAMS,Clam
Agrolatina,24A4402167,02/03/2025,Entry,1120.0,1120.0,0,SWEET GLOBE,Clam
Agrolatina,24A4402167,02/03/2025,Entry,480.0,1600.0,0,SWEET GLOBE,Clam
Agrolatina,24A4402167,02/11/2025,Sale,-80.0,1520.0,8,SWEET GLOBE,Clam
Agrolatina,24A4402167,02/13/2025,Sale,-80.0,1440.0,10,SWEET GLOBE,Clam
Agrolatina,24A4402167,02/15/2025,Sale,-80.0,1360.0,12,SWEET GLOBE,Clam
Agrolatina,24A4402167,02/17/2025,Sale,-400.0,960.0,14,SWEET GLOBE,Clam
Agrolatina,24A4402167,02/22/2025,Sale,-27.0,933.0,19,SWEET GLOBE,Clam
Agrolatina,24A4402167,02/27/2025,Sale,-50.0,883.0,24,SWEET GLOBE,Clam
Agrolatina,24A4402167,02/28/2025,Sale,-180.0,703.0,25,SWEET GLOBE,Clam
Agrolatina,24A4402167,03/01/2025,Sale,-40.0,663.0,26,SWEET GLOBE,Clam
Agrolatina,24A4402167,03/05/2025,Sale,-168.0,495.0,30,SWEET GLOBE,Clam
Agrolatina,24A4402167,03/05/2025,Sale,-40.0,455.0,30,SWEET GLOBE,Clam
Agrolatina,24A4410780,01/30/2025,Entry,1040.0,1040.0,0,SWEET GLOBE,Clam
Agrolatina,24A4410780,01/30/2025,Entry,560.0,1600.0,0,SWEET GLOBE,Clam
Agrolatina,24A4410780,02/06/2025,Sale,-80.0,1520.0,7,SWEET GLOBE,Clam
Agrolatina,24A4410780,02/07/2025,Sale,-160.0,1360.0,8,SWEET GLOBE,Clam
Agrolatina,24A4410780,02/10/2025,Sale,-80.0,1280.0,11,SWEET GLOBE,Clam
Agrolatina,24A4410780,02/10/2025,Sale,-160.0,1120.0,11,SWEET GLOBE,Clam
Agrolatina,24A4410780,02/10/2025,Sale,-80.0,1040.0,11,SWEET GLOBE,Clam
Agrolatina,24A4410780,02/11/2025,Sale,-320.0,720.0,12,SWEET GLOBE,Clam
Agrolatina,24A4410780,02/15/2025,Sale,-80.0,640.0,16,SWEET GLOBE,Clam
Agrolatina,24A4410780,02/19/2025,Sale,-80.0,560.0,20,SWEET GLOBE,Clam
Agrolatina,24A4410780,02/20/2025,Sale,-160.0,400.0,21,SWEET GLOBE,Clam
Agrolatina,24A4410780,02/20/2025,Sale,-80.0,320.0,21,SWEET GLOBE,Clam
Agrolatina,24A4410780,02/21/2025,Sale,-80.0,240.0,22,SWEET GLOBE,Clam
Agrolatina,24A4410780,02/26/2025,Sale,-47.0,193.0,27,SWEET GLOBE,Clam
Agrolatina,24A4410780,02/27/2025,Sale,-60.0,133.0,28,SWEET GLOBE,Clam
Agrolatina,24A4410780,02/28/2025,Sale,-80.0,53.0,29,SWEET GLOBE,Clam
Agrolatina,24A4412798,02/27/2025,Entry,720.0,720.0,0,SWEET GLOBE,Clam
Agrolatina,24A4412798,02/27/2025,Entry,880.0,1600.0,0,SWEET GLOBE,Clam
Agrolatina,24A4412798,03/08/2025,Sale,-80.0,1520.0,9,SWEET GLOBE,Clam
Agrolatina,24A4412798,03/10/2025,Sale,-40.0,1480.0,11,SWEET GLOBE,Clam
Agrolatina,24A4412798,03/11/2025,Sale,-20.0,1460.0,12,SWEET GLOBE,Clam
Agrolatina,24A4412798,03/11/2025,Sale,-40.0,1420.0,12,SWEET GLOBE,Clam
Agrolatina,24A4412798,03/13/2025,Sale,-40.0,1380.0,14,SWEET GLOBE,Clam
Agrolatina,24A4412798,03/13/2025,Sale,-160.0,1220.0,14,SWEET GLOBE,Clam
Agrolatina,24A4412798,03/14/2025,Sale,-116.0,1104.0,15,SWEET GLOBE,Clam
Agrolatina,24A4412798,03/15/2025,Sale,-20.0,1084.0,16,SWEET GLOBE,Clam
Agrolatina,24A4412798,03/15/2025,Sale,-400.0,684.0,16,SWEET GLOBE,Clam
Agrolatina,24A4412798,03/19/2025,Sale,-80.0,604.0,20,SWEET GLOBE,Clam
Agrolatina,24A4413285,02/24/2025,Entry,400.0,400.0,0,TIMCO,Clam
Agrolatina,24A4413285,02/24/2025,Entry,1200.0,1600.0,0,TIMCO,Clam
Agrolatina,24A4413285,03/17/2025,Sale,-1040.0,560.0,21,TIMCO,Clam
Agrolatina,24A4413285,04/02/2025,Sale,-400.0,160.0,37,TIMCO,Clam
Agrolatina,24A4413285,04/04/2025,Sale,-160.0,0.0,39,TIMCO,Clam
Agrolatina,24A4414698,01/30/2025,Entry,1235.0,1235.0,0,SWEET GLOBE,Bag
Agrolatina,24A4414698,01/30/2025,Entry,665.0,1900.0,0,SWEET GLOBE,Bag
Agrolatina,24A4414698,02/12/2025,Sale,-360.0,1540.0,13,SWEET GLOBE,Bag
Agrolatina,24A4414698,02/22/2025,Sale,-210.0,1330.0,23,SWEET GLOBE,Bag
Agrolatina,24A4414698,02/22/2025,Sale,-3.0,1327.0,23,SWEET GLOBE,Bag
Agrolatina,24A4414698,02/24/2025,Sale,-155.0,1172.0,25,SWEET GLOBE,Bag
Agrolatina,24A4414698,02/27/2025,Sale,-70.0,1102.0,28,SWEET GLOBE,Bag
Agrolatina,24A4414698,02/27/2025,Sale,-360.0,742.0,28,SWEET GLOBE,Bag
Agrolatina,24A4414698,02/28/2025,Sale,-270.0,472.0,29,SWEET GLOBE,Bag
Agrolatina,24A4414698,02/28/2025,Sale,-180.0,292.0,29,SWEET GLOBE,Bag
Agrolatina,24A4414698,02/28/2025,Sale,-90.0,202.0,29,SWEET GLOBE,Bag
Agrolatina,24A4418013,03/10/2025,Entry,1360.0,1360.0,0,TIMCO,Clam
Agrolatina,24A4418013,03/10/2025,Entry,240.0,1600.0,0,TIMCO,Clam
Agrolatina,24A4418013,03/25/2025,Sale,-80.0,1520.0,15,TIMCO,Clam
Agrolatina,24A4418013,04/01/2025,Sale,-80.0,1440.0,22,TIMCO,Clam
Agrolatina,24A4418013,04/01/2025,Sale,-80.0,1360.0,22,TIMCO,Clam
Agrolatina,24A4418013,04/03/2025,Sale,-240.0,1120.0,24,TIMCO,Clam
Agrolatina,24A4418013,04/03/2025,Sale,-80.0,1040.0,24,TIMCO,Clam
Agrolatina,24A4418013,04/04/2025,Sale,-640.0,400.0,25,TIMCO,Clam
Agrolatina,24A4418013,04/05/2025,Sale,-160.0,240.0,26,TIMCO,Clam
Agrolatina,24A4418013,04/09/2025,Sale,-80.0,160.0,30,TIMCO,Clam
Agrolatina,24A4418013,04/10/2025,Sale,-80.0,80.0,31,TIMCO,Clam
Agrolatina,24A4418013,04/14/2025,Sale,-80.0,0.0,35,TIMCO,Clam
Agrolatina,24A4420509,02/03/2025,Entry,640.0,640.0,0,SWEET GLOBE,Clam
Agrolatina,24A4420509,02/03/2025,Entry,960.0,1600.0,0,SWEET GLOBE,Clam
Agrolatina,24A4420509,02/07/2025,Sale,-160.0,1440.0,4,SWEET GLOBE,Clam
Agrolatina,24A4420509,02/10/2025,Sale,-80.0,1360.0,7,SWEET GLOBE,Clam
Agrolatina,24A4420509,02/11/2025,Sale,-80.0,1280.0,8,SWEET GLOBE,Clam
Agrolatina,24A4420509,02/15/2025,Sale,-80.0,1200.0,12,SWEET GLOBE,Clam
Agrolatina,24A4420509,02/17/2025,Sale,-80.0,1120.0,14,SWEET GLOBE,Clam
Agrolatina,24A4420509,02/22/2025,Sale,-27.0,1093.0,19,SWEET GLOBE,Clam
Agrolatina,24A4420509,02/24/2025,Sale,-50.0,1043.0,21,SWEET GLOBE,Clam
Agrolatina,24A4420509,02/25/2025,Sale,-50.0,993.0,22,SWEET GLOBE,Clam
Agrolatina,24A4420509,03/01/2025,Sale,-380.0,613.0,26,SWEET GLOBE,Clam
Agrolatina,24A4420509,03/05/2025,Sale,-40.0,573.0,30,SWEET GLOBE,Clam
Agrolatina,24A4421676,02/24/2025,Entry,640.0,640.0,0,TIMCO,Clam
Agrolatina,24A4421676,02/24/2025,Entry,960.0,1600.0,0,TIMCO,Clam
Agrolatina,24A4421676,04/22/2025,Sale,-640.0,960.0,57,TIMCO,Clam
Agrolatina,24A4421676,05/03/2025,Sale,-160.0,800.0,68,TIMCO,Clam
Agrolatina,24A4421676,05/03/2025,Sale,-720.0,80.0,68,TIMCO,Clam
Agrolatina,24A4431381,02/17/2025,Entry,1120.0,1120.0,0,SWEET GLOBE,Clam
Agrolatina,24A4431381,02/17/2025,Entry,480.0,1600.0,0,SWEET GLOBE,Clam
Agrolatina,24A4431381,03/06/2025,Sale,-400.0,1200.0,17,SWEET GLOBE,Clam
Agrolatina,24A4431381,03/08/2025,Sale,-160.0,1040.0,19,SWEET GLOBE,Clam
Agrolatina,24A4431381,03/08/2025,Sale,-80.0,960.0,19,SWEET GLOBE,Clam
Agrolatina,24A4431381,03/12/2025,Sale,-80.0,880.0,23,SWEET GLOBE,Clam
Agrolatina,24A4431381,03/13/2025,Sale,-60.0,820.0,24,SWEET GLOBE,Clam
Agrolatina,24A4431381,03/14/2025,Sale,-60.0,760.0,25,SWEET GLOBE,Clam
Agrolatina,24A4431381,03/15/2025,Sale,-120.0,640.0,26,SWEET GLOBE,Clam
Agrolatina,24A4431381,03/17/2025,Sale,-100.0,540.0,28,SWEET GLOBE,Clam
Agrolatina,24A4431381,03/18/2025,Sale,-80.0,460.0,29,SWEET GLOBE,Clam
Agrolatina,24A4431381,03/19/2025,Sale,-180.0,280.0,30,SWEET GLOBE,Clam
Agrolatina,24A4433018,01/16/2025,Entry,1280.0,1280.0,0,ALLISON,Clam
Agrolatina,24A4433018,01/16/2025,Entry,320.0,1600.0,0,ALLISON,Clam
Agrolatina,24A4433018,02/03/2025,Sale,-80.0,1520.0,18,ALLISON,Clam
Agrolatina,24A4433018,02/04/2025,Sale,-160.0,1360.0,19,ALLISON,Clam
Agrolatina,24A4433018,02/06/2025,Sale,-240.0,1120.0,21,ALLISON,Clam
Agrolatina,24A4433018,02/08/2025,Sale,-80.0,1040.0,23,ALLISON,Clam
Agrolatina,24A4433018,02/11/2025,Sale,-240.0,800.0,26,ALLISON,Clam
Agrolatina,24A4433018,02/13/2025,Sale,-240.0,560.0,28,ALLISON,Clam
Agrolatina,24A4433018,02/17/2025,Sale,-240.0,320.0,32,ALLISON,Clam
Agrolatina,24A4433018,02/19/2025,Sale,-80.0,240.0,34,ALLISON,Clam
Agrolatina,24A4433018,02/22/2025,Sale,-80.0,160.0,37,ALLISON,Clam
Agrolatina,24A4433018,02/24/2025,Sale,-80.0,80.0,39,ALLISON,Clam
Agrolatina,24A4433018,03/03/2025,Sale,-80.0,0.0,46,ALLISON,Clam
Agrolatina,24A4440022,02/20/2025,Entry,1280.0,1280.0,0,COTTON CANDY,Clam
Agrolatina,24A4440022,02/20/2025,Entry,320.0,1600.0,0,COTTON CANDY,Clam
Agrolatina,24A4440022,03/04/2025,Sale,-560.0,1040.0,12,COTTON CANDY,Clam
Agrolatina,24A4440022,03/05/2025,Sale,-640.0,400.0,13,COTTON CANDY,Clam
Agrolatina,24A4440022,03/05/2025,Sale,-80.0,320.0,13,COTTON CANDY,Clam
Agrolatina,24A4440022,03/07/2025,Sale,-80.0,240.0,15,COTTON CANDY,Clam
Agrolatina,24A4440022,03/07/2025,Sale,-80.0,160.0,15,COTTON CANDY,Clam
Agrolatina,24A4440260,02/20/2025,Entry,640.0,640.0,0,ALLISON,Clam
Agrolatina,24A4440260,02/20/2025,Entry,960.0,1600.0,0,ALLISON,Clam
Agrolatina,24A4440260,03/06/2025,Sale,-720.0,880.0,14,ALLISON,Clam
Agrolatina,24A4440260,03/11/2025,Sale,-640.0,240.0,19,ALLISON,Clam
Agrolatina,24A4440260,03/14/2025,Sale,-160.0,80.0,22,ALLISON,Clam
Agrolatina,24A4440260,03/20/2025,Sale,-80.0,0.0,28,ALLISON,Clam
Agrolatina,24A4444481,02/20/2025,Entry,800.0,800.0,0,SWEET GLOBE,Clam
Agrolatina,24A4444481,02/20/2025,Entry,800.0,1600.0,0,SWEET GLOBE,Clam
Agrolatina,24A4444481,03/03/2025,Sale,-320.0,1280.0,11,SWEET GLOBE,Clam
Agrolatina,24A4444481,03/03/2025,Sale,-80.0,1200.0,11,SWEET GLOBE,Clam
Agrolatina,24A4444481,03/03/2025,Sale,-320.0,880.0,11,SWEET GLOBE,Clam
Agrolatina,24A4444481,03/03/2025,Sale,-80.0,800.0,11,SWEET GLOBE,Clam
Agrolatina,24A4444481,03/06/2025,Sale,-10.0,790.0,14,SWEET GLOBE,Clam
Agrolatina,24A4444481,03/06/2025,Sale,-50.0,740.0,14,SWEET GLOBE,Clam
Agrolatina,24A4444481,03/10/2025,Sale,-60.0,680.0,18,SWEET GLOBE,Clam
Agrolatina,24A4444481,03/11/2025,Sale,-200.0,480.0,19,SWEET GLOBE,Clam
Agrolatina,24A4444481,03/11/2025,Sale,-140.0,340.0,19,SWEET GLOBE,Clam
Agrolatina,24A4444481,03/11/2025,Sale,-60.0,280.0,19,SWEET GLOBE,Clam
Agrolatina,24A4444481,03/14/2025,Sale,-80.0,200.0,22,SWEET GLOBE,Clam
Agrolatina,24A4452337,02/20/2025,Entry,475.0,475.0,0,IVORY,Bag
Agrolatina,24A4452337,02/20/2025,Entry,1425.0,1900.0,0,IVORY,Bag
Agrolatina,24A4452337,02/28/2025,Sale,-95.0,1805.0,8,IVORY,Bag
Agrolatina,24A4452337,03/01/2025,Sale,-95.0,1710.0,9,IVORY,Bag
Agrolatina,24A4452337,03/01/2025,Sale,-950.0,760.0,9,IVORY,Bag
Agrolatina,24A4452337,03/01/2025,Sale,-285.0,475.0,9,IVORY,Bag
Agrolatina,24A4452337,03/12/2025,Sale,-45.0,430.0,20,IVORY,Bag
Agrolatina,24A4452337,03/12/2025,Sale,-190.0,240.0,20,IVORY,Bag
Agrolatina,24A4452337,03/12/2025,Sale,-145.0,95.0,20,IVORY,Bag
Agrolatina,24A4452743,02/20/2025,Entry,960.0,960.0,0,CANDY DREAMS,Clam
Agrolatina,24A4452743,02/20/2025,Entry,640.0,1600.0,0,CANDY DREAMS,Clam
Agrolatina,24A4452743,03/01/2025,Sale,-160.0,1440.0,9,CANDY DREAMS,Clam
Agrolatina,24A4452743,03/03/2025,Sale,-560.0,880.0,11,CANDY DREAMS,Clam
Agrolatina,24A4452743,03/04/2025,Sale,-100.0,780.0,12,CANDY DREAMS,Clam
Agrolatina,24A4452743,03/04/2025,Sale,-400.0,380.0,12,CANDY DREAMS,Clam
Agrolatina,24A4452743,03/11/2025,Sale,-80.0,300.0,19,CANDY DREAMS,Clam
Agrolatina,24A4452743,04/21/2025,Sale,-80.0,220.0,60,CANDY DREAMS,Clam
Agrolatina,24A4453082,01/11/2025,Entry,1520.0,1520.0,0,ALLISON,Clam
Agrolatina,24A4453082,01/11/2025,Entry,80.0,1600.0,0,ALLISON,Clam
Agrolatina,24A4453082,01/31/2025,Sale,-400.0,1200.0,20,ALLISON,Clam
Agrolatina,24A4453082,02/03/2025,Sale,-960.0,240.0,23,ALLISON,Clam
Agrolatina,24A4453082,02/03/2025,Sale,-160.0,80.0,23,ALLISON,Clam
Agrolatina,24A4453082,02/03/2025,Sale,-80.0,0.0,23,ALLISON,Clam
Agrolatina,24A4453117,01/09/2025,Entry,1040.0,1040.0,0,SWEET GLOBE,Clam
Agrolatina,24A4453117,01/09/2025,Entry,160.0,1200.0,0,SWEET GLOBE,Clam
Agrolatina,24A4453117,01/09/2025,Entry,400.0,1600.0,0,SWEET GLOBE,Clam
Agrolatina,24A4453117,01/17/2025,Sale,-160.0,1440.0,8,SWEET GLOBE,Clam
Agrolatina,24A4453117,01/18/2025,Sale,-1040.0,400.0,9,SWEET GLOBE,Clam
Agrolatina,24A4453117,01/18/2025,Sale,-400.0,0.0,9,SWEET GLOBE,Clam
Agrolatina,24A4453328,01/09/2025,Entry,80.0,80.0,0,IVORY,Clam
Agrolatina,24A4453328,01/09/2025,Entry,1200.0,1280.0,0,SWEET GLOBE,Clam
Agrolatina,24A4453328,01/09/2025,Entry,320.0,1600.0,0,SWEET GLOBE,Clam
Agrolatina,24A4453328,01/16/2025,Sale,-160.0,1440.0,7,SWEET GLOBE,Clam
Agrolatina,24A4453328,01/21/2025,Sale,-80.0,1360.0,12,IVORY,Clam
Agrolatina,24A4453328,01/21/2025,Sale,-320.0,1040.0,12,SWEET GLOBE,Clam
Agrolatina,24A4453328,01/31/2025,Sale,-1040.0,0.0,22,SWEET GLOBE,Clam
Agrolatina,24A4453354,03/10/2025,Entry,80.0,80.0,0,AUTUMN CRISP,Clam
Agrolatina,24A4453354,03/10/2025,Entry,1520.0,1600.0,0,AUTUMN CRISP,Clam
Agrolatina,24A4453354,03/17/2025,Sale,-560.0,1040.0,7,AUTUMN CRISP,Clam
Agrolatina,24A4453354,03/19/2025,Sale,-50.0,990.0,9,AUTUMN CRISP,Clam
Agrolatina,24A4453354,03/19/2025,Sale,-30.0,960.0,9,AUTUMN CRISP,Clam
Agrolatina,24A4453354,03/19/2025,Sale,-80.0,880.0,9,AUTUMN CRISP,Clam
Agrolatina,24A4453354,03/19/2025,Sale,-800.0,80.0,9,AUTUMN CRISP,Clam
Agrolatina,24A4453354,03/19/2025,Sale,-80.0,0.0,9,AUTUMN CRISP,Clam
Agrolatina,24A4453821,01/09/2025,Entry,1360.0,1360.0,0,ALLISON,Clam
Agrolatina,24A4453821,01/09/2025,Entry,240.0,1600.0,0,ALLISON,Clam
Agrolatina,24A4453821,01/17/2025,Sale,-720.0,880.0,8,ALLISON,Clam
Agrolatina,24A4453821,01/17/2025,Sale,-240.0,640.0,8,ALLISON,Clam
Agrolatina,24A4453821,01/18/2025,Sale,-320.0,320.0,9,ALLISON,Clam
Agrolatina,24A4453821,01/18/2025,Sale,-320.0,0.0,9,ALLISON,Clam
Agrolatina,24A4461869,01/16/2025,Entry,1200.0,1200.0,0,SWEET GLOBE,Clam
Agrolatina,24A4461869,01/16/2025,Entry,400.0,1600.0,0,SWEET GLOBE,Clam
Agrolatina,24A4461869,02/04/2025,Sale,-80.0,1520.0,19,SWEET GLOBE,Clam
Agrolatina,24A4461869,02/05/2025,Sale,-160.0,1360.0,20,SWEET GLOBE,Clam
Agrolatina,24A4461869,02/05/2025,Sale,-160.0,1200.0,20,SWEET GLOBE,Clam
Agrolatina,24A4461869,02/05/2025,Sale,-160.0,1040.0,20,SWEET GLOBE,Clam
Agrolatina,24A4461869,02/05/2025,Sale,-160.0,880.0,20,SWEET GLOBE,Clam
Agrolatina,24A4461869,02/06/2025,Sale,-160.0,720.0,21,SWEET GLOBE,Clam
Agrolatina,24A4461869,02/06/2025,Sale,-80.0,640.0,21,SWEET GLOBE,Clam
Agrolatina,24A4461869,02/07/2025,Sale,-240.0,400.0,22,SWEET GLOBE,Clam
Agrolatina,24A4461869,02/12/2025,Sale,-80.0,320.0,27,SWEET GLOBE,Clam
Agrolatina,24A4461869,02/13/2025,Sale,-320.0,0.0,28,SWEET GLOBE,Clam
Agrolatina,24A4464106,02/24/2025,Entry,1280.0,1280.0,0,IVORY,Clam
Agrolatina,24A4464106,02/24/2025,Entry,320.0,1600.0,0,IVORY,Clam
Agrolatina,24A4464106,03/04/2025,Sale,-80.0,1520.0,8,IVORY,Clam
Agrolatina,24A4464106,03/12/2025,Sale,-160.0,1360.0,16,IVORY,Clam
Agrolatina,24A4464106,03/12/2025,Sale,-80.0,1280.0,16,IVORY,Clam
Agrolatina,24A4464106,03/15/2025,Sale,-240.0,1040.0,19,IVORY,Clam
Agrolatina,24A4464106,03/15/2025,Sale,-320.0,720.0,19,IVORY,Clam
Agrolatina,24A4464106,03/21/2025,Sale,-60.0,660.0,25,IVORY,Clam
Agrolatina,24A4464106,03/22/2025,Sale,-240.0,420.0,26,IVORY,Clam
Agrolatina,24A4464106,03/28/2025,Sale,-120.0,300.0,32,IVORY,Clam
Agrolatina,24A4464106,03/29/2025,Sale,-40.0,260.0,33,IVORY,Clam
Agrolatina,24A4464106,03/29/2025,Sale,-40.0,220.0,33,IVORY,Clam
Agrolatina,24A4469540,02/27/2025,Entry,1120.0,1120.0,0,SWEET GLOBE,Clam
Agrolatina,24A4469540,02/27/2025,Entry,480.0,1600.0,0,SWEET GLOBE,Clam
Agrolatina,24A4469540,03/06/2025,Sale,-480.0,1120.0,7,SWEET GLOBE,Clam
Agrolatina,24A4469540,03/08/2025,Sale,-480.0,640.0,9,SWEET GLOBE,Clam
Agrolatina,24A4469540,03/08/2025,Sale,-80.0,560.0,9,SWEET GLOBE,Clam
Agrolatina,24A4469540,03/08/2025,Sale,-80.0,480.0,9,SWEET GLOBE,Clam
Agrolatina,24A4469540,03/10/2025,Sale,-40.0,440.0,11,SWEET GLOBE,Clam
Agrolatina,24A4469540,03/12/2025,Sale,-60.0,380.0,13,SWEET GLOBE,Clam
Agrolatina,24A4469540,03/14/2025,Sale,-29.0,351.0,15,SWEET GLOBE,Clam
Agrolatina,24A4469540,03/15/2025,Sale,-160.0,191.0,16,SWEET GLOBE,Clam
Agrolatina,24A4469540,03/15/2025,Sale,-60.0,131.0,16,SWEET GLOBE,Clam
Agrolatina,24A4473094,02/11/2025,Entry,1440.0,1440.0,0,ALLISON,Clam
Agrolatina,24A4473094,02/11/2025,Entry,160.0,1600.0,0,ALLISON,Clam
Agrolatina,24A4473094,02/17/2025,Sale,-1440.0,160.0,6,ALLISON,Clam
Agrolatina,24A4473094,02/21/2025,Sale,-160.0,0.0,10,ALLISON,Clam
Agrolatina,24A4477741,03/10/2025,Entry,80.0,80.0,0,AUTUMN CRISP,Clam
Agrolatina,24A4477741,03/10/2025,Entry,1520.0,1600.0,0,AUTUMN CRISP,Clam
Agrolatina,24A4477741,03/17/2025,Sale,-80.0,1520.0,7,AUTUMN CRISP,Clam
Agrolatina,24A4477741,03/19/2025,Sale,-80.0,1440.0,9,AUTUMN CRISP,Clam
Agrolatina,24A4477741,03/19/2025,Sale,-800.0,640.0,9,AUTUMN CRISP,Clam
Agrolatina,24A4477741,03/19/2025,Sale,-160.0,480.0,9,AUTUMN CRISP,Clam
Agrolatina,24A4477741,03/19/2025,Sale,-80.0,400.0,9,AUTUMN CRISP,Clam
Agrolatina,24A4477741,03/19/2025,Sale,-160.0,240.0,9,AUTUMN CRISP,Clam
Agrolatina,24A4477741,03/19/2025,Sale,-240.0,0.0,9,AUTUMN CRISP,Clam
Agrolatina,24A4483934,02/20/2025,Entry,1040.0,1040.0,0,COTTON CANDY,Clam
Agrolatina,24A4483934,02/20/2025,Entry,560.0,1600.0,0,COTTON CANDY,Clam
Agrolatina,24A4483934,02/25/2025,Sale,-320.0,1280.0,5,COTTON CANDY,Clam
Agrolatina,24A4483934,03/04/2025,Sale,-400.0,880.0,12,COTTON CANDY,Clam
Agrolatina,24A4483934,03/04/2025,Sale,-160.0,720.0,12,COTTON CANDY,Clam
Agrolatina,24A4483934,03/05/2025,Sale,-80.0,640.0,13,COTTON CANDY,Clam
Agrolatina,24A4483934,03/07/2025,Sale,-160.0,480.0,15,COTTON CANDY,Clam
Agrolatina,24A4483934,03/17/2025,Sale,-41.0,439.0,25,COTTON CANDY,Clam
Agrolatina,24A4483934,03/21/2025,Sale,-30.0,409.0,29,COTTON CANDY,Clam
Agrolatina,24A4490424,02/20/2025,Entry,95.0,95.0,0,IVORY,Bag
Agrolatina,24A4490424,02/20/2025,Entry,1425.0,1520.0,0,SWEET GLOBE,Bag
Agrolatina,24A4490424,02/20/2025,Entry,380.0,1900.0,0,SWEET GLOBE,Bag
Agrolatina,24A4490424,02/21/2025,Sale,-190.0,1710.0,1,SWEET GLOBE,Bag
Agrolatina,24A4490424,02/24/2025,Sale,-270.0,1440.0,4,SWEET GLOBE,Bag
Agrolatina,24A4490424,02/26/2025,Sale,-180.0,1260.0,6,SWEET GLOBE,Bag
Agrolatina,24A4490424,02/27/2025,Sale,-450.0,810.0,7,SWEET GLOBE,Bag
Agrolatina,24A4490424,02/28/2025,Sale,-180.0,630.0,8,SWEET GLOBE,Bag
Agrolatina,24A4490424,02/28/2025,Sale,-270.0,360.0,8,SWEET GLOBE,Bag
Agrolatina,24A4490424,03/12/2025,Sale,-70.0,290.0,20,IVORY,Bag
Agrolatina,24A4490424,03/12/2025,Sale,-4.0,286.0,20,SWEET GLOBE,Bag
Agrolatina,24A4490424,04/01/2025,Sale,-16.0,270.0,40,SWEET GLOBE,Bag
Agrolatina,24A4492509,01/16/2025,Entry,160.0,160.0,0,IVORY,Clam
Agrolatina,24A4492509,01/16/2025,Entry,240.0,400.0,0,IVORY,Clam
Agrolatina,24A4492509,01/16/2025,Entry,960.0,1360.0,0,SWEET GLOBE,Clam
Agrolatina,24A4492509,01/16/2025,Entry,240.0,1600.0,0,SWEET GLOBE,Clam
Agrolatina,24A4492509,02/04/2025,Sale,-320.0,1280.0,19,SWEET GLOBE,Clam
Agrolatina,24A4492509,02/04/2025,Sale,-240.0,1040.0,19,SWEET GLOBE,Clam
Agrolatina,24A4492509,02/05/2025,Sale,-160.0,880.0,20,IVORY,Clam
Agrolatina,24A4492509,02/05/2025,Sale,-80.0,800.0,20,SWEET GLOBE,Clam
Agrolatina,24A4492509,02/05/2025,Sale,-80.0,720.0,20,SWEET GLOBE,Clam
Agrolatina,24A4492509,02/05/2025,Sale,-160.0,560.0,20,SWEET GLOBE,Clam
Agrolatina,24A4492509,02/05/2025,Sale,-80.0,480.0,20,SWEET GLOBE,Clam
Agrolatina,24A4492509,02/12/2025,Sale,-80.0,400.0,27,IVORY,Clam
Agrolatina,24A4492509,02/13/2025,Sale,-160.0,240.0,28,SWEET GLOBE,Clam
Agrolatina,24A4492509,02/15/2025,Sale,-80.0,160.0,30,SWEET GLOBE,Clam
Agrolatina,24A4494667,12/07/2024,Entry,1520.0,1520.0,0,CANDY SNAP,Clam
Agrolatina,24A4494667,12/07/2024,Entry,80.0,1600.0,0,CANDY SNAP,Clam
Agrolatina,24A4494667,01/06/2025,Sale,-400.0,1200.0,30,CANDY SNAP,Clam
Agrolatina,24A4494667,01/06/2025,Sale,-160.0,1040.0,30,CANDY SNAP,Clam
Agrolatina,24A4494667,01/06/2025,Sale,-960.0,80.0,30,CANDY SNAP,Clam
Agrolatina,24A4494667,01/06/2025,Sale,-80.0,0.0,30,CANDY SNAP,Clam
Agrolatina,24A4499376,01/16/2025,Entry,1120.0,1120.0,0,SWEET GLOBE,Clam
Agrolatina,24A4499376,01/16/2025,Entry,480.0,1600.0,0,SWEET GLOBE,Clam
Agrolatina,24A4499376,02/04/2025,Sale,-80.0,1520.0,19,SWEET GLOBE,Clam
Agrolatina,24A4499376,02/04/2025,Sale,-80.0,1440.0,19,SWEET GLOBE,Clam
Agrolatina,24A4499376,02/04/2025,Sale,-480.0,960.0,19,SWEET GLOBE,Clam
Agrolatina,24A4499376,02/05/2025,Sale,-80.0,880.0,20,SWEET GLOBE,Clam
Agrolatina,24A4499376,02/05/2025,Sale,-400.0,480.0,20,SWEET GLOBE,Clam
Agrolatina,24A4499376,02/05/2025,Sale,-80.0,400.0,20,SWEET GLOBE,Clam
Agrolatina,24A4499376,02/06/2025,Sale,-80.0,320.0,21,SWEET GLOBE,Clam
Agrolatina,24A4499376,02/11/2025,Sale,-80.0,240.0,26,SWEET GLOBE,Clam
Agrolatina,24A4499376,02/12/2025,Sale,-80.0,160.0,27,SWEET GLOBE,Clam
Agrolatina,24A4499376,02/13/2025,Sale,-160.0,0.0,28,SWEET GLOBE,Clam
Agrolatina,24A4501200,12/30/2024,Entry,1360.0,1360.0,0,SWEET GLOBE,Clam
Agrolatina,24A4501200,12/30/2024,Entry,240.0,1600.0,0,SWEET GLOBE,Clam
Agrolatina,24A4501200,01/17/2025,Sale,-560.0,1040.0,18,SWEET GLOBE,Clam
Agrolatina,24A4501200,01/18/2025,Sale,-240.0,800.0,19,SWEET GLOBE,Clam
Agrolatina,24A4501200,01/18/2025,Sale,-240.0,560.0,19,SWEET GLOBE,Clam
Agrolatina,24A4501200,01/19/2025,Sale,-480.0,80.0,20,SWEET GLOBE,Clam
Agrolatina,24A4501200,01/22/2025,Sale,-80.0,0.0,23,SWEET GLOBE,Clam
Agrolatina,24A4501982,12/30/2024,Entry,1200.0,1200.0,0,ALLISON,Clam
Agrolatina,24A4501982,12/30/2024,Entry,400.0,1600.0,0,ALLISON,Clam
Agrolatina,24A4501982,01/18/2025,Sale,-160.0,1440.0,19,ALLISON,Clam
Agrolatina,24A4501982,01/18/2025,Sale,-240.0,1200.0,19,ALLISON,Clam
Agrolatina,24A4501982,01/18/2025,Sale,-400.0,800.0,19,ALLISON,Clam
Agrolatina,24A4501982,01/20/2025,Sale,-800.0,0.0,21,ALLISON,Clam
Agrolatina,24A4508502,02/27/2025,Entry,640.0,640.0,0,SWEET GLOBE,Clam
Agrolatina,24A4508502,02/27/2025,Entry,160.0,800.0,0,SWEET GLOBE,Clam
Agrolatina,24A4508502,02/27/2025,Entry,800.0,1600.0,0,SWEET GLOBE,Clam
Agrolatina,24A4508502,03/05/2025,Sale,-480.0,1120.0,6,SWEET GLOBE,Clam
Agrolatina,24A4508502,03/05/2025,Sale,-80.0,1040.0,6,SWEET GLOBE,Clam
Agrolatina,24A4508502,03/08/2025,Sale,-80.0,960.0,9,SWEET GLOBE,Clam
Agrolatina,24A4508502,03/08/2025,Sale,-80.0,880.0,9,SWEET GLOBE,Clam
Agrolatina,24A4508502,03/14/2025,Sale,-320.0,560.0,15,SWEET GLOBE,Clam
Agrolatina,24A4508502,03/14/2025,Sale,-240.0,320.0,15,SWEET GLOBE,Clam
Agrolatina,24A4508502,03/17/2025,Sale,-130.0,190.0,18,SWEET GLOBE,Clam
Agrolatina,24A4508647,01/16/2025,Entry,1520.0,1520.0,0,ALLISON,Clam
Agrolatina,24A4508647,01/16/2025,Entry,80.0,1600.0,0,ALLISON,Clam
Agrolatina,24A4508647,02/04/2025,Sale,-320.0,1280.0,19,ALLISON,Clam
Agrolatina,24A4508647,02/04/2025,Sale,-80.0,1200.0,19,ALLISON,Clam
Agrolatina,24A4508647,02/05/2025,Sale,-80.0,1120.0,20,ALLISON,Clam
Agrolatina,24A4508647,02/11/2025,Sale,-560.0,560.0,26,ALLISON,Clam
Agrolatina,24A4508647,02/14/2025,Sale,-80.0,480.0,29,ALLISON,Clam
Agrolatina,24A4508647,02/17/2025,Sale,-240.0,240.0,32,ALLISON,Clam
Agrolatina,24A4508647,02/19/2025,Sale,-160.0,80.0,34,ALLISON,Clam
Agrolatina,24A4508760,02/24/2025,Entry,80.0,80.0,0,AUTUMN CRISP,Bag
Agrolatina,24A4508760,02/24/2025,Entry,880.0,960.0,0,AUTUMN CRISP,Bag
Agrolatina,24A4508760,02/24/2025,Entry,640.0,1600.0,0,AUTUMN CRISP,Bag
Agrolatina,24A4520010,02/05/2025,Entry,1140.0,1140.0,0,IVORY,Bag
Agrolatina,24A4520010,02/05/2025,Entry,760.0,1900.0,0,IVORY,Bag
Agrolatina,24A4520010,02/14/2025,Sale,-95.0,1805.0,9,IVORY,Bag
Agrolatina,24A4520010,02/18/2025,Sale,-95.0,1710.0,13,IVORY,Bag
Agrolatina,24A4520010,02/21/2025,Sale,-190.0,1520.0,16,IVORY,Bag
Agrolatina,24A4520010,03/04/2025,Sale,-475.0,1045.0,27,IVORY,Bag
Agrolatina,24A4520010,03/05/2025,Sale,-190.0,855.0,28,IVORY,Bag
Agrolatina,24A4520010,03/05/2025,Sale,-285.0,570.0,28,IVORY,Bag
Agrolatina,24A4520010,03/05/2025,Sale,-285.0,285.0,28,IVORY,Bag
Agrolatina,24A4520010,03/08/2025,Sale,-95.0,190.0,31,IVORY,Bag
Agrolatina,24A4520010,03/12/2025,Sale,-70.0,120.0,35,IVORY,Bag
Agrolatina,24A4520010,03/17/2025,Sale,-95.0,25.0,40,IVORY,Bag
Agrolatina,24A4520160,02/24/2025,Entry,800.0,800.0,0,TIMCO,Clam
Agrolatina,24A4520160,02/24/2025,Entry,800.0,1600.0,0,TIMCO,Clam
Agrolatina,24A4520160,04/22/2025,Sale,-800.0,800.0,57,TIMCO,Clam
Agrolatina,24A4520160,05/03/2025,Sale,-800.0,0.0,68,TIMCO,Clam
Agrolatina,24A4520690,02/24/2025,Entry,1600.0,1600.0,0,AUTUMN CRISP,Clam
Agrolatina,24A4520690,03/29/2025,Sale,-720.0,880.0,33,AUTUMN CRISP,Clam
Agrolatina,24A4520690,04/04/2025,Sale,-788.0,92.0,39,AUTUMN CRISP,Clam
Agrolatina,24A4520690,05/02/2025,Sale,-80.0,12.0,67,AUTUMN CRISP,Clam
Agrolatina,24A4520690,05/03/2025,Sale,-12.0,0.0,68,AUTUMN CRISP,Clam
Agrolatina,24A4520827,02/20/2025,Entry,1040.0,1040.0,0,TIMCO,Clam
Agrolatina,24A4520827,02/20/2025,Entry,560.0,1600.0,0,TIMCO,Clam
Agrolatina,24A4520827,03/09/2025,Sale,-240.0,1360.0,17,TIMCO,Clam
Agrolatina,24A4520827,03/11/2025,Sale,-880.0,480.0,19,TIMCO,Clam
Agrolatina,24A4520827,03/13/2025,Sale,-160.0,320.0,21,TIMCO,Clam
Agrolatina,24A4520827,03/14/2025,Sale,-320.0,0.0,22,TIMCO,Clam
Agrolatina,24A4520880,02/03/2025,Entry,1040.0,1040.0,0,SWEET GLOBE,Clam
Agrolatina,24A4520880,02/03/2025,Entry,560.0,1600.0,0,SWEET GLOBE,Clam
Agrolatina,24A4520880,02/19/2025,Sale,-80.0,1520.0,16,SWEET GLOBE,Clam
Agrolatina,24A4520880,02/19/2025,Sale,-80.0,1440.0,16,SWEET GLOBE,Clam
Agrolatina,24A4520880,02/20/2025,Sale,-80.0,1360.0,17,SWEET GLOBE,Clam
Agrolatina,24A4520880,02/22/2025,Sale,-400.0,960.0,19,SWEET GLOBE,Clam
Agrolatina,24A4520880,02/22/2025,Sale,-160.0,800.0,19,SWEET GLOBE,Clam
Agrolatina,24A4520880,02/22/2025,Sale,-160.0,640.0,19,SWEET GLOBE,Clam
Agrolatina,24A4520880,02/27/2025,Sale,-400.0,240.0,24,SWEET GLOBE,Clam
Agrolatina,24A4520880,03/05/2025,Sale,-160.0,80.0,30,SWEET GLOBE,Clam
Agrolatina,24A4521588,01/16/2025,Entry,1280.0,1280.0,0,ALLISON,Clam
Agrolatina,24A4521588,01/16/2025,Entry,320.0,1600.0,0,ALLISON,Clam
Agrolatina,24A4521588,02/04/2025,Sale,-80.0,1520.0,19,ALLISON,Clam
Agrolatina,24A4521588,02/04/2025,Sale,-80.0,1440.0,19,ALLISON,Clam
Agrolatina,24A4521588,02/05/2025,Sale,-80.0,1360.0,20,ALLISON,Clam
Agrolatina,24A4521588,02/06/2025,Sale,-80.0,1280.0,21,ALLISON,Clam
Agrolatina,24A4521588,02/11/2025,Sale,-80.0,1200.0,26,ALLISON,Clam
Agrolatina,24A4521588,02/12/2025,Sale,-400.0,800.0,27,ALLISON,Clam
Agrolatina,24A4521588,02/13/2025,Sale,-80.0,720.0,28,ALLISON,Clam
Agrolatina,24A4521588,02/14/2025,Sale,-240.0,480.0,29,ALLISON,Clam
Agrolatina,24A4521588,02/17/2025,Sale,-160.0,320.0,32,ALLISON,Clam
Agrolatina,24A4521588,02/19/2025,Sale,-160.0,160.0,34,ALLISON,Clam
Agrolatina,24A4521588,02/24/2025,Sale,-80.0,80.0,39,ALLISON,Clam
Agrolatina,24A4521588,03/14/2025,Sale,-50.0,30.0,57,ALLISON,Clam
Agrolatina,24A4522389,02/03/2025,Entry,1280.0,1280.0,0,SWEET GLOBE,Clam
Agrolatina,24A4522389,02/03/2025,Entry,320.0,1600.0,0,SWEET GLOBE,Clam
Agrolatina,24A4522389,02/06/2025,Sale,-80.0,1520.0,3,SWEET GLOBE,Clam
Agrolatina,24A4522389,02/07/2025,Sale,-160.0,1360.0,4,SWEET GLOBE,Clam
Agrolatina,24A4522389,02/07/2025,Sale,-80.0,1280.0,4,SWEET GLOBE,Clam
Agrolatina,24A4522389,02/08/2025,Sale,-80.0,1200.0,5,SWEET GLOBE,Clam
Agrolatina,24A4522389,02/08/2025,Sale,-160.0,1040.0,5,SWEET GLOBE,Clam
Agrolatina,24A4522389,02/08/2025,Sale,-240.0,800.0,5,SWEET GLOBE,Clam
Agrolatina,24A4522389,02/10/2025,Sale,-80.0,720.0,7,SWEET GLOBE,Clam
Agrolatina,24A4522389,02/10/2025,Sale,-80.0,640.0,7,SWEET GLOBE,Clam
Agrolatina,24A4522389,02/10/2025,Sale,-80.0,560.0,7,SWEET GLOBE,Clam
Agrolatina,24A4522389,02/11/2025,Sale,-160.0,400.0,8,SWEET GLOBE,Clam
Agrolatina,24A4522389,02/11/2025,Sale,-80.0,320.0,8,SWEET GLOBE,Clam
Agrolatina,24A4522389,02/11/2025,Sale,-80.0,240.0,8,SWEET GLOBE,Clam
Agrolatina,24A4522389,02/15/2025,Sale,-160.0,80.0,12,SWEET GLOBE,Clam
Agrolatina,24A4522389,02/18/2025,Sale,-80.0,0.0,15,SWEET GLOBE,Clam
Agrolatina,24A4526091,02/03/2025,Entry,1120.0,1120.0,0,SWEET GLOBE,Clam
Agrolatina,24A4526091,02/03/2025,Entry,480.0,1600.0,0,SWEET GLOBE,Clam
Agrolatina,24A4526091,02/21/2025,Sale,-240.0,1360.0,18,SWEET GLOBE,Clam
Agrolatina,24A4526091,02/21/2025,Sale,-80.0,1280.0,18,SWEET GLOBE,Clam
Agrolatina,24A4526091,02/22/2025,Sale,-80.0,1200.0,19,SWEET GLOBE,Clam
Agrolatina,24A4526091,02/22/2025,Sale,-320.0,880.0,19,SWEET GLOBE,Clam
Agrolatina,24A4526091,02/22/2025,Sale,-400.0,480.0,19,SWEET GLOBE,Clam
Agrolatina,24A4526091,02/26/2025,Sale,-40.0,440.0,23,SWEET GLOBE,Clam
Agrolatina,24A4526091,03/05/2025,Sale,-80.0,360.0,30,SWEET GLOBE,Clam
Agrolatina,24A4527077,02/03/2025,Entry,880.0,880.0,0,SWEET GLOBE,Clam
Agrolatina,24A4527077,02/03/2025,Entry,720.0,1600.0,0,SWEET GLOBE,Clam
Agrolatina,24A4527077,02/20/2025,Sale,-160.0,1440.0,17,SWEET GLOBE,Clam
Agrolatina,24A4527077,02/20/2025,Sale,-80.0,1360.0,17,SWEET GLOBE,Clam
Agrolatina,24A4527077,02/20/2025,Sale,-320.0,1040.0,17,SWEET GLOBE,Clam
Agrolatina,24A4527077,02/21/2025,Sale,-80.0,960.0,18,SWEET GLOBE,Clam
Agrolatina,24A4527077,02/22/2025,Sale,-160.0,800.0,19,SWEET GLOBE,Clam
Agrolatina,24A4527077,03/01/2025,Sale,-80.0,720.0,26,SWEET GLOBE,Clam
Agrolatina,24A4527077,03/05/2025,Sale,-240.0,480.0,30,SWEET GLOBE,Clam
Agrolatina,24A4527077,03/10/2025,Sale,-60.0,420.0,35,SWEET GLOBE,Clam
Agrolatina,24A4527077,03/13/2025,Sale,-20.0,400.0,38,SWEET GLOBE,Clam
Agrolatina,24A4527077,03/13/2025,Sale,-40.0,360.0,38,SWEET GLOBE,Clam
Agrolatina,24A4528941,02/20/2025,Entry,880.0,880.0,0,SWEET GLOBE,Clam
Agrolatina,24A4528941,02/20/2025,Entry,720.0,1600.0,0,SWEET GLOBE,Clam
Agrolatina,24A4528941,02/27/2025,Sale,-160.0,1440.0,7,SWEET GLOBE,Clam
Agrolatina,24A4528941,03/01/2025,Sale,-240.0,1200.0,9,SWEET GLOBE,Clam
Agrolatina,24A4528941,03/01/2025,Sale,-400.0,800.0,9,SWEET GLOBE,Clam
Agrolatina,24A4528941,03/03/2025,Sale,-240.0,560.0,11,SWEET GLOBE,Clam
Agrolatina,24A4528941,03/03/2025,Sale,-160.0,400.0,11,SWEET GLOBE,Clam
Agrolatina,24A4528941,03/03/2025,Sale,-160.0,240.0,11,SWEET GLOBE,Clam
Agrolatina,24A4528941,03/10/2025,Sale,-100.0,140.0,18,SWEET GLOBE,Clam
Agrolatina,24A4528941,03/11/2025,Sale,-60.0,80.0,19,SWEET GLOBE,Clam
Agrolatina,24A4528941,03/11/2025,Sale,-20.0,60.0,19,SWEET GLOBE,Clam
Agrolatina,24A4528941,03/12/2025,Sale,-10.0,50.0,20,SWEET GLOBE,Clam
Agrolatina,24A4532432,02/20/2025,Entry,1280.0,1280.0,0,IVORY,Clam
Agrolatina,24A4532432,02/20/2025,Entry,240.0,1520.0,0,IVORY,Clam
Agrolatina,24A4532432,02/20/2025,Entry,80.0,1600.0,0,IVORY,Clam
Agrolatina,24A4532432,02/26/2025,Sale,-960.0,640.0,6,IVORY,Clam
Agrolatina,24A4532432,02/26/2025,Sale,-160.0,480.0,6,IVORY,Clam
Agrolatina,24A4532432,02/26/2025,Sale,-240.0,240.0,6,IVORY,Clam
Agrolatina,24A4532432,03/06/2025,Sale,-80.0,160.0,14,IVORY,Clam
Agrolatina,24A4532432,03/22/2025,Sale,-20.0,140.0,30,IVORY,Clam
Agrolatina,24A4532432,03/22/2025,Sale,-40.0,100.0,30,IVORY,Clam
Agrolatina,24A4532432,03/29/2025,Sale,-40.0,60.0,37,IVORY,Clam
Agrolatina,24A4532514,02/11/2025,Entry,1140.0,1140.0,0,SWEET GLOBE,Bag
Agrolatina,24A4532514,02/11/2025,Entry,760.0,1900.0,0,SWEET GLOBE,Bag
Agrolatina,24A4532514,02/25/2025,Sale,-760.0,1140.0,14,SWEET GLOBE,Bag
Agrolatina,24A4532514,03/03/2025,Sale,-285.0,855.0,20,SWEET GLOBE,Bag
Agrolatina,24A4532514,03/04/2025,Sale,-475.0,380.0,21,SWEET GLOBE,Bag
Agrolatina,24A4532514,03/25/2025,Sale,-95.0,285.0,42,SWEET GLOBE,Bag
Agrolatina,24A4532514,03/25/2025,Sale,-285.0,0.0,42,SWEET GLOBE,Bag
Agrolatina,24A4534923,02/24/2025,Entry,720.0,720.0,0,TIMCO,Clam
Agrolatina,24A4534923,02/24/2025,Entry,880.0,1600.0,0,TIMCO,Clam
Agrolatina,24A4534923,04/21/2025,Sale,-640.0,960.0,56,TIMCO,Clam
Agrolatina,24A4534923,04/22/2025,Sale,-80.0,880.0,57,TIMCO,Clam
Agrolatina,24A4534923,04/24/2025,Sale,-720.0,160.0,59,TIMCO,Clam
Agrolatina,24A4534923,05/03/2025,Sale,-160.0,0.0,68,TIMCO,Clam
Agrolatina,24A4536741,02/24/2025,Entry,80.0,80.0,0,ALLISON,Clam
Agrolatina,24A4536741,02/24/2025,Entry,560.0,640.0,0,ALLISON,Clam
Agrolatina,24A4536741,02/24/2025,Entry,160.0,800.0,0,TIMCO,Clam
Agrolatina,24A4536741,02/24/2025,Entry,800.0,1600.0,0,TIMCO,Clam
Agrolatina,24A4536741,03/11/2025,Sale,-80.0,1520.0,15,ALLISON,Clam
Agrolatina,24A4536741,03/20/2025,Sale,-560.0,960.0,24,ALLISON,Clam
Agrolatina,24A4536741,03/24/2025,Sale,-80.0,880.0,28,TIMCO,Clam
Agrolatina,24A4536741,03/25/2025,Sale,-720.0,160.0,29,TIMCO,Clam
Agrolatina,24A4536741,03/27/2025,Sale,-80.0,80.0,31,TIMCO,Clam
Agrolatina,24A4536741,03/28/2025,Sale,-80.0,0.0,32,TIMCO,Clam
Agrolatina,24A4536931,02/24/2025,Entry,800.0,800.0,0,TIMCO,Clam
Agrolatina,24A4536931,02/24/2025,Entry,800.0,1600.0,0,TIMCO,Clam
Agrolatina,24A4536931,04/21/2025,Sale,-800.0,800.0,56,TIMCO,Clam
Agrolatina,24A4536931,05/03/2025,Sale,-800.0,0.0,68,TIMCO,Clam
Agrolatina,24A4553369,03/13/2025,Entry,320.0,320.0,0,AUTUMN CRISP,Clam
Agrolatina,24A4553369,03/13/2025,Entry,1280.0,1600.0,0,AUTUMN CRISP,Clam
Agrolatina,24A4553369,03/28/2025,Sale,-160.0,1440.0,15,AUTUMN CRISP,Clam
Agrolatina,24A4553369,03/29/2025,Sale,-320.0,1120.0,16,AUTUMN CRISP,Clam
Agrolatina,24A4553369,03/29/2025,Sale,-80.0,1040.0,16,AUTUMN CRISP,Clam
Agrolatina,24A4553369,04/01/2025,Sale,-80.0,960.0,19,AUTUMN CRISP,Clam
Agrolatina,24A4553369,04/01/2025,Sale,-960.0,0.0,19,AUTUMN CRISP,Clam
Agrolatina,24A4562864,03/10/2025,Entry,1600.0,1600.0,0,TIMCO,Clam
Agrolatina,24A4562864,03/31/2025,Sale,-640.0,960.0,21,TIMCO,Clam
Agrolatina,24A4562864,04/02/2025,Sale,-320.0,640.0,23,TIMCO,Clam
Agrolatina,24A4562864,04/05/2025,Sale,-640.0,0.0,26,TIMCO,Clam
Agrolatina,24A4746398,01/30/2025,Entry,1440.0,1440.0,0,SWEET GLOBE,Clam
Agrolatina,24A4746398,01/30/2025,Entry,160.0,1600.0,0,SWEET GLOBE,Clam
Agrolatina,24A4746398,02/15/2025,Sale,-80.0,1520.0,16,SWEET GLOBE,Clam
Agrolatina,24A4746398,02/15/2025,Sale,-480.0,1040.0,16,SWEET GLOBE,Clam
Agrolatina,24A4746398,02/17/2025,Sale,-160.0,880.0,18,SWEET GLOBE,Clam
Agrolatina,24A4746398,02/22/2025,Sale,-160.0,720.0,23,SWEET GLOBE,Clam
Agrolatina,24A4746398,02/24/2025,Sale,-15.0,705.0,25,SWEET GLOBE,Clam
Agrolatina,24A4746398,02/25/2025,Sale,-230.0,475.0,26,SWEET GLOBE,Clam
Agrolatina,24A4746398,02/28/2025,Sale,-80.0,395.0,29,SWEET GLOBE,Clam
Agrolatina,24A4746398,03/05/2025,Sale,-80.0,315.0,34,SWEET GLOBE,Clam
Agrolatina,24A5000140,02/12/2025,Entry,1520.0,1520.0,0,TIMCO,Clam
Agrolatina,24A5000140,02/12/2025,Entry,80.0,1600.0,0,TIMCO,Clam
Agrolatina,24A5000140,03/14/2025,Sale,-80.0,1520.0,30,TIMCO,Clam
Agrolatina,24A5000140,03/17/2025,Sale,-1520.0,0.0,33,TIMCO,Clam
Agrolatina,24A5000602,03/10/2025,Entry,1600.0,1600.0,0,TIMCO,Clam
Agrolatina,24A5000602,04/11/2025,Sale,-1040.0,560.0,32,TIMCO,Clam
Agrolatina,24A5000602,04/12/2025,Sale,-480.0,80.0,33,TIMCO,Clam
Agrolatina,24A5000602,04/13/2025,Sale,-80.0,0.0,34,TIMCO,Clam
Agrolatina,24A5000665,03/03/2025,Entry,1520.0,1520.0,0,TIMCO,Clam
Agrolatina,24A5000665,03/03/2025,Entry,80.0,1600.0,0,TIMCO,Clam
Agrolatina,24A5000665,03/24/2025,Sale,-960.0,640.0,21,TIMCO,Clam
Agrolatina,24A5000665,03/25/2025,Sale,-80.0,560.0,22,TIMCO,Clam
Agrolatina,24A5000665,03/27/2025,Sale,-480.0,80.0,24,TIMCO,Clam
Agrolatina,24A5000665,04/03/2025,Sale,-80.0,0.0,31,TIMCO,Clam
Agrolatina,24A5000990,01/08/2025,Sale,-560.0,-560.0,0,ALLISON,Clam
Agrolatina,24A5000990,01/09/2025,Entry,1040.0,480.0,1,ALLISON,Clam
Agrolatina,24A5000990,01/09/2025,Entry,560.0,1040.0,1,ALLISON,Clam
Agrolatina,24A5000990,01/11/2025,Sale,-960.0,80.0,3,ALLISON,Clam
Agrolatina,24A5000990,01/13/2025,Sale,-80.0,0.0,5,ALLISON,Clam
Agrolatina,24A5002204,12/29/2024,Entry,1040.0,1040.0,0,SWEET GLOBE,Clam
Agrolatina,24A5002204,12/29/2024,Entry,560.0,1600.0,0,SWEET GLOBE,Clam
Agrolatina,24A5002204,01/07/2025,Sale,-480.0,1120.0,9,SWEET GLOBE,Clam
Agrolatina,24A5002204,01/09/2025,Sale,-560.0,560.0,11,SWEET GLOBE,Clam
Agrolatina,24A5002204,01/09/2025,Sale,-560.0,0.0,11,SWEET GLOBE,Clam
Agrolatina,24A5002210,03/31/2025,Entry,1200.0,1200.0,0,JACK SALUTE,Clam
Agrolatina,24A5002210,03/31/2025,Entry,400.0,1600.0,0,JACK SALUTE,Clam
Agrolatina,24A5002210,04/12/2025,Sale,-1200.0,400.0,12,JACK SALUTE,Clam
Agrolatina,24A5002210,04/16/2025,Sale,-400.0,0.0,16,JACK SALUTE,Clam
Agrolatina,24A5002396,02/24/2025,Entry,880.0,880.0,0,TIMCO,Clam
Agrolatina,24A5002396,02/24/2025,Entry,720.0,1600.0,0,TIMCO,Clam
Agrolatina,24A5002518,02/17/2025,Entry,1040.0,1040.0,0,TIMCO,Clam
Agrolatina,24A5002518,02/17/2025,Entry,560.0,1600.0,0,TIMCO,Clam
Agrolatina,24A5002518,03/13/2025,Sale,-640.0,960.0,24,TIMCO,Clam
Agrolatina,24A5002518,03/13/2025,Sale,-320.0,640.0,24,TIMCO,Clam
Agrolatina,24A5002518,03/17/2025,Sale,-80.0,560.0,28,TIMCO,Clam
Agrolatina,24A5002518,03/27/2025,Sale,-560.0,0.0,38,TIMCO,Clam
Agrolatina,24A5003140,12/30/2024,Entry,1440.0,1440.0,0,ALLISON,Clam
Agrolatina,24A5003140,12/30/2024,Entry,160.0,1600.0,0,ALLISON,Clam
Agrolatina,24A5003140,01/18/2025,Sale,-160.0,1440.0,19,ALLISON,Clam
Agrolatina,24A5003140,01/20/2025,Sale,-80.0,1360.0,21,ALLISON,Clam
Agrolatina,24A5003140,01/21/2025,Sale,-1200.0,160.0,22,ALLISON,Clam
Agrolatina,24A5003140,01/22/2025,Sale,-80.0,80.0,23,ALLISON,Clam
Agrolatina,24A5003140,01/23/2025,Sale,-80.0,0.0,24,ALLISON,Clam
Agrolatina,24A5008780,03/31/2025,Entry,800.0,800.0,0,JACK SALUTE,Clam
Agrolatina,24A5008780,03/31/2025,Entry,800.0,1600.0,0,JACK SALUTE,Clam
Agrolatina,24A5008780,04/12/2025,Sale,-400.0,1200.0,12,JACK SALUTE,Clam
Agrolatina,24A5008780,04/15/2025,Sale,-240.0,960.0,15,JACK SALUTE,Clam
Agrolatina,24A5008780,04/15/2025,Sale,-160.0,800.0,15,JACK SALUTE,Clam
Agrolatina,24A5008780,04/16/2025,Sale,-640.0,160.0,16,JACK SALUTE,Clam
Agrolatina,24A5008780,04/26/2025,Sale,-160.0,0.0,26,JACK SALUTE,Clam
Agrolatina,24A5010283,04/23/2025,Entry,880.0,880.0,0,SWEET GLOBE,Clam
Agrolatina,24A5010283,04/23/2025,Entry,720.0,1600.0,0,SWEET GLOBE,Clam
Agrolatina,24A5010283,05/07/2025,Sale,-880.0,720.0,14,SWEET GLOBE,Clam
Agrolatina,24A5010283,05/07/2025,Sale,-720.0,0.0,14,SWEET GLOBE,Clam
Agrolatina,24A5018432,02/24/2025,Entry,960.0,960.0,0,COTTON CANDY,Clam
Agrolatina,24A5018432,02/24/2025,Entry,640.0,1600.0,0,COTTON CANDY,Clam
Agrolatina,24A5018432,03/21/2025,Sale,-480.0,1120.0,25,COTTON CANDY,Clam
Agrolatina,24A5018432,03/27/2025,Sale,-400.0,720.0,31,COTTON CANDY,Clam
Agrolatina,24A5018432,03/27/2025,Sale,-160.0,560.0,31,COTTON CANDY,Clam
Agrolatina,24A5018432,03/28/2025,Sale,-240.0,320.0,32,COTTON CANDY,Clam
Agrolatina,24A5018432,03/28/2025,Sale,-80.0,240.0,32,COTTON CANDY,Clam
Agrolatina,24A5018432,03/28/2025,Sale,-73.0,167.0,32,COTTON CANDY,Clam
Agrolatina,24A5018643,02/17/2025,Entry,720.0,720.0,0,AUTUMN CRISP,Clam
Agrolatina,24A5018643,02/17/2025,Entry,880.0,1600.0,0,AUTUMN CRISP,Clam
Agrolatina,24A5018643,03/04/2025,Sale,-880.0,720.0,15,AUTUMN CRISP,Clam
Agrolatina,24A5018643,03/15/2025,Sale,-720.0,0.0,26,AUTUMN CRISP,Clam
Agrolatina,24A5018788,12/16/2024,Entry,880.0,880.0,0,IVORY,Clam
Agrolatina,24A5018788,12/16/2024,Entry,160.0,1040.0,0,IVORY,Clam
Agrolatina,24A5018788,12/16/2024,Entry,560.0,1600.0,0,IVORY,Clam
Agrolatina,24A5018788,12/23/2024,Sale,-880.0,720.0,7,IVORY,Clam
Agrolatina,24A5018788,12/23/2024,Sale,-160.0,560.0,7,IVORY,Clam
Agrolatina,24A5018788,12/23/2024,Sale,-560.0,0.0,7,IVORY,Clam
Agrolatina,24A5019742,02/10/2025,Entry,1280.0,1280.0,0,TIMCO,Clam
Agrolatina,24A5019742,02/10/2025,Entry,320.0,1600.0,0,TIMCO,Clam
Agrolatina,24A5019742,03/06/2025,Sale,-320.0,1280.0,24,TIMCO,Clam
Agrolatina,24A5019742,03/07/2025,Sale,-400.0,880.0,25,TIMCO,Clam
Agrolatina,24A5019742,03/10/2025,Sale,-880.0,0.0,28,TIMCO,Clam
Agrolatina,24A5020050,01/23/2025,Entry,640.0,640.0,0,AUTUMN CRISP,Clam
Agrolatina,24A5020050,01/23/2025,Entry,960.0,1600.0,0,AUTUMN CRISP,Clam
Agrolatina,24A5020050,02/01/2025,Sale,-800.0,800.0,9,AUTUMN CRISP,Clam
Agrolatina,24A5020050,02/05/2025,Sale,-80.0,720.0,13,AUTUMN CRISP,Clam
Agrolatina,24A5020050,02/11/2025,Sale,-560.0,160.0,19,AUTUMN CRISP,Clam
Agrolatina,24A5020050,02/21/2025,Sale,-160.0,0.0,29,AUTUMN CRISP,Clam
Agrolatina,24A5020229,01/13/2025,Entry,1200.0,1200.0,0,SWEET FAVORS,Clam
Agrolatina,24A5020229,01/13/2025,Entry,400.0,1600.0,0,SWEET FAVORS,Clam
Agrolatina,24A5020229,01/21/2025,Sale,-960.0,640.0,8,SWEET FAVORS,Clam
Agrolatina,24A5020229,01/21/2025,Sale,-400.0,240.0,8,SWEET FAVORS,Clam
Agrolatina,24A5020229,01/22/2025,Sale,-240.0,0.0,9,SWEET FAVORS,Clam
Agrolatina,24A5020234,01/13/2025,Entry,1280.0,1280.0,0,SWEET GLOBE,Clam
Agrolatina,24A5020234,01/13/2025,Entry,320.0,1600.0,0,SWEET GLOBE,Clam
Agrolatina,24A5020234,01/21/2025,Sale,-80.0,1520.0,8,SWEET GLOBE,Clam
Agrolatina,24A5020234,01/22/2025,Sale,-1280.0,240.0,9,SWEET GLOBE,Clam
Agrolatina,24A5020234,01/29/2025,Sale,-240.0,0.0,16,SWEET GLOBE,Clam
Agrolatina,24A5020300,01/30/2025,Entry,80.0,80.0,0,SWEET FAVORS,Clam
Agrolatina,24A5020300,01/30/2025,Entry,1520.0,1600.0,0,SWEET FAVORS,Clam
Agrolatina,24A5020300,02/08/2025,Sale,-640.0,960.0,9,SWEET FAVORS,Clam
Agrolatina,24A5020300,02/08/2025,Sale,-80.0,880.0,9,SWEET FAVORS,Clam
Agrolatina,24A5020300,02/11/2025,Sale,-480.0,400.0,12,SWEET FAVORS,Clam
Agrolatina,24A5020300,02/11/2025,Sale,-80.0,320.0,12,SWEET FAVORS,Clam
Agrolatina,24A5020300,02/15/2025,Sale,-240.0,80.0,16,SWEET FAVORS,Clam
Agrolatina,24A5020300,02/18/2025,Sale,-80.0,0.0,19,SWEET FAVORS,Clam
Agrolatina,24A5020379,01/13/2025,Entry,1520.0,1520.0,0,IVORY,Clam
Agrolatina,24A5020379,01/13/2025,Entry,80.0,1600.0,0,IVORY,Clam
Agrolatina,24A5020379,01/22/2025,Sale,-1520.0,80.0,9,IVORY,Clam
Agrolatina,24A5020379,01/23/2025,Sale,-80.0,0.0,10,IVORY,Clam
Agrolatina,24A5020384,01/13/2025,Entry,1600.0,1600.0,0,SWEET FAVORS,Clam
Agrolatina,24A5020384,01/22/2025,Sale,-160.0,1440.0,9,SWEET FAVORS,Clam
Agrolatina,24A5020384,01/22/2025,Sale,-1440.0,0.0,9,SWEET FAVORS,Clam
Agrolatina,24A5020424,01/30/2025,Entry,640.0,640.0,0,CANDY DREAMS,Clam
Agrolatina,24A5020424,01/30/2025,Entry,960.0,1600.0,0,CANDY DREAMS,Clam
Agrolatina,24A5020424,03/03/2025,Sale,-320.0,1280.0,32,CANDY DREAMS,Clam
Agrolatina,24A5020424,03/05/2025,Sale,-320.0,960.0,34,CANDY DREAMS,Clam
Agrolatina,24A5020424,03/06/2025,Sale,-615.0,345.0,35,CANDY DREAMS,Clam
Agrolatina,24A5020424,03/06/2025,Sale,-284.0,61.0,35,CANDY DREAMS,Clam
Agrolatina,24A5020445,03/10/2025,Entry,1360.0,1360.0,0,TIMCO,Clam
Agrolatina,24A5020445,03/10/2025,Entry,240.0,1600.0,0,TIMCO,Clam
Agrolatina,24A5020445,04/03/2025,Sale,-80.0,1520.0,24,TIMCO,Clam
Agrolatina,24A5020445,04/09/2025,Sale,-160.0,1360.0,30,TIMCO,Clam
Agrolatina,24A5020445,04/13/2025,Sale,-1360.0,0.0,34,TIMCO,Clam
Agrolatina,24A5020580,01/23/2025,Entry,1600.0,1600.0,0,ALLISON,Clam
Agrolatina,24A5020580,02/06/2025,Sale,-1040.0,560.0,14,ALLISON,Clam
Agrolatina,24A5020580,02/11/2025,Sale,-560.0,0.0,19,ALLISON,Clam
Agrolatina,24A5020635,01/13/2025,Entry,1600.0,1600.0,0,SWEET FAVORS,Clam
Agrolatina,24A5020635,01/18/2025,Sale,-720.0,880.0,5,SWEET FAVORS,Clam
Agrolatina,24A5020635,01/18/2025,Sale,-880.0,0.0,5,SWEET FAVORS,Clam
Agrolatina,24A5020656,01/13/2025,Entry,1360.0,1360.0,0,SWEET FAVORS,Clam
Agrolatina,24A5020656,01/13/2025,Entry,240.0,1600.0,0,SWEET FAVORS,Clam
Agrolatina,24A5020656,01/18/2025,Sale,-880.0,720.0,5,SWEET FAVORS,Clam
Agrolatina,24A5020656,01/20/2025,Sale,-480.0,240.0,7,SWEET FAVORS,Clam
Agrolatina,24A5020656,01/21/2025,Sale,-240.0,0.0,8,SWEET FAVORS,Clam
Agrolatina,24A5020661,01/30/2025,Entry,240.0,240.0,0,CANDY DREAMS,Clam
Agrolatina,24A5020661,01/30/2025,Entry,1360.0,1600.0,0,CANDY DREAMS,Clam
Agrolatina,24A5020661,03/06/2025,Sale,-190.0,1410.0,35,CANDY DREAMS,Clam
Agrolatina,24A5020661,03/06/2025,Sale,-30.0,1380.0,35,CANDY DREAMS,Clam
Agrolatina,24A5020661,03/06/2025,Sale,-770.0,610.0,35,CANDY DREAMS,Clam
Agrolatina,24A5020661,03/07/2025,Sale,-320.0,290.0,36,CANDY DREAMS,Clam
Agrolatina,24A5020661,03/07/2025,Sale,-38.0,252.0,36,CANDY DREAMS,Clam
Agrolatina,24A5020661,03/11/2025,Sale,-160.0,92.0,40,CANDY DREAMS,Clam
Agrolatina,24A5020701,01/13/2025,Entry,1360.0,1360.0,0,CANDY DREAMS,Clam
Agrolatina,24A5020701,01/13/2025,Entry,240.0,1600.0,0,CANDY DREAMS,Clam
Agrolatina,24A5020701,01/25/2025,Sale,-160.0,1440.0,12,CANDY DREAMS,Clam
Agrolatina,24A5020701,01/25/2025,Sale,-720.0,720.0,12,CANDY DREAMS,Clam
Agrolatina,24A5020701,01/27/2025,Sale,-320.0,400.0,14,CANDY DREAMS,Clam
Agrolatina,24A5020701,01/27/2025,Sale,-240.0,160.0,14,CANDY DREAMS,Clam
Agrolatina,24A5020701,02/25/2025,Sale,-80.0,80.0,43,CANDY DREAMS,Clam
Agrolatina,24A5020701,03/01/2025,Sale,-5.0,75.0,47,CANDY DREAMS,Clam
Agrolatina,24A5020701,03/06/2025,Sale,-57.0,18.0,52,CANDY DREAMS,Clam
Agrolatina,24A5020722,01/30/2025,Entry,720.0,720.0,0,AUTUMN CRISP,Clam
Agrolatina,24A5020722,01/30/2025,Entry,880.0,1600.0,0,AUTUMN CRISP,Clam
Agrolatina,24A5020722,02/17/2025,Sale,-720.0,880.0,18,AUTUMN CRISP,Clam
Agrolatina,24A5020722,02/17/2025,Sale,-400.0,480.0,18,AUTUMN CRISP,Clam
Agrolatina,24A5020722,02/17/2025,Sale,-480.0,0.0,18,AUTUMN CRISP,Clam
Agrolatina,24A5020804,01/13/2025,Entry,1520.0,1520.0,0,SWEET FAVORS,Clam
Agrolatina,24A5020804,01/13/2025,Entry,80.0,1600.0,0,SWEET FAVORS,Clam
Agrolatina,24A5020804,02/19/2025,Sale,-80.0,1520.0,37,SWEET FAVORS,Clam
Agrolatina,24A5020804,02/19/2025,Sale,-80.0,1440.0,37,SWEET FAVORS,Clam
Agrolatina,24A5020804,02/22/2025,Sale,-640.0,800.0,40,SWEET FAVORS,Clam
Agrolatina,24A5020804,02/25/2025,Sale,-480.0,320.0,43,SWEET FAVORS,Clam
Agrolatina,24A5020804,02/26/2025,Sale,-320.0,0.0,44,SWEET FAVORS,Clam
Agrolatina,24A5020888,01/20/2025,Entry,960.0,960.0,0,SWEET GLOBE,Clam
Agrolatina,24A5020888,01/20/2025,Entry,640.0,1600.0,0,SWEET GLOBE,Clam
Agrolatina,24A5020888,01/29/2025,Sale,-880.0,720.0,9,SWEET GLOBE,Clam
Agrolatina,24A5020888,01/29/2025,Sale,-80.0,640.0,9,SWEET GLOBE,Clam
Agrolatina,24A5020888,01/29/2025,Sale,-480.0,160.0,9,SWEET GLOBE,Clam
Agrolatina,24A5020888,01/30/2025,Sale,-80.0,80.0,10,SWEET GLOBE,Clam
Agrolatina,24A5020888,01/30/2025,Sale,-80.0,0.0,10,SWEET GLOBE,Clam
Agrolatina,24A5020980,01/20/2025,Entry,480.0,480.0,0,SWEET GLOBE,Clam
Agrolatina,24A5020980,01/20/2025,Entry,1120.0,1600.0,0,SWEET GLOBE,Clam
Agrolatina,24A5020980,01/30/2025,Sale,-480.0,1120.0,10,SWEET GLOBE,Clam
Agrolatina,24A5020980,01/30/2025,Sale,-800.0,320.0,10,SWEET GLOBE,Clam
Agrolatina,24A5020980,01/31/2025,Sale,-320.0,0.0,11,SWEET GLOBE,Clam
Agrolatina,24A5021190,01/13/2025,Entry,1440.0,1440.0,0,IVORY,Clam
Agrolatina,24A5021190,01/13/2025,Entry,160.0,1600.0,0,IVORY,Clam
Agrolatina,24A5021190,01/18/2025,Sale,-160.0,1440.0,5,IVORY,Clam
Agrolatina,24A5021190,01/18/2025,Sale,-720.0,720.0,5,IVORY,Clam
Agrolatina,24A5021190,01/20/2025,Sale,-560.0,160.0,7,IVORY,Clam
Agrolatina,24A5021190,01/20/2025,Sale,-160.0,0.0,7,IVORY,Clam
Agrolatina,24A5021272,01/13/2025,Entry,1330.0,1330.0,0,SWEET GLOBE,Bag
Agrolatina,24A5021272,01/13/2025,Entry,190.0,1520.0,0,SWEET GLOBE,Bag
Agrolatina,24A5021272,01/13/2025,Entry,380.0,1900.0,0,SWEET GLOBE,Bag
Agrolatina,24A5021272,01/23/2025,Sale,-760.0,1140.0,10,SWEET GLOBE,Bag
Agrolatina,24A5021272,01/24/2025,Sale,-190.0,950.0,11,SWEET GLOBE,Bag
Agrolatina,24A5021272,01/27/2025,Sale,-95.0,855.0,14,SWEET GLOBE,Bag
Agrolatina,24A5021272,01/27/2025,Sale,-475.0,380.0,14,SWEET GLOBE,Bag
Agrolatina,24A5021272,01/27/2025,Sale,-380.0,0.0,14,SWEET GLOBE,Bag
Agrolatina,24A5021436,01/20/2025,Entry,80.0,80.0,0,AUTUMN CRISP,Clam
Agrolatina,24A5021436,01/20/2025,Entry,1200.0,1280.0,0,AUTUMN CRISP,Clam
Agrolatina,24A5021436,01/20/2025,Entry,320.0,1600.0,0,AUTUMN CRISP,Clam
Agrolatina,24A5021436,01/31/2025,Sale,-1200.0,400.0,11,AUTUMN CRISP,Clam
Agrolatina,24A5021436,02/05/2025,Sale,-80.0,320.0,16,AUTUMN CRISP,Clam
Agrolatina,24A5021436,02/08/2025,Sale,-160.0,160.0,19,AUTUMN CRISP,Clam
Agrolatina,24A5021436,02/12/2025,Sale,-80.0,80.0,23,AUTUMN CRISP,Clam
Agrolatina,24A5021436,02/21/2025,Sale,-80.0,0.0,32,AUTUMN CRISP,Clam
Agrolatina,24A5021462,01/20/2025,Entry,1120.0,1120.0,0,AUTUMN CRISP,Clam
Agrolatina,24A5021462,01/20/2025,Entry,480.0,1600.0,0,AUTUMN CRISP,Clam
Agrolatina,24A5021462,01/31/2025,Sale,-240.0,1360.0,11,AUTUMN CRISP,Clam
Agrolatina,24A5021462,02/01/2025,Sale,-720.0,640.0,12,AUTUMN CRISP,Clam
Agrolatina,24A5021462,02/05/2025,Sale,-160.0,480.0,16,AUTUMN CRISP,Clam
Agrolatina,24A5021462,02/08/2025,Sale,-480.0,0.0,19,AUTUMN CRISP,Clam
Agrolatina,24A5021483,01/13/2025,Entry,1440.0,1440.0,0,IVORY,Clam
Agrolatina,24A5021483,01/13/2025,Entry,160.0,1600.0,0,IVORY,Clam
Agrolatina,24A5021483,01/17/2025,Sale,-480.0,1120.0,4,IVORY,Clam
Agrolatina,24A5021483,01/17/2025,Sale,-480.0,640.0,4,IVORY,Clam
Agrolatina,24A5021483,01/17/2025,Sale,-160.0,480.0,4,IVORY,Clam
Agrolatina,24A5021483,01/23/2025,Sale,-480.0,0.0,10,IVORY,Clam
Agrolatina,24A5022999,01/30/2025,Entry,640.0,640.0,0,AUTUMN CRISP,Clam
Agrolatina,24A5022999,01/30/2025,Entry,960.0,1600.0,0,AUTUMN CRISP,Clam
Agrolatina,24A5022999,02/08/2025,Sale,-960.0,640.0,9,AUTUMN CRISP,Clam
Agrolatina,24A5022999,02/11/2025,Sale,-640.0,0.0,12,AUTUMN CRISP,Clam
Agrolatina,24A5023043,01/23/2025,Entry,1045.0,1045.0,0,SWEET GLOBE,Bag
Agrolatina,24A5023043,01/23/2025,Entry,95.0,1140.0,0,SWEET GLOBE,Bag
Agrolatina,24A5023043,01/23/2025,Entry,760.0,1900.0,0,SWEET GLOBE,Bag
Agrolatina,24A5023043,02/03/2025,Sale,-95.0,1805.0,11,SWEET GLOBE,Bag
Agrolatina,24A5023043,02/03/2025,Sale,-760.0,1045.0,11,SWEET GLOBE,Bag
Agrolatina,24A5023043,02/10/2025,Sale,-190.0,855.0,18,SWEET GLOBE,Bag
Agrolatina,24A5023043,02/11/2025,Sale,-95.0,760.0,19,SWEET GLOBE,Bag
Agrolatina,24A5023043,02/12/2025,Sale,-190.0,570.0,20,SWEET GLOBE,Bag
Agrolatina,24A5023043,02/22/2025,Sale,-3.0,567.0,30,SWEET GLOBE,Bag
Agrolatina,24A5023043,02/24/2025,Sale,-60.0,507.0,32,SWEET GLOBE,Bag
Agrolatina,24A5023043,03/11/2025,Sale,-95.0,412.0,47,SWEET GLOBE,Bag
Agrolatina,24A5023043,03/12/2025,Sale,-20.0,392.0,48,SWEET GLOBE,Bag
Agrolatina,24A5023193,01/15/2025,Entry,640.0,640.0,0,ALLISON,Clam
Agrolatina,24A5023193,01/15/2025,Entry,960.0,1600.0,0,ALLISON,Clam
Agrolatina,24A5023193,02/03/2025,Sale,-560.0,1040.0,19,ALLISON,Clam
Agrolatina,24A5023193,02/03/2025,Sale,-240.0,800.0,19,ALLISON,Clam
Agrolatina,24A5023193,02/06/2025,Sale,-80.0,720.0,22,ALLISON,Clam
Agrolatina,24A5023193,02/06/2025,Sale,-720.0,0.0,22,ALLISON,Clam
Agrolatina,24A5023207,01/13/2025,Entry,960.0,960.0,0,SWEET GLOBE,Clam
Agrolatina,24A5023207,01/13/2025,Entry,640.0,1600.0,0,SWEET GLOBE,Clam
Agrolatina,24A5023207,01/18/2025,Sale,-960.0,640.0,5,SWEET GLOBE,Clam
Agrolatina,24A5023207,01/18/2025,Sale,-640.0,0.0,5,SWEET GLOBE,Clam
Agrolatina,24A5023228,01/23/2025,Entry,800.0,800.0,0,ALLISON,Clam
Agrolatina,24A5023228,01/23/2025,Entry,800.0,1600.0,0,ALLISON,Clam
Agrolatina,24A5023228,02/06/2025,Sale,-560.0,1040.0,14,ALLISON,Clam
Agrolatina,24A5023228,02/10/2025,Sale,-240.0,800.0,18,ALLISON,Clam
Agrolatina,24A5023228,02/11/2025,Sale,-160.0,640.0,19,ALLISON,Clam
Agrolatina,24A5023228,02/11/2025,Sale,-80.0,560.0,19,ALLISON,Clam
Agrolatina,24A5023228,02/11/2025,Sale,-560.0,0.0,19,ALLISON,Clam
Agrolatina,24A5139044,02/17/2025,Entry,640.0,640.0,0,SWEET GLOBE,Clam
Agrolatina,24A5139044,02/17/2025,Entry,960.0,1600.0,0,SWEET GLOBE,Clam
Agrolatina,24A5139044,03/05/2025,Sale,-240.0,1360.0,16,SWEET GLOBE,Clam
Agrolatina,24A5139044,03/07/2025,Sale,-400.0,960.0,18,SWEET GLOBE,Clam
Agrolatina,24A5139044,03/08/2025,Sale,-80.0,880.0,19,SWEET GLOBE,Clam
Agrolatina,24A5139044,03/08/2025,Sale,-80.0,800.0,19,SWEET GLOBE,Clam
Agrolatina,24A5139044,03/08/2025,Sale,-80.0,720.0,19,SWEET GLOBE,Clam
Agrolatina,24A5139044,03/10/2025,Sale,-200.0,520.0,21,SWEET GLOBE,Clam
Agrolatina,24A5139044,03/11/2025,Sale,-50.0,470.0,22,SWEET GLOBE,Clam
Agrolatina,24A5139044,03/11/2025,Sale,-160.0,310.0,22,SWEET GLOBE,Clam
Agrolatina,24A5139044,03/14/2025,Sale,-40.0,270.0,25,SWEET GLOBE,Clam
Agrolatina,24A5139044,03/15/2025,Sale,-40.0,230.0,26,SWEET GLOBE,Clam
Agrolatina,24A5139044,03/17/2025,Sale,-20.0,210.0,28,SWEET GLOBE,Clam
Agrolatina,24A5143234,02/11/2025,Entry,1040.0,1040.0,0,SWEET GLOBE,Clam
Agrolatina,24A5143234,02/11/2025,Entry,560.0,1600.0,0,SWEET GLOBE,Clam
Agrolatina,24A5143234,02/22/2025,Sale,-1040.0,560.0,11,SWEET GLOBE,Clam
Agrolatina,24A5143234,02/22/2025,Sale,-560.0,0.0,11,SWEET GLOBE,Clam
Agrolatina,24A5293311,01/30/2025,Entry,1120.0,1120.0,0,ALLISON,Clam
Agrolatina,24A5293311,01/30/2025,Entry,480.0,1600.0,0,ALLISON,Clam
Agrolatina,24A5293311,02/15/2025,Sale,-1120.0,480.0,16,ALLISON,Clam
Agrolatina,24A5293311,03/01/2025,Sale,-480.0,0.0,30,ALLISON,Clam
Agrolatina,24A5293543,01/20/2025,Entry,80.0,80.0,0,AUTUMN CRISP,Clam
Agrolatina,24A5293543,01/20/2025,Entry,560.0,640.0,0,AUTUMN CRISP,Clam
Agrolatina,24A5293543,01/20/2025,Entry,960.0,1600.0,0,AUTUMN CRISP,Clam
Agrolatina,24A5293543,02/05/2025,Sale,-80.0,1520.0,16,AUTUMN CRISP,Clam
Agrolatina,24A5293543,02/05/2025,Sale,-560.0,960.0,16,AUTUMN CRISP,Clam
Agrolatina,24A5293543,02/08/2025,Sale,-320.0,640.0,19,AUTUMN CRISP,Clam
Agrolatina,24A5293543,02/12/2025,Sale,-640.0,0.0,23,AUTUMN CRISP,Clam
Agrolatina,24A5293693,01/13/2025,Entry,1440.0,1440.0,0,SWEET GLOBE,Clam
Agrolatina,24A5293693,01/13/2025,Entry,160.0,1600.0,0,SWEET GLOBE,Clam
Agrolatina,24A5293693,01/17/2025,Sale,-1440.0,160.0,4,SWEET GLOBE,Clam
Agrolatina,24A5293693,01/18/2025,Sale,-160.0,0.0,5,SWEET GLOBE,Clam
Agrolatina,24A5293841,01/30/2025,Entry,1120.0,1120.0,0,ALLISON,Clam
Agrolatina,24A5293841,01/30/2025,Entry,480.0,1600.0,0,ALLISON,Clam
Agrolatina,24A5293841,02/11/2025,Sale,-320.0,1280.0,12,ALLISON,Clam
Agrolatina,24A5293841,02/11/2025,Sale,-800.0,480.0,12,ALLISON,Clam
Agrolatina,24A5293841,02/11/2025,Sale,-480.0,0.0,12,ALLISON,Clam
Agrolatina,24A5293991,01/20/2025,Entry,1200.0,1200.0,0,SWEET GLOBE,Clam
Agrolatina,24A5293991,01/20/2025,Entry,400.0,1600.0,0,SWEET GLOBE,Clam
Agrolatina,24A5293991,01/28/2025,Sale,-1200.0,400.0,8,SWEET GLOBE,Clam
Agrolatina,24A5293991,01/28/2025,Sale,-320.0,80.0,8,SWEET GLOBE,Clam
Agrolatina,24A5293991,01/29/2025,Sale,-80.0,0.0,9,SWEET GLOBE,Clam
Agrolatina,24A5294072,01/30/2025,Entry,1120.0,1120.0,0,SWEET GLOBE,Clam
Agrolatina,24A5294072,01/30/2025,Entry,480.0,1600.0,0,SWEET GLOBE,Clam
Agrolatina,24A5294072,02/19/2025,Sale,-1120.0,480.0,20,SWEET GLOBE,Clam
Agrolatina,24A5294072,02/19/2025,Sale,-480.0,0.0,20,SWEET GLOBE,Clam
Agrolatina,24A5294215,01/20/2025,Entry,480.0,480.0,0,SWEET GLOBE,Clam
Agrolatina,24A5294215,01/20/2025,Entry,1120.0,1600.0,0,SWEET GLOBE,Clam
Agrolatina,24A5294215,01/31/2025,Sale,-320.0,1280.0,11,SWEET GLOBE,Clam
Agrolatina,24A5294215,02/07/2025,Sale,-80.0,1200.0,18,SWEET GLOBE,Clam
Agrolatina,24A5294215,02/08/2025,Sale,-80.0,1120.0,19,SWEET GLOBE,Clam
Agrolatina,24A5294215,02/08/2025,Sale,-1120.0,0.0,19,SWEET GLOBE,Clam
Agrolatina,24A5294344,01/20/2025,Entry,720.0,720.0,0,ALLISON,Clam
Agrolatina,24A5294344,01/20/2025,Entry,880.0,1600.0,0,ALLISON,Clam
Agrolatina,24A5294344,02/03/2025,Sale,-320.0,1280.0,14,ALLISON,Clam
Agrolatina,24A5294344,02/05/2025,Sale,-240.0,1040.0,16,ALLISON,Clam
Agrolatina,24A5294344,02/06/2025,Sale,-160.0,880.0,17,ALLISON,Clam
Agrolatina,24A5294344,02/06/2025,Sale,-880.0,0.0,17,ALLISON,Clam
Agrolatina,24A5294365,01/20/2025,Entry,1280.0,1280.0,0,IVORY,Clam
Agrolatina,24A5294365,01/20/2025,Entry,80.0,1360.0,0,IVORY,Clam
Agrolatina,24A5294365,01/20/2025,Entry,240.0,1600.0,0,IVORY,Clam
Agrolatina,24A5294365,01/31/2025,Sale,-1280.0,320.0,11,IVORY,Clam
Agrolatina,24A5294365,01/31/2025,Sale,-80.0,240.0,11,IVORY,Clam
Agrolatina,24A5294365,01/31/2025,Sale,-240.0,0.0,11,IVORY,Clam
Agrolatina,24A5294540,01/13/2025,Entry,1600.0,1600.0,0,SWEET FAVORS,Clam
Agrolatina,24A5294540,01/23/2025,Sale,-640.0,960.0,10,SWEET FAVORS,Clam
Agrolatina,24A5294540,01/28/2025,Sale,-80.0,880.0,15,SWEET FAVORS,Clam
Agrolatina,24A5294540,02/01/2025,Sale,-880.0,0.0,19,SWEET FAVORS,Clam
Agrolatina,24A5294940,01/30/2025,Entry,1120.0,1120.0,0,ALLISON,Clam
Agrolatina,24A5294940,01/30/2025,Entry,480.0,1600.0,0,ALLISON,Clam
Agrolatina,24A5294940,02/15/2025,Sale,-800.0,800.0,16,ALLISON,Clam
Agrolatina,24A5294940,03/01/2025,Sale,-320.0,480.0,30,ALLISON,Clam
Agrolatina,24A5294940,03/01/2025,Sale,-480.0,0.0,30,ALLISON,Clam
Agrolatina,24A5364641,01/30/2025,Entry,640.0,640.0,0,SWEET GLOBE,Clam
Agrolatina,24A5364641,01/30/2025,Entry,960.0,1600.0,0,SWEET GLOBE,Clam
Agrolatina,24A5364641,02/05/2025,Sale,-80.0,1520.0,6,SWEET GLOBE,Clam
Agrolatina,24A5364641,02/05/2025,Sale,-720.0,800.0,6,SWEET GLOBE,Clam
Agrolatina,24A5364641,02/08/2025,Sale,-400.0,400.0,9,SWEET GLOBE,Clam
Agrolatina,24A5364641,02/10/2025,Sale,-160.0,240.0,11,SWEET GLOBE,Clam
Agrolatina,24A5364641,02/10/2025,Sale,-240.0,0.0,11,SWEET GLOBE,Clam
Agrolatina,24A5365503,03/10/2025,Entry,560.0,560.0,0,AUTUMN CRISP,Clam
Agrolatina,24A5365503,03/10/2025,Entry,1040.0,1600.0,0,AUTUMN CRISP,Clam
Agrolatina,24A5365503,03/27/2025,Sale,-560.0,1040.0,17,AUTUMN CRISP,Clam
Agrolatina,24A5365503,04/01/2025,Sale,-480.0,560.0,22,AUTUMN CRISP,Clam
Agrolatina,24A5365503,04/02/2025,Sale,-560.0,0.0,23,AUTUMN CRISP,Clam
Agrolatina,24A5366140,02/24/2025,Entry,1440.0,1440.0,0,TIMCO,Clam
Agrolatina,24A5366140,02/24/2025,Entry,80.0,1520.0,0,TIMCO,Clam
Agrolatina,24A5366140,02/24/2025,Entry,80.0,1600.0,0,TIMCO,Clam
Agrolatina,24A5366351,04/23/2025,Entry,1120.0,1120.0,0,SWEET GLOBE,Clam
Agrolatina,24A5366351,04/23/2025,Entry,480.0,1600.0,0,SWEET GLOBE,Clam
Agrolatina,24A5366351,05/08/2025,Sale,-1120.0,480.0,15,SWEET GLOBE,Clam
Agrolatina,24A5366351,05/08/2025,Sale,-480.0,0.0,15,SWEET GLOBE,Clam
Agrolatina,24A5404321,01/22/2025,Sale,-1600.0,-1600.0,0,SWEET GLOBE,Clam
Agrolatina,24A5404321,01/25/2025,Entry,1600.0,0.0,3,SWEET GLOBE,Clam
Agrolatina,24A5470405,02/17/2025,Entry,720.0,720.0,0,AUTUMN CRISP,Clam
Agrolatina,24A5470405,02/17/2025,Entry,880.0,1600.0,0,AUTUMN CRISP,Clam
Agrolatina,24A5470405,03/04/2025,Sale,-80.0,1520.0,15,AUTUMN CRISP,Clam
Agrolatina,24A5470405,03/14/2025,Sale,-800.0,720.0,25,AUTUMN CRISP,Clam
Agrolatina,24A5470405,03/15/2025,Sale,-720.0,0.0,26,AUTUMN CRISP,Clam
Agrolatina,24A5470750,02/24/2025,Entry,1280.0,1280.0,0,TIMCO,Clam
Agrolatina,24A5470750,02/24/2025,Entry,320.0,1600.0,0,TIMCO,Clam
Agrolatina,24A5470956,01/13/2025,Entry,1280.0,1280.0,0,ALLISON,Clam
Agrolatina,24A5470956,01/13/2025,Entry,320.0,1600.0,0,ALLISON,Clam
Agrolatina,24A5470956,01/20/2025,Sale,-640.0,960.0,7,ALLISON,Clam
Agrolatina,24A5470956,01/20/2025,Sale,-640.0,320.0,7,ALLISON,Clam
Agrolatina,24A5470956,01/20/2025,Sale,-240.0,80.0,7,ALLISON,Clam
Agrolatina,24A5470956,01/21/2025,Sale,-80.0,0.0,8,ALLISON,Clam
Agrolatina,24A5470961,03/10/2025,Entry,1360.0,1360.0,0,TIMCO,Clam
Agrolatina,24A5470961,03/10/2025,Entry,240.0,1600.0,0,TIMCO,Clam
Agrolatina,24A5470961,04/03/2025,Sale,-960.0,640.0,24,TIMCO,Clam
Agrolatina,24A5470961,04/21/2025,Sale,-80.0,560.0,42,TIMCO,Clam
Agrolatina,24A5470961,04/22/2025,Sale,-80.0,480.0,43,TIMCO,Clam
Agrolatina,24A5470961,04/23/2025,Sale,-240.0,240.0,44,TIMCO,Clam
Agrolatina,24A5470961,04/24/2025,Sale,-240.0,0.0,45,TIMCO,Clam
Agrolatina,24A5471021,04/14/2025,Entry,1600.0,1600.0,0,SWEET GLOBE,Clam
Agrolatina,24A5471021,04/28/2025,Sale,-1600.0,0.0,14,SWEET GLOBE,Clam
Agrolatina,24A5471171,03/10/2025,Entry,320.0,320.0,0,AUTUMN CRISP,Bag
Agrolatina,24A5471171,03/10/2025,Entry,1280.0,1600.0,0,AUTUMN CRISP,Bag
Agrolatina,24A5471309,02/24/2025,Entry,80.0,80.0,0,AUTUMN CRISP,Bag
Agrolatina,24A5471309,02/24/2025,Entry,1520.0,1600.0,0,AUTUMN CRISP,Bag
Agrolatina,24A5471675,02/13/2025,Entry,190.0,190.0,0,IVORY,Bag
Agrolatina,24A5471675,02/13/2025,Entry,475.0,665.0,0,IVORY,Bag
Agrolatina,24A5471675,02/13/2025,Entry,950.0,1615.0,0,SWEET GLOBE,Bag
Agrolatina,24A5471675,02/13/2025,Entry,285.0,1900.0,0,SWEET GLOBE,Bag
Agrolatina,24A5471675,02/24/2025,Sale,-570.0,1330.0,11,SWEET GLOBE,Bag
Agrolatina,24A5471675,02/25/2025,Sale,-285.0,1045.0,12,SWEET GLOBE,Bag
Agrolatina,24A5471675,02/25/2025,Sale,-285.0,760.0,12,SWEET GLOBE,Bag
Agrolatina,24A5471675,03/05/2025,Sale,-190.0,570.0,20,IVORY,Bag
Agrolatina,24A5471675,03/11/2025,Sale,-190.0,380.0,26,IVORY,Bag
Agrolatina,24A5471675,03/11/2025,Sale,-95.0,285.0,26,SWEET GLOBE,Bag
Agrolatina,24A5471675,03/17/2025,Sale,-285.0,0.0,32,IVORY,Bag
Agrolatina,24A5471865,03/10/2025,Entry,640.0,640.0,0,AUTUMN CRISP,Clam
Agrolatina,24A5471865,03/10/2025,Entry,960.0,1600.0,0,AUTUMN CRISP,Clam
Agrolatina,24A5471865,04/01/2025,Sale,-960.0,640.0,22,AUTUMN CRISP,Clam
Agrolatina,24A5471865,04/02/2025,Sale,-640.0,0.0,23,AUTUMN CRISP,Clam
Agrolatina,24A5471973,02/24/2025,Entry,1040.0,1040.0,0,TIMCO,Clam
Agrolatina,24A5471973,02/24/2025,Entry,560.0,1600.0,0,TIMCO,Clam
Agrolatina,24A5471994,02/03/2025,Entry,880.0,880.0,0,SWEET GLOBE,Clam
Agrolatina,24A5471994,02/03/2025,Entry,720.0,1600.0,0,SWEET GLOBE,Clam
Agrolatina,24A5471994,02/18/2025,Sale,-880.0,720.0,15,SWEET GLOBE,Clam
Agrolatina,24A5471994,02/19/2025,Sale,-720.0,0.0,16,SWEET GLOBE,Clam
Agrolatina,24A5472157,02/17/2025,Entry,560.0,560.0,0,AUTUMN CRISP,Clam
Agrolatina,24A5472157,02/17/2025,Entry,1040.0,1600.0,0,AUTUMN CRISP,Clam
Agrolatina,24A5472286,02/10/2025,Entry,720.0,720.0,0,ALLISON,Clam
Agrolatina,24A5472286,02/10/2025,Entry,880.0,1600.0,0,ALLISON,Clam
Agrolatina,24A5472286,02/22/2025,Sale,-240.0,1360.0,12,ALLISON,Clam
Agrolatina,24A5472286,02/25/2025,Sale,-80.0,1280.0,15,ALLISON,Clam
Agrolatina,24A5472286,02/26/2025,Sale,-320.0,960.0,16,ALLISON,Clam
Agrolatina,24A5472286,03/01/2025,Sale,-320.0,640.0,19,ALLISON,Clam
Agrolatina,24A5472286,03/01/2025,Sale,-400.0,240.0,19,ALLISON,Clam
Agrolatina,24A5472286,03/03/2025,Sale,-160.0,80.0,21,ALLISON,Clam
Agrolatina,24A5472286,03/04/2025,Sale,-80.0,0.0,22,ALLISON,Clam
Agrolatina,24A5472291,02/24/2025,Entry,1440.0,1440.0,0,TIMCO,Clam
Agrolatina,24A5472291,02/24/2025,Entry,160.0,1600.0,0,TIMCO,Clam
Agrolatina,24A5472291,03/13/2025,Sale,-1120.0,480.0,17,TIMCO,Clam
Agrolatina,24A5472291,03/17/2025,Sale,-320.0,160.0,21,TIMCO,Clam
Agrolatina,24A5472291,04/06/2025,Sale,-160.0,0.0,41,TIMCO,Clam
Agrolatina,24A5472331,01/13/2025,Entry,1360.0,1360.0,0,IVORY,Clam
Agrolatina,24A5472331,01/13/2025,Entry,80.0,1440.0,0,IVORY,Clam
Agrolatina,24A5472331,01/13/2025,Entry,160.0,1600.0,0,IVORY,Clam
Agrolatina,24A5472331,01/15/2025,Sale,-960.0,640.0,2,IVORY,Clam
Agrolatina,24A5472331,01/15/2025,Sale,-320.0,320.0,2,IVORY,Clam
Agrolatina,24A5472331,01/15/2025,Sale,-80.0,240.0,2,IVORY,Clam
Agrolatina,24A5472331,01/15/2025,Sale,-80.0,160.0,2,IVORY,Clam
Agrolatina,24A5472331,01/15/2025,Sale,-160.0,0.0,2,IVORY,Clam
Agrolatina,24A5473235,03/03/2025,Entry,480.0,480.0,0,AUTUMN CRISP,Clam
Agrolatina,24A5473235,03/03/2025,Entry,1120.0,1600.0,0,AUTUMN CRISP,Clam
Agrolatina,24A5473533,02/28/2025,Entry,400.0,400.0,0,AUTUMN CRISP,Clam
Agrolatina,24A5473533,02/28/2025,Entry,1200.0,1600.0,0,AUTUMN CRISP,Clam
Agrolatina,24A5473615,02/03/2025,Entry,640.0,640.0,0,CANDY DREAMS,Clam
Agrolatina,24A5473615,02/03/2025,Entry,960.0,1600.0,0,CANDY DREAMS,Clam
Agrolatina,24A5473615,03/09/2025,Sale,-160.0,1440.0,34,CANDY DREAMS,Clam
Agrolatina,24A5473615,03/11/2025,Sale,-26.0,1414.0,36,CANDY DREAMS,Clam
Agrolatina,24A5473615,03/11/2025,Sale,-400.0,1014.0,36,CANDY DREAMS,Clam
Agrolatina,24A5473615,03/11/2025,Sale,-400.0,614.0,36,CANDY DREAMS,Clam
Agrolatina,24A5473615,03/11/2025,Sale,-371.0,243.0,36,CANDY DREAMS,Clam
Agrolatina,24A5473615,03/12/2025,Sale,-54.0,189.0,37,CANDY DREAMS,Clam
Agrolatina,24A5473615,03/26/2025,Sale,-33.0,156.0,51,CANDY DREAMS,Clam
Agrolatina,24A5473657,02/24/2025,Entry,960.0,960.0,0,COTTON CANDY,Clam
Agrolatina,24A5473657,02/24/2025,Entry,640.0,1600.0,0,COTTON CANDY,Clam
Agrolatina,24A5473657,03/10/2025,Sale,-240.0,1360.0,14,COTTON CANDY,Clam
Agrolatina,24A5473657,03/27/2025,Sale,-960.0,400.0,31,COTTON CANDY,Clam
Agrolatina,24A5473657,03/27/2025,Sale,-400.0,0.0,31,COTTON CANDY,Clam
Agrolatina,24A5475201,02/17/2025,Entry,160.0,160.0,0,AUTUMN CRISP,Clam
Agrolatina,24A5475201,02/17/2025,Entry,1440.0,1600.0,0,AUTUMN CRISP,Clam
Agrolatina,24A5475330,03/03/2025,Entry,480.0,480.0,0,AUTUMN CRISP,Clam
Agrolatina,24A5475330,03/03/2025,Entry,1120.0,1600.0,0,AUTUMN CRISP,Clam
Agrolatina,24A5475330,03/18/2025,Sale,-240.0,1360.0,15,AUTUMN CRISP,Clam
Agrolatina,24A5475330,03/20/2025,Sale,-880.0,480.0,17,AUTUMN CRISP,Clam
Agrolatina,24A5475330,03/27/2025,Sale,-480.0,0.0,24,AUTUMN CRISP,Clam
Agrolatina,24A5477061,01/30/2025,Entry,880.0,880.0,0,SWEET GLOBE,Clam
Agrolatina,24A5477061,01/30/2025,Entry,720.0,1600.0,0,SWEET GLOBE,Clam
Agrolatina,24A5477061,02/08/2025,Sale,-800.0,800.0,9,SWEET GLOBE,Clam
Agrolatina,24A5477061,02/10/2025,Sale,-720.0,80.0,11,SWEET GLOBE,Clam
Agrolatina,24A5477061,02/12/2025,Sale,-80.0,0.0,13,SWEET GLOBE,Clam
Agrolatina,24A5477821,03/10/2025,Entry,640.0,640.0,0,AUTUMN CRISP,Clam
Agrolatina,24A5477821,03/10/2025,Entry,960.0,1600.0,0,AUTUMN CRISP,Clam
Agrolatina,24A5477821,04/01/2025,Sale,-480.0,1120.0,22,AUTUMN CRISP,Clam
Agrolatina,24A5477821,04/02/2025,Sale,-640.0,480.0,23,AUTUMN CRISP,Clam
Agrolatina,24A5477821,04/04/2025,Sale,-480.0,0.0,25,AUTUMN CRISP,Clam
Agrolatina,24A5478577,03/11/2025,Entry,1440.0,1440.0,0,TIMCO,Clam
Agrolatina,24A5478577,03/11/2025,Entry,160.0,1600.0,0,TIMCO,Clam
Agrolatina,24A5542726,02/12/2025,Entry,880.0,880.0,0,COTTON CANDY,Clam
Agrolatina,24A5542726,02/12/2025,Entry,720.0,1600.0,0,COTTON CANDY,Clam
Agrolatina,24A5542726,03/05/2025,Sale,-640.0,960.0,21,COTTON CANDY,Clam
Agrolatina,24A5542726,03/05/2025,Sale,-240.0,720.0,21,COTTON CANDY,Clam
Agrolatina,24A5542726,03/05/2025,Sale,-720.0,0.0,21,COTTON CANDY,Clam
Agrolatina,24A5547420,02/24/2025,Entry,1600.0,1600.0,0,AUTUMN CRISP,Clam
Agrolatina,24A5560313,01/13/2025,Entry,1520.0,1520.0,0,SWEET GLOBE,Clam
Agrolatina,24A5560313,01/13/2025,Entry,80.0,1600.0,0,SWEET GLOBE,Clam
Agrolatina,24A5560313,01/18/2025,Sale,-560.0,1040.0,5,SWEET GLOBE,Clam
Agrolatina,24A5560313,01/20/2025,Sale,-960.0,80.0,7,SWEET GLOBE,Clam
Agrolatina,24A5560313,01/21/2025,Sale,-80.0,0.0,8,SWEET GLOBE,Clam
Agrolatina,24A5568299,01/27/2025,Entry,1360.0,1360.0,0,SWEET FAVORS,Clam
Agrolatina,24A5568299,01/27/2025,Entry,240.0,1600.0,0,SWEET FAVORS,Clam
Agrolatina,24A5568299,02/25/2025,Sale,-960.0,640.0,29,SWEET FAVORS,Clam
Agrolatina,24A5568299,02/25/2025,Sale,-80.0,560.0,29,SWEET FAVORS,Clam
Agrolatina,24A5568299,02/26/2025,Sale,-400.0,160.0,30,SWEET FAVORS,Clam
Agrolatina,24A5568299,03/06/2025,Sale,-80.0,80.0,38,SWEET FAVORS,Clam
Agrolatina,24A5568299,03/12/2025,Sale,-80.0,0.0,44,SWEET FAVORS,Clam
Agrolatina,24A5568982,01/27/2025,Entry,960.0,960.0,0,IVORY,Clam
Agrolatina,24A5568982,01/27/2025,Entry,640.0,1600.0,0,IVORY,Clam
Agrolatina,24A5568982,01/31/2025,Sale,-960.0,640.0,4,IVORY,Clam
Agrolatina,24A5568982,01/31/2025,Sale,-640.0,0.0,4,IVORY,Clam
Agrolatina,24A5719017,01/16/2025,Entry,480.0,480.0,0,SWEET GLOBE,Clam
Agrolatina,24A5719017,01/16/2025,Entry,1120.0,1600.0,0,SWEET GLOBE,Clam
Agrolatina,24A5719017,01/29/2025,Sale,-80.0,1520.0,13,SWEET GLOBE,Clam
Agrolatina,24A5719017,02/01/2025,Sale,-160.0,1360.0,16,SWEET GLOBE,Clam
Agrolatina,24A5719017,02/03/2025,Sale,-160.0,1200.0,18,SWEET GLOBE,Clam
Agrolatina,24A5719017,02/03/2025,Sale,-80.0,1120.0,18,SWEET GLOBE,Clam
Agrolatina,24A5719017,02/03/2025,Sale,-397.0,723.0,18,SWEET GLOBE,Clam
Agrolatina,24A5719017,02/04/2025,Sale,-240.0,483.0,19,SWEET GLOBE,Clam
Agrolatina,24A5719017,02/04/2025,Sale,-240.0,243.0,19,SWEET GLOBE,Clam
Agrolatina,24A5719017,02/05/2025,Sale,-240.0,3.0,20,SWEET GLOBE,Clam
Agrolatina,24A5776700,03/09/2025,Entry,1200.0,1200.0,0,ALLISON,Clam
Agrolatina,24A5776700,03/09/2025,Entry,80.0,1280.0,0,ALLISON,Clam
Agrolatina,24A5776700,03/09/2025,Entry,320.0,1600.0,0,ALLISON,Clam
Agrolatina,24A5776700,03/10/2025,Sale,-80.0,1520.0,1,ALLISON,Clam
Agrolatina,24A5776700,03/11/2025,Sale,-80.0,1440.0,2,ALLISON,Clam
Agrolatina,24A5776700,03/13/2025,Sale,-1040.0,400.0,4,ALLISON,Clam
Agrolatina,24A5776700,03/20/2025,Sale,-160.0,240.0,11,ALLISON,Clam
Agrolatina,24A5776700,03/25/2025,Sale,-4.0,236.0,16,ALLISON,Clam
Agrolatina,24A5776700,03/27/2025,Sale,-60.0,176.0,18,ALLISON,Clam
Agrolatina,24A5776700,03/27/2025,Sale,-80.0,96.0,18,ALLISON,Clam
Agrolatina,24A5783680,01/18/2025,Entry,1360.0,1360.0,0,SWEET GLOBE,Clam
Agrolatina,24A5783680,01/18/2025,Entry,240.0,1600.0,0,SWEET GLOBE,Clam
Agrolatina,24A5783680,01/28/2025,Sale,-320.0,1280.0,10,SWEET GLOBE,Clam
Agrolatina,24A5783680,01/28/2025,Sale,-560.0,720.0,10,SWEET GLOBE,Clam
Agrolatina,24A5783680,01/29/2025,Sale,-160.0,560.0,11,SWEET GLOBE,Clam
Agrolatina,24A5783680,01/29/2025,Sale,-80.0,480.0,11,SWEET GLOBE,Clam
Agrolatina,24A5783680,01/30/2025,Sale,-80.0,400.0,12,SWEET GLOBE,Clam
Agrolatina,24A5783680,01/31/2025,Sale,-80.0,320.0,13,SWEET GLOBE,Clam
Agrolatina,24A5783680,01/31/2025,Sale,-160.0,160.0,13,SWEET GLOBE,Clam
Agrolatina,24A5783680,01/31/2025,Sale,-80.0,80.0,13,SWEET GLOBE,Clam
Agrolatina,24A5783680,02/07/2025,Sale,-80.0,0.0,20,SWEET GLOBE,Clam
Agrolatina,24A5786442,02/17/2025,Entry,560.0,560.0,0,SWEET GLOBE,Clam
Agrolatina,24A5786442,02/17/2025,Entry,1040.0,1600.0,0,SWEET GLOBE,Clam
Agrolatina,24A5786442,03/03/2025,Sale,-480.0,1120.0,14,SWEET GLOBE,Clam
Agrolatina,24A5786442,03/05/2025,Sale,-80.0,1040.0,16,SWEET GLOBE,Clam
Agrolatina,24A5786442,03/05/2025,Sale,-78.0,962.0,16,SWEET GLOBE,Clam
Agrolatina,24A5786442,03/06/2025,Sale,-480.0,482.0,17,SWEET GLOBE,Clam
Agrolatina,24A5786442,03/10/2025,Sale,-120.0,362.0,21,SWEET GLOBE,Clam
Agrolatina,24A5786442,03/10/2025,Sale,-82.0,280.0,21,SWEET GLOBE,Clam
Agrolatina,24A5786442,03/11/2025,Sale,-60.0,220.0,22,SWEET GLOBE,Clam
Agrolatina,24A5803792,03/04/2025,Entry,400.0,400.0,0,TIMCO,Clam
Agrolatina,24A5803792,03/04/2025,Entry,1200.0,1600.0,0,TIMCO,Clam
Agrolatina,24A5803792,03/27/2025,Sale,-320.0,1280.0,23,TIMCO,Clam
Agrolatina,24A5803792,04/04/2025,Sale,-80.0,1200.0,31,TIMCO,Clam
Agrolatina,24A5803792,04/09/2025,Sale,-1200.0,0.0,36,TIMCO,Clam
Agrolatina,24A6017678,02/04/2025,Entry,800.0,800.0,0,SWEET GLOBE,Clam
Agrolatina,24A6017678,02/04/2025,Entry,800.0,1600.0,0,SWEET GLOBE,Clam
Agrolatina,24A6017678,02/19/2025,Sale,-800.0,800.0,15,SWEET GLOBE,Clam
Agrolatina,24A6017678,02/19/2025,Sale,-160.0,640.0,15,SWEET GLOBE,Clam
Agrolatina,24A6017678,02/19/2025,Sale,-640.0,0.0,15,SWEET GLOBE,Clam
Agrolatina,24A6017810,01/18/2025,Entry,1360.0,1360.0,0,SWEET GLOBE,Clam
Agrolatina,24A6017810,01/18/2025,Entry,240.0,1600.0,0,SWEET GLOBE,Clam
Agrolatina,24A6017810,01/22/2025,Sale,-1360.0,240.0,4,SWEET GLOBE,Clam
Agrolatina,24A6017810,01/28/2025,Sale,-240.0,0.0,10,SWEET GLOBE,Clam
Agrolatina,24A6021563,03/04/2025,Entry,850.0,850.0,0,SWEET FAVORS,Clam
Agrolatina,24A6021563,03/04/2025,Entry,850.0,1700.0,0,SWEET FAVORS,Clam
Agrolatina,24A6021563,03/26/2025,Sale,-85.0,1615.0,22,SWEET FAVORS,Clam
Agrolatina,24A6021563,03/28/2025,Sale,-85.0,1530.0,24,SWEET FAVORS,Clam
Agrolatina,24A6021563,03/31/2025,Sale,-85.0,1445.0,27,SWEET FAVORS,Clam
Agrolatina,24A6021563,04/03/2025,Sale,-640.0,805.0,30,SWEET FAVORS,Clam
Agrolatina,24A6021563,04/03/2025,Sale,-85.0,720.0,30,SWEET FAVORS,Clam
Agrolatina,24A6021563,04/04/2025,Sale,-595.0,125.0,31,SWEET FAVORS,Clam
Agrolatina,24A6021563,04/09/2025,Sale,-85.0,40.0,36,SWEET FAVORS,Clam
Agrolatina,24A6021563,05/03/2025,Sale,-40.0,0.0,60,SWEET FAVORS,Clam
Agrolatina,24A6023360,01/27/2025,Entry,1520.0,1520.0,0,SWEET GLOBE,Clam
Agrolatina,24A6023360,01/27/2025,Entry,80.0,1600.0,0,SWEET GLOBE,Clam
Agrolatina,24A6023360,01/30/2025,Sale,-400.0,1200.0,3,SWEET GLOBE,Clam
Agrolatina,24A6023360,01/31/2025,Sale,-80.0,1120.0,4,SWEET GLOBE,Clam
Agrolatina,24A6023360,01/31/2025,Sale,-80.0,1040.0,4,SWEET GLOBE,Clam
Agrolatina,24A6023360,02/01/2025,Sale,-160.0,880.0,5,SWEET GLOBE,Clam
Agrolatina,24A6023360,02/01/2025,Sale,-240.0,640.0,5,SWEET GLOBE,Clam
Agrolatina,24A6023360,02/04/2025,Sale,-640.0,0.0,8,SWEET GLOBE,Clam
Agrolatina,24A6025732,02/04/2025,Entry,240.0,240.0,0,CANDY DREAMS,Clam
Agrolatina,24A6025732,02/04/2025,Entry,1360.0,1600.0,0,CANDY DREAMS,Clam
Agrolatina,24A6025732,03/06/2025,Sale,-3.0,1597.0,30,CANDY DREAMS,Clam
Agrolatina,24A6025732,03/11/2025,Sale,-27.0,1570.0,35,CANDY DREAMS,Clam
Agrolatina,24A6025732,03/12/2025,Sale,-209.0,1361.0,36,CANDY DREAMS,Clam
Agrolatina,24A6025732,03/12/2025,Sale,-377.0,984.0,36,CANDY DREAMS,Clam
Agrolatina,24A6025732,03/13/2025,Sale,-640.0,344.0,37,CANDY DREAMS,Clam
Agrolatina,24A6025732,03/17/2025,Sale,-199.0,145.0,41,CANDY DREAMS,Clam
Agrolatina,24A6025933,01/19/2025,Entry,320.0,320.0,0,CANDY SNAP,Clam
Agrolatina,24A6025933,01/19/2025,Entry,1280.0,1600.0,0,CANDY SNAP,Clam
Agrolatina,24A6025933,02/12/2025,Sale,-160.0,1440.0,24,CANDY SNAP,Clam
Agrolatina,24A6025933,02/17/2025,Sale,-160.0,1280.0,29,CANDY SNAP,Clam
Agrolatina,24A6025933,02/17/2025,Sale,-480.0,800.0,29,CANDY SNAP,Clam
Agrolatina,24A6025933,02/17/2025,Sale,-22.0,778.0,29,CANDY SNAP,Clam
Agrolatina,24A6025933,03/06/2025,Sale,-400.0,378.0,46,CANDY SNAP,Clam
Agrolatina,24A6025933,03/27/2025,Sale,-80.0,298.0,67,CANDY SNAP,Clam
Agrolatina,24A6028731,01/18/2025,Entry,1440.0,1440.0,0,SWEET GLOBE,Clam
Agrolatina,24A6028731,01/18/2025,Entry,160.0,1600.0,0,SWEET GLOBE,Clam
Agrolatina,24A6028731,02/05/2025,Sale,-560.0,1040.0,18,SWEET GLOBE,Clam
Agrolatina,24A6028731,02/05/2025,Sale,-160.0,880.0,18,SWEET GLOBE,Clam
Agrolatina,24A6028731,02/05/2025,Sale,-240.0,640.0,18,SWEET GLOBE,Clam
Agrolatina,24A6028731,02/05/2025,Sale,-80.0,560.0,18,SWEET GLOBE,Clam
Agrolatina,24A6028731,02/05/2025,Sale,-160.0,400.0,18,SWEET GLOBE,Clam
Agrolatina,24A6028731,02/07/2025,Sale,-160.0,240.0,20,SWEET GLOBE,Clam
Agrolatina,24A6028731,02/07/2025,Sale,-80.0,160.0,20,SWEET GLOBE,Clam
Agrolatina,24A6028731,02/12/2025,Sale,-160.0,0.0,25,SWEET GLOBE,Clam
Agrolatina,24A6034471,03/04/2025,Entry,640.0,640.0,0,CANDY DREAMS,Clam
Agrolatina,24A6034471,03/04/2025,Entry,960.0,1600.0,0,CANDY DREAMS,Clam
Agrolatina,24A6034471,03/25/2025,Sale,-160.0,1440.0,21,CANDY DREAMS,Clam
Agrolatina,24A6034471,03/26/2025,Sale,-240.0,1200.0,22,CANDY DREAMS,Clam
Agrolatina,24A6034471,04/02/2025,Sale,-240.0,960.0,29,CANDY DREAMS,Clam
Agrolatina,24A6034471,04/10/2025,Sale,-80.0,880.0,37,CANDY DREAMS,Clam
Agrolatina,24A6034471,04/21/2025,Sale,-160.0,720.0,48,CANDY DREAMS,Clam
Agrolatina,24A6036221,03/04/2025,Entry,720.0,720.0,0,TIMCO,Clam
Agrolatina,24A6036221,03/04/2025,Entry,880.0,1600.0,0,TIMCO,Clam
Agrolatina,24A6036221,03/26/2025,Sale,-640.0,960.0,22,TIMCO,Clam
Agrolatina,24A6036221,03/28/2025,Sale,-80.0,880.0,24,TIMCO,Clam
Agrolatina,24A6036221,03/31/2025,Sale,-880.0,0.0,27,TIMCO,Clam
Agrolatina,24A6038815,03/04/2025,Entry,595.0,595.0,0,SWEET GLOBE,Clam
Agrolatina,24A6038815,03/04/2025,Entry,1105.0,1700.0,0,SWEET GLOBE,Clam
Agrolatina,24A6038815,03/20/2025,Sale,-307.0,1393.0,16,SWEET GLOBE,Clam
Agrolatina,24A6038815,04/07/2025,Sale,-510.0,883.0,34,SWEET GLOBE,Bag
Agrolatina,24A6038815,04/08/2025,Sale,-235.0,648.0,35,SWEET GLOBE,Bag
Agrolatina,24A6044525,02/20/2025,Entry,1045.0,1045.0,0,IVORY,Bag
Agrolatina,24A6044525,02/20/2025,Entry,760.0,1805.0,0,IVORY,Bag
Agrolatina,24A6044525,02/20/2025,Entry,95.0,1900.0,0,IVORY,Bag
Agrolatina,24A6044525,02/28/2025,Sale,-190.0,1710.0,8,IVORY,Bag
Agrolatina,24A6044525,02/28/2025,Sale,-95.0,1615.0,8,IVORY,Bag
Agrolatina,24A6044525,03/01/2025,Sale,-665.0,950.0,9,IVORY,Bag
Agrolatina,24A6044525,03/01/2025,Sale,-190.0,760.0,9,IVORY,Bag
Agrolatina,24A6044525,03/01/2025,Sale,-190.0,570.0,9,IVORY,Bag
Agrolatina,24A6044525,03/08/2025,Sale,-50.0,520.0,16,IVORY,Bag
Agrolatina,24A6044525,03/12/2025,Sale,-120.0,400.0,20,IVORY,Bag
Agrolatina,24A6044525,03/12/2025,Sale,-70.0,330.0,20,IVORY,Bag
Agrolatina,24A6044525,03/17/2025,Sale,-33.0,297.0,25,IVORY,Bag
Agrolatina,24A6044525,03/17/2025,Sale,-55.0,242.0,25,IVORY,Bag
Agrolatina,24A6060156,02/24/2025,Entry,320.0,320.0,0,SWEET GLOBE,Clam
Agrolatina,24A6060156,02/24/2025,Entry,1280.0,1600.0,0,SWEET GLOBE,Clam
Agrolatina,24A6060156,03/11/2025,Sale,-120.0,1480.0,15,SWEET GLOBE,Clam
Agrolatina,24A6060156,03/13/2025,Sale,-160.0,1320.0,17,SWEET GLOBE,Clam
Agrolatina,24A6060156,03/13/2025,Sale,-80.0,1240.0,17,SWEET GLOBE,Clam
Agrolatina,24A6060156,03/15/2025,Sale,-80.0,1160.0,19,SWEET GLOBE,Clam
Agrolatina,24A6060156,03/15/2025,Sale,-80.0,1080.0,19,SWEET GLOBE,Clam
Agrolatina,24A6060156,03/15/2025,Sale,-200.0,880.0,19,SWEET GLOBE,Clam
Agrolatina,24A6060156,03/15/2025,Sale,-240.0,640.0,19,SWEET GLOBE,Clam
Agrolatina,24A6060156,03/17/2025,Sale,-120.0,520.0,21,SWEET GLOBE,Clam
Agrolatina,24A6060420,01/13/2025,Entry,1120.0,1120.0,0,CANDY SNAP,Clam
Agrolatina,24A6060420,01/13/2025,Entry,480.0,1600.0,0,CANDY SNAP,Clam
Agrolatina,24A6060420,01/18/2025,Sale,-80.0,1520.0,5,CANDY SNAP,Clam
Agrolatina,24A6060420,01/18/2025,Sale,-880.0,640.0,5,CANDY SNAP,Clam
Agrolatina,24A6060420,01/18/2025,Sale,-80.0,560.0,5,CANDY SNAP,Clam
Agrolatina,24A6060420,01/21/2025,Sale,-80.0,480.0,8,CANDY SNAP,Clam
Agrolatina,24A6060420,01/21/2025,Sale,-480.0,0.0,8,CANDY SNAP,Clam
Agrolatina,24A6088812,03/04/2025,Entry,800.0,800.0,0,AUTUMN CRISP,Clam
Agrolatina,24A6088812,03/04/2025,Entry,800.0,1600.0,0,AUTUMN CRISP,Clam
Agrolatina,24A6090553,02/11/2025,Entry,720.0,720.0,0,SWEET GLOBE,Clam
Agrolatina,24A6090553,02/11/2025,Entry,880.0,1600.0,0,SWEET GLOBE,Clam
Agrolatina,24A6090553,02/18/2025,Sale,-320.0,1280.0,7,SWEET GLOBE,Clam
Agrolatina,24A6090553,02/19/2025,Sale,-80.0,1200.0,8,SWEET GLOBE,Clam
Agrolatina,24A6090553,02/21/2025,Sale,-160.0,1040.0,10,SWEET GLOBE,Clam
Agrolatina,24A6090553,02/24/2025,Sale,-20.0,1020.0,13,SWEET GLOBE,Clam
Agrolatina,24A6090553,02/24/2025,Sale,-340.0,680.0,13,SWEET GLOBE,Clam
Agrolatina,24A6090553,02/25/2025,Sale,-26.0,654.0,14,SWEET GLOBE,Clam
Agrolatina,24A6090553,02/27/2025,Sale,-20.0,634.0,16,SWEET GLOBE,Clam
Agrolatina,24A6090553,02/27/2025,Sale,-40.0,594.0,16,SWEET GLOBE,Clam
Agrolatina,24A6090553,03/03/2025,Sale,-240.0,354.0,20,SWEET GLOBE,Clam
Agrolatina,24A6090553,03/03/2025,Sale,-80.0,274.0,20,SWEET GLOBE,Clam
Agrolatina,24A6090553,03/10/2025,Sale,-80.0,194.0,27,SWEET GLOBE,Clam
Agrolatina,24A6090553,03/12/2025,Sale,-60.0,134.0,29,SWEET GLOBE,Clam
Agrolatina,24A6092593,01/19/2025,Entry,400.0,400.0,0,IVORY,Clam
Agrolatina,24A6092593,01/19/2025,Entry,80.0,480.0,0,IVORY,Clam
Agrolatina,24A6092593,01/19/2025,Entry,80.0,560.0,0,IVORY,Clam
Agrolatina,24A6092593,01/19/2025,Entry,960.0,1520.0,0,SWEET GLOBE,Clam
Agrolatina,24A6092593,01/19/2025,Entry,80.0,1600.0,0,SWEET GLOBE,Clam
Agrolatina,24A6092593,02/06/2025,Sale,-80.0,1520.0,18,SWEET GLOBE,Clam
Agrolatina,24A6092593,02/06/2025,Sale,-80.0,1440.0,18,SWEET GLOBE,Clam
Agrolatina,24A6092593,02/06/2025,Sale,-80.0,1360.0,18,SWEET GLOBE,Clam
Agrolatina,24A6092593,02/07/2025,Sale,-160.0,1200.0,19,SWEET GLOBE,Clam
Agrolatina,24A6092593,02/07/2025,Sale,-80.0,1120.0,19,SWEET GLOBE,Clam
Agrolatina,24A6092593,02/08/2025,Sale,-80.0,1040.0,20,SWEET GLOBE,Clam
Agrolatina,24A6092593,02/10/2025,Sale,-80.0,960.0,22,IVORY,Clam
Agrolatina,24A6092593,02/10/2025,Sale,-80.0,880.0,22,IVORY,Clam
Agrolatina,24A6092593,02/10/2025,Sale,-80.0,800.0,22,SWEET GLOBE,Clam
Agrolatina,24A6092593,02/10/2025,Sale,-80.0,720.0,22,SWEET GLOBE,Clam
Agrolatina,24A6092593,02/11/2025,Sale,-80.0,640.0,23,SWEET GLOBE,Clam
Agrolatina,24A6092593,02/12/2025,Sale,-160.0,480.0,24,IVORY,Clam
Agrolatina,24A6092593,02/13/2025,Sale,-160.0,320.0,25,IVORY,Clam
Agrolatina,24A6092593,02/13/2025,Sale,-80.0,240.0,25,SWEET GLOBE,Clam
Agrolatina,24A6092593,02/15/2025,Sale,-80.0,160.0,27,IVORY,Clam
Agrolatina,24A6092593,02/17/2025,Sale,-80.0,80.0,29,SWEET GLOBE,Clam
Agrolatina,24A6092593,02/28/2025,Sale,-50.0,30.0,40,SWEET GLOBE,Clam
Agrolatina,24A6095318,02/11/2025,Entry,1120.0,1120.0,0,SWEET GLOBE,Clam
Agrolatina,24A6095318,02/11/2025,Entry,480.0,1600.0,0,SWEET GLOBE,Clam
Agrolatina,24A6095318,02/20/2025,Sale,-1120.0,480.0,9,SWEET GLOBE,Clam
Agrolatina,24A6095318,03/05/2025,Sale,-80.0,400.0,22,SWEET GLOBE,Clam
Agrolatina,24A6095318,03/06/2025,Sale,-160.0,240.0,23,SWEET GLOBE,Clam
Agrolatina,24A6095318,03/11/2025,Sale,-160.0,80.0,28,SWEET GLOBE,Clam
Agrolatina,24A6095318,03/13/2025,Sale,-80.0,0.0,30,SWEET GLOBE,Clam
Agrolatina,24A6096839,01/03/2025,Entry,1280.0,1280.0,0,CANDY SNAP,Clam
Agrolatina,24A6096839,01/03/2025,Entry,320.0,1600.0,0,CANDY SNAP,Clam
Agrolatina,24A6096839,01/17/2025,Sale,-320.0,1280.0,14,CANDY SNAP,Clam
Agrolatina,24A6096839,01/17/2025,Sale,-960.0,320.0,14,CANDY SNAP,Clam
Agrolatina,24A6096839,01/18/2025,Sale,-240.0,80.0,15,CANDY SNAP,Clam
Agrolatina,24A6096839,01/21/2025,Sale,-80.0,0.0,18,CANDY SNAP,Clam
Agrolatina,24A6097532,03/04/2025,Entry,640.0,640.0,0,SWEET GLOBE,Clam
Agrolatina,24A6097532,03/04/2025,Entry,960.0,1600.0,0,SWEET GLOBE,Clam
Agrolatina,24A6097532,03/15/2025,Sale,-120.0,1480.0,11,SWEET GLOBE,Clam
Agrolatina,24A6097532,03/15/2025,Sale,-80.0,1400.0,11,SWEET GLOBE,Clam
Agrolatina,24A6097532,03/17/2025,Sale,-40.0,1360.0,13,SWEET GLOBE,Clam
Agrolatina,24A6097532,03/18/2025,Sale,-160.0,1200.0,14,SWEET GLOBE,Clam
Agrolatina,24A6097532,03/19/2025,Sale,-170.0,1030.0,15,SWEET GLOBE,Clam
Agrolatina,24A6097532,04/02/2025,Sale,-440.0,590.0,29,SWEET GLOBE,Clam
Agrolatina,24A6100008,03/07/2025,Entry,1120.0,1120.0,0,AUTUMN CRISP,Clam
Agrolatina,24A6100008,03/07/2025,Entry,480.0,1600.0,0,AUTUMN CRISP,Clam
Agrolatina,24A6100008,03/22/2025,Sale,-80.0,1520.0,15,AUTUMN CRISP,Clam
Agrolatina,24A6100008,03/26/2025,Sale,-480.0,1040.0,19,AUTUMN CRISP,Clam
Agrolatina,24A6100008,03/31/2025,Sale,-1040.0,0.0,24,AUTUMN CRISP,Clam
Agrolatina,24A6100604,01/13/2025,Entry,720.0,720.0,0,CANDY SNAP,Clam
Agrolatina,24A6100604,01/13/2025,Entry,880.0,1600.0,0,CANDY SNAP,Clam
Agrolatina,24A6100604,01/29/2025,Sale,-80.0,1520.0,16,CANDY SNAP,Clam
Agrolatina,24A6100604,01/31/2025,Sale,-480.0,1040.0,18,CANDY SNAP,Clam
Agrolatina,24A6100604,01/31/2025,Sale,-160.0,880.0,18,CANDY SNAP,Clam
Agrolatina,24A6100604,02/03/2025,Sale,-320.0,560.0,21,CANDY SNAP,Clam
Agrolatina,24A6100604,02/13/2025,Sale,-560.0,0.0,31,CANDY SNAP,Clam
Agrolatina,24A6106421,01/07/2025,Entry,1280.0,1280.0,0,SWEET GLOBE,Clam
Agrolatina,24A6106421,01/07/2025,Entry,80.0,1360.0,0,SWEET GLOBE,Clam
Agrolatina,24A6106421,01/07/2025,Entry,240.0,1600.0,0,SWEET GLOBE,Clam
Agrolatina,24A6106421,01/21/2025,Sale,-160.0,1440.0,14,SWEET GLOBE,Clam
Agrolatina,24A6106421,01/21/2025,Sale,-240.0,1200.0,14,SWEET GLOBE,Clam
Agrolatina,24A6106421,01/29/2025,Sale,-80.0,1120.0,22,SWEET GLOBE,Clam
Agrolatina,24A6106421,01/30/2025,Sale,-320.0,800.0,23,SWEET GLOBE,Clam
Agrolatina,24A6106421,01/31/2025,Sale,-240.0,560.0,24,SWEET GLOBE,Clam
Agrolatina,24A6106421,01/31/2025,Sale,-400.0,160.0,24,SWEET GLOBE,Clam
Agrolatina,24A6106421,02/01/2025,Sale,-160.0,0.0,25,SWEET GLOBE,Clam
Agrolatina,24A6112502,01/18/2025,Entry,1360.0,1360.0,0,IVORY,Clam
Agrolatina,24A6112502,01/18/2025,Entry,80.0,1440.0,0,IVORY,Clam
Agrolatina,24A6112502,01/18/2025,Entry,160.0,1600.0,0,IVORY,Clam
Agrolatina,24A6112502,01/25/2025,Sale,-80.0,1520.0,7,IVORY,Clam
Agrolatina,24A6112502,01/25/2025,Sale,-80.0,1440.0,7,IVORY,Clam
Agrolatina,24A6112502,01/28/2025,Sale,-80.0,1360.0,10,IVORY,Clam
Agrolatina,24A6112502,01/29/2025,Sale,-1040.0,320.0,11,IVORY,Clam
Agrolatina,24A6112502,01/31/2025,Sale,-240.0,80.0,13,IVORY,Clam
Agrolatina,24A6112502,02/03/2025,Sale,-80.0,0.0,16,IVORY,Clam
Agrolatina,24A6120492,01/30/2025,Entry,160.0,160.0,0,CANDY DREAMS,Clam
Agrolatina,24A6120492,01/30/2025,Entry,1440.0,1600.0,0,CANDY DREAMS,Clam
Agrolatina,24A6120492,02/11/2025,Sale,-80.0,1520.0,12,CANDY DREAMS,Clam
Agrolatina,24A6120492,02/12/2025,Sale,-80.0,1440.0,13,CANDY DREAMS,Clam
Agrolatina,24A6120492,02/17/2025,Sale,-80.0,1360.0,18,CANDY DREAMS,Clam
Agrolatina,24A6120492,02/17/2025,Sale,-80.0,1280.0,18,CANDY DREAMS,Clam
Agrolatina,24A6120492,02/17/2025,Sale,-720.0,560.0,18,CANDY DREAMS,Clam
Agrolatina,24A6120492,02/18/2025,Sale,-480.0,80.0,19,CANDY DREAMS,Clam
Agrolatina,24A6120492,02/27/2025,Sale,-60.0,20.0,28,CANDY DREAMS,Clam
Agrolatina,24A6120492,03/01/2025,Sale,-10.0,10.0,30,CANDY DREAMS,Clam
Agrolatina,24A6127088,02/11/2025,Entry,320.0,320.0,0,COTTON CANDY,Clam
Agrolatina,24A6127088,02/11/2025,Entry,1280.0,1600.0,0,COTTON CANDY,Clam
Agrolatina,24A6127088,02/21/2025,Sale,-320.0,1280.0,10,COTTON CANDY,Clam
Agrolatina,24A6127088,02/21/2025,Sale,-1280.0,0.0,10,COTTON CANDY,Clam
Agrolatina,24A6127698,01/07/2025,Entry,1280.0,1280.0,0,SWEET GLOBE,Clam
Agrolatina,24A6127698,01/07/2025,Entry,80.0,1360.0,0,SWEET GLOBE,Clam
Agrolatina,24A6127698,01/07/2025,Entry,240.0,1600.0,0,SWEET GLOBE,Clam
Agrolatina,24A6127698,01/20/2025,Sale,-400.0,1200.0,13,SWEET GLOBE,Clam
Agrolatina,24A6127698,01/21/2025,Sale,-80.0,1120.0,14,SWEET GLOBE,Clam
Agrolatina,24A6127698,01/27/2025,Sale,-160.0,960.0,20,SWEET GLOBE,Clam
Agrolatina,24A6127698,01/28/2025,Sale,-160.0,800.0,21,SWEET GLOBE,Clam
Agrolatina,24A6127698,01/30/2025,Sale,-560.0,240.0,23,SWEET GLOBE,Clam
Agrolatina,24A6127698,01/31/2025,Sale,-80.0,160.0,24,SWEET GLOBE,Clam
Agrolatina,24A6127698,01/31/2025,Sale,-160.0,0.0,24,SWEET GLOBE,Clam
Agrolatina,24A6127912,01/30/2025,Entry,1520.0,1520.0,0,SWEET GLOBE,Clam
Agrolatina,24A6127912,01/30/2025,Entry,80.0,1600.0,0,SWEET GLOBE,Clam
Agrolatina,24A6127912,03/04/2025,Sale,-418.0,1182.0,33,SWEET GLOBE,Clam
Agrolatina,24A6127912,03/04/2025,Sale,-60.0,1122.0,33,SWEET GLOBE,Clam
Agrolatina,24A6127912,03/06/2025,Sale,-420.0,702.0,35,SWEET GLOBE,Clam
Agrolatina,24A6127912,03/10/2025,Sale,-40.0,662.0,39,SWEET GLOBE,Clam
Agrolatina,24A6127912,03/11/2025,Sale,-126.0,536.0,40,SWEET GLOBE,Clam
Agrolatina,24A6127912,03/11/2025,Sale,-20.0,516.0,40,SWEET GLOBE,Clam
Agrolatina,24A6127912,03/11/2025,Sale,-20.0,496.0,40,SWEET GLOBE,Clam
Agrolatina,24A6129038,03/10/2025,Entry,1520.0,1520.0,0,TIMCO,Clam
Agrolatina,24A6129038,03/10/2025,Entry,80.0,1600.0,0,TIMCO,Clam
Agrolatina,24A6129038,03/21/2025,Sale,-80.0,1520.0,11,TIMCO,Clam
Agrolatina,24A6129038,04/01/2025,Sale,-160.0,1360.0,22,TIMCO,Clam
Agrolatina,24A6129038,04/01/2025,Sale,-80.0,1280.0,22,TIMCO,Clam
Agrolatina,24A6129038,04/03/2025,Sale,-80.0,1200.0,24,TIMCO,Clam
Agrolatina,24A6129038,04/04/2025,Sale,-80.0,1120.0,25,TIMCO,Clam
Agrolatina,24A6129038,04/05/2025,Sale,-80.0,1040.0,26,TIMCO,Clam
Agrolatina,24A6129038,04/05/2025,Sale,-160.0,880.0,26,TIMCO,Clam
Agrolatina,24A6129038,04/07/2025,Sale,-80.0,800.0,28,TIMCO,Clam
Agrolatina,24A6129038,04/07/2025,Sale,-80.0,720.0,28,TIMCO,Clam
Agrolatina,24A6129038,04/09/2025,Sale,-160.0,560.0,30,TIMCO,Clam
Agrolatina,24A6129038,04/10/2025,Sale,-400.0,160.0,31,TIMCO,Clam
Agrolatina,24A6129038,04/11/2025,Sale,-160.0,0.0,32,TIMCO,Clam
Agrolatina,24A6133795,01/18/2025,Entry,1280.0,1280.0,0,SWEET GLOBE,Clam
Agrolatina,24A6133795,01/18/2025,Entry,240.0,1520.0,0,SWEET GLOBE,Clam
Agrolatina,24A6133795,01/18/2025,Entry,80.0,1600.0,0,SWEET GLOBE,Clam
Agrolatina,24A6133795,02/05/2025,Sale,-320.0,1280.0,18,SWEET GLOBE,Clam
Agrolatina,24A6133795,02/06/2025,Sale,-320.0,960.0,19,SWEET GLOBE,Clam
Agrolatina,24A6133795,02/06/2025,Sale,-80.0,880.0,19,SWEET GLOBE,Clam
Agrolatina,24A6133795,02/07/2025,Sale,-80.0,800.0,20,SWEET GLOBE,Clam
Agrolatina,24A6133795,02/07/2025,Sale,-80.0,720.0,20,SWEET GLOBE,Clam
Agrolatina,24A6133795,02/07/2025,Sale,-174.0,546.0,20,SWEET GLOBE,Clam
Agrolatina,24A6133795,02/07/2025,Sale,-80.0,466.0,20,SWEET GLOBE,Clam
Agrolatina,24A6133795,02/08/2025,Sale,-66.0,400.0,21,SWEET GLOBE,Clam
Agrolatina,24A6133795,02/10/2025,Sale,-80.0,320.0,23,SWEET GLOBE,Clam
Agrolatina,24A6133795,02/15/2025,Sale,-80.0,240.0,28,SWEET GLOBE,Clam
Agrolatina,24A6133795,02/21/2025,Sale,-240.0,0.0,34,SWEET GLOBE,Clam
Agrolatina,24A6135993,01/13/2025,Entry,1520.0,1520.0,0,SWEET GLOBE,Clam
Agrolatina,24A6135993,01/13/2025,Entry,80.0,1600.0,0,SWEET GLOBE,Clam
Agrolatina,24A6135993,02/06/2025,Sale,-160.0,1440.0,24,SWEET GLOBE,Clam
Agrolatina,24A6135993,02/06/2025,Sale,-80.0,1360.0,24,SWEET GLOBE,Clam
Agrolatina,24A6135993,02/07/2025,Sale,-80.0,1280.0,25,SWEET GLOBE,Clam
Agrolatina,24A6135993,02/07/2025,Sale,-240.0,1040.0,25,SWEET GLOBE,Clam
Agrolatina,24A6135993,02/07/2025,Sale,-720.0,320.0,25,SWEET GLOBE,Clam
Agrolatina,24A6135993,02/07/2025,Sale,-80.0,240.0,25,SWEET GLOBE,Clam
Agrolatina,24A6135993,02/08/2025,Sale,-80.0,160.0,26,SWEET GLOBE,Clam
Agrolatina,24A6135993,02/08/2025,Sale,-80.0,80.0,26,SWEET GLOBE,Clam
Agrolatina,24A6135993,02/15/2025,Sale,-80.0,0.0,33,SWEET GLOBE,Clam
Agrolatina,24A6154625,01/21/2025,Entry,800.0,800.0,0,CANDY SNAP,Clam
Agrolatina,24A6154625,01/21/2025,Entry,800.0,1600.0,0,CANDY SNAP,Clam
Agrolatina,24A6154625,02/03/2025,Sale,-80.0,1520.0,13,CANDY SNAP,Clam
Agrolatina,24A6154625,02/17/2025,Sale,-160.0,1360.0,27,CANDY SNAP,Clam
Agrolatina,24A6154625,02/17/2025,Sale,-240.0,1120.0,27,CANDY SNAP,Clam
Agrolatina,24A6154625,02/17/2025,Sale,-640.0,480.0,27,CANDY SNAP,Clam
Agrolatina,24A6154625,02/17/2025,Sale,-80.0,400.0,27,CANDY SNAP,Clam
Agrolatina,24A6154625,02/27/2025,Sale,-30.0,370.0,37,CANDY SNAP,Clam
Agrolatina,24A6154625,02/28/2025,Sale,-80.0,290.0,38,CANDY SNAP,Clam
Agrolatina,24A6154625,03/03/2025,Sale,-60.0,230.0,41,CANDY SNAP,Clam
Agrolatina,24A6154625,03/03/2025,Sale,-40.0,190.0,41,CANDY SNAP,Clam
Agrolatina,24A6154625,03/04/2025,Sale,-80.0,110.0,42,CANDY SNAP,Clam
Agrolatina,24A6156593,01/07/2025,Entry,960.0,960.0,0,SWEET GLOBE,Clam
Agrolatina,24A6156593,01/07/2025,Entry,80.0,1040.0,0,SWEET GLOBE,Clam
Agrolatina,24A6156593,01/07/2025,Entry,560.0,1600.0,0,SWEET GLOBE,Clam
Agrolatina,24A6156593,01/20/2025,Sale,-320.0,1280.0,13,SWEET GLOBE,Clam
Agrolatina,24A6156593,01/20/2025,Sale,-320.0,960.0,13,SWEET GLOBE,Clam
Agrolatina,24A6156593,01/21/2025,Sale,-160.0,800.0,14,SWEET GLOBE,Clam
Agrolatina,24A6156593,01/21/2025,Sale,-80.0,720.0,14,SWEET GLOBE,Clam
Agrolatina,24A6156593,01/27/2025,Sale,-80.0,640.0,20,SWEET GLOBE,Clam
Agrolatina,24A6156593,01/29/2025,Sale,-80.0,560.0,22,SWEET GLOBE,Clam
Agrolatina,24A6156593,01/30/2025,Sale,-240.0,320.0,23,SWEET GLOBE,Clam
Agrolatina,24A6156593,02/12/2025,Sale,-160.0,160.0,36,SWEET GLOBE,Clam
Agrolatina,24A6156593,02/12/2025,Sale,-160.0,0.0,36,SWEET GLOBE,Clam
Agrolatina,24A6157483,01/18/2025,Entry,1520.0,1520.0,0,SWEET GLOBE,Clam
Agrolatina,24A6157483,01/18/2025,Entry,80.0,1600.0,0,SWEET GLOBE,Clam
Agrolatina,24A6157483,01/25/2025,Sale,-480.0,1120.0,7,SWEET GLOBE,Clam
Agrolatina,24A6157483,01/25/2025,Sale,-80.0,1040.0,7,SWEET GLOBE,Clam
Agrolatina,24A6157483,01/27/2025,Sale,-1040.0,0.0,9,SWEET GLOBE,Clam
Agrolatina,24A6170209,01/16/2025,Entry,1520.0,1520.0,0,ALLISON,Clam
Agrolatina,24A6170209,01/16/2025,Entry,80.0,1600.0,0,ALLISON,Clam
Agrolatina,24A6170209,01/30/2025,Sale,-560.0,1040.0,14,ALLISON,Clam
Agrolatina,24A6170209,01/30/2025,Sale,-80.0,960.0,14,ALLISON,Clam
Agrolatina,24A6170209,02/01/2025,Sale,-80.0,880.0,16,ALLISON,Clam
Agrolatina,24A6170209,02/05/2025,Sale,-80.0,800.0,20,ALLISON,Clam
Agrolatina,24A6170209,02/05/2025,Sale,-80.0,720.0,20,ALLISON,Clam
Agrolatina,24A6170209,02/07/2025,Sale,-80.0,640.0,22,ALLISON,Clam
Agrolatina,24A6170209,02/08/2025,Sale,-400.0,240.0,23,ALLISON,Clam
Agrolatina,24A6170209,02/10/2025,Sale,-80.0,160.0,25,ALLISON,Clam
Agrolatina,24A6170209,02/12/2025,Sale,-160.0,0.0,27,ALLISON,Clam
Agrolatina,24A6183823,02/03/2025,Entry,640.0,640.0,0,CANDY DREAMS,Clam
Agrolatina,24A6183823,02/03/2025,Entry,960.0,1600.0,0,CANDY DREAMS,Clam
Agrolatina,24A6183823,02/08/2025,Sale,-160.0,1440.0,5,CANDY DREAMS,Clam
Agrolatina,24A6183823,02/10/2025,Sale,-80.0,1360.0,7,CANDY DREAMS,Clam
Agrolatina,24A6183823,02/10/2025,Sale,-240.0,1120.0,7,CANDY DREAMS,Clam
Agrolatina,24A6183823,02/11/2025,Sale,-80.0,1040.0,8,CANDY DREAMS,Clam
Agrolatina,24A6183823,02/13/2025,Sale,-80.0,960.0,10,CANDY DREAMS,Clam
Agrolatina,24A6183823,02/17/2025,Sale,-160.0,800.0,14,CANDY DREAMS,Clam
Agrolatina,24A6183823,02/19/2025,Sale,-160.0,640.0,16,CANDY DREAMS,Clam
Agrolatina,24A6183823,02/20/2025,Sale,-160.0,480.0,17,CANDY DREAMS,Clam
Agrolatina,24A6183823,02/22/2025,Sale,-80.0,400.0,19,CANDY DREAMS,Clam
Agrolatina,24A6183823,02/22/2025,Sale,-80.0,320.0,19,CANDY DREAMS,Clam
Agrolatina,24A6183823,02/24/2025,Sale,-80.0,240.0,21,CANDY DREAMS,Clam
Agrolatina,24A6183823,02/24/2025,Sale,-80.0,160.0,21,CANDY DREAMS,Clam
Agrolatina,24A6183823,02/25/2025,Sale,-70.0,90.0,22,CANDY DREAMS,Clam
Agrolatina,24A6187834,02/03/2025,Entry,1360.0,1360.0,0,SWEET GLOBE,Clam
Agrolatina,24A6187834,02/03/2025,Entry,240.0,1600.0,0,SWEET GLOBE,Clam
Agrolatina,24A6187834,02/07/2025,Sale,-80.0,1520.0,4,SWEET GLOBE,Clam
Agrolatina,24A6187834,02/08/2025,Sale,-80.0,1440.0,5,SWEET GLOBE,Clam
Agrolatina,24A6187834,02/10/2025,Sale,-80.0,1360.0,7,SWEET GLOBE,Clam
Agrolatina,24A6187834,02/10/2025,Sale,-80.0,1280.0,7,SWEET GLOBE,Clam
Agrolatina,24A6187834,02/10/2025,Sale,-240.0,1040.0,7,SWEET GLOBE,Clam
Agrolatina,24A6187834,02/10/2025,Sale,-240.0,800.0,7,SWEET GLOBE,Clam
Agrolatina,24A6187834,02/11/2025,Sale,-160.0,640.0,8,SWEET GLOBE,Clam
Agrolatina,24A6187834,02/11/2025,Sale,-160.0,480.0,8,SWEET GLOBE,Clam
Agrolatina,24A6187834,02/18/2025,Sale,-80.0,400.0,15,SWEET GLOBE,Clam
Agrolatina,24A6187834,02/22/2025,Sale,-27.0,373.0,19,SWEET GLOBE,Clam
Agrolatina,24A6187834,02/24/2025,Sale,-55.0,318.0,21,SWEET GLOBE,Clam
Agrolatina,24A6187834,02/28/2025,Sale,-40.0,278.0,25,SWEET GLOBE,Clam
Agrolatina,24A6187834,03/03/2025,Sale,-40.0,238.0,28,SWEET GLOBE,Clam
Agrolatina,24A6187834,03/04/2025,Sale,-10.0,228.0,29,SWEET GLOBE,Clam
Agrolatina,24A6187834,03/05/2025,Sale,-49.0,179.0,30,SWEET GLOBE,Clam
Agrolatina,24A6194849,03/03/2025,Entry,880.0,880.0,0,COTTON CANDY,Clam
Agrolatina,24A6194849,03/03/2025,Entry,720.0,1600.0,0,COTTON CANDY,Clam
Agrolatina,24A6194849,03/28/2025,Sale,-202.0,1398.0,25,COTTON CANDY,Clam
Agrolatina,24A6194849,03/31/2025,Sale,-80.0,1318.0,28,COTTON CANDY,Clam
Agrolatina,24A6194849,04/02/2025,Sale,-40.0,1278.0,30,COTTON CANDY,Clam
Agrolatina,24A6194849,04/10/2025,Sale,-80.0,1198.0,38,COTTON CANDY,Clam
Agrolatina,24A6210214,02/24/2025,Entry,800.0,800.0,0,AUTUMN CRISP,Clam
Agrolatina,24A6210214,02/24/2025,Entry,800.0,1600.0,0,AUTUMN CRISP,Clam
Agrolatina,24A6239223,02/20/2025,Entry,880.0,880.0,0,SWEET GLOBE,Clam
Agrolatina,24A6239223,02/20/2025,Entry,720.0,1600.0,0,SWEET GLOBE,Clam
Agrolatina,24A6239223,02/27/2025,Sale,-80.0,1520.0,7,SWEET GLOBE,Clam
Agrolatina,24A6239223,03/03/2025,Sale,-80.0,1440.0,11,SWEET GLOBE,Clam
Agrolatina,24A6239223,03/03/2025,Sale,-640.0,800.0,11,SWEET GLOBE,Clam
Agrolatina,24A6239223,03/06/2025,Sale,-260.0,540.0,14,SWEET GLOBE,Clam
Agrolatina,24A6239223,03/11/2025,Sale,-11.0,529.0,19,SWEET GLOBE,Clam
Agrolatina,24A6239223,03/11/2025,Sale,-120.0,409.0,19,SWEET GLOBE,Clam
Agrolatina,24A6239223,03/11/2025,Sale,-183.0,226.0,19,SWEET GLOBE,Clam
Agrolatina,24A6239223,03/11/2025,Sale,-40.0,186.0,19,SWEET GLOBE,Clam
Agrolatina,24A6245930,02/03/2025,Entry,1360.0,1360.0,0,ALLISON,Clam
Agrolatina,24A6245930,02/03/2025,Entry,240.0,1600.0,0,ALLISON,Clam
Agrolatina,24A6245930,03/03/2025,Sale,-80.0,1520.0,28,ALLISON,Clam
Agrolatina,24A6245930,03/04/2025,Sale,-80.0,1440.0,29,ALLISON,Clam
Agrolatina,24A6245930,03/07/2025,Sale,-80.0,1360.0,32,ALLISON,Clam
Agrolatina,24A6245930,03/07/2025,Sale,-80.0,1280.0,32,ALLISON,Clam
Agrolatina,24A6245930,03/08/2025,Sale,-720.0,560.0,33,ALLISON,Clam
Agrolatina,24A6245930,03/10/2025,Sale,-320.0,240.0,35,ALLISON,Clam
Agrolatina,24A6245930,03/11/2025,Sale,-80.0,160.0,36,ALLISON,Clam
Agrolatina,24A6245930,03/14/2025,Sale,-80.0,80.0,39,ALLISON,Clam
Agrolatina,24A6245930,03/27/2025,Sale,-53.0,27.0,52,ALLISON,Clam
Agrolatina,24A6254491,03/10/2025,Entry,1360.0,1360.0,0,TIMCO,Clam
Agrolatina,24A6254491,03/10/2025,Entry,240.0,1600.0,0,TIMCO,Clam
Agrolatina,24A6254491,03/27/2025,Sale,-80.0,1520.0,17,TIMCO,Clam
Agrolatina,24A6254491,03/31/2025,Sale,-80.0,1440.0,21,TIMCO,Clam
Agrolatina,24A6254491,04/01/2025,Sale,-160.0,1280.0,22,TIMCO,Clam
Agrolatina,24A6254491,04/04/2025,Sale,-320.0,960.0,25,TIMCO,Clam
Agrolatina,24A6254491,04/05/2025,Sale,-80.0,880.0,26,TIMCO,Clam
Agrolatina,24A6254491,04/07/2025,Sale,-80.0,800.0,28,TIMCO,Clam
Agrolatina,24A6254491,04/07/2025,Sale,-80.0,720.0,28,TIMCO,Clam
Agrolatina,24A6254491,04/08/2025,Sale,-80.0,640.0,29,TIMCO,Clam
Agrolatina,24A6254491,04/08/2025,Sale,-80.0,560.0,29,TIMCO,Clam
Agrolatina,24A6254491,04/09/2025,Sale,-160.0,400.0,30,TIMCO,Clam
Agrolatina,24A6254491,04/10/2025,Sale,-80.0,320.0,31,TIMCO,Clam
Agrolatina,24A6254491,04/11/2025,Sale,-320.0,0.0,32,TIMCO,Clam
Agrolatina,24A6279020,02/13/2025,Entry,640.0,640.0,0,ALLISON,Clam
Agrolatina,24A6279020,02/13/2025,Entry,960.0,1600.0,0,ALLISON,Clam
Agrolatina,24A6279020,02/28/2025,Sale,-240.0,1360.0,15,ALLISON,Clam
Agrolatina,24A6279020,03/03/2025,Sale,-720.0,640.0,18,ALLISON,Clam
Agrolatina,24A6279020,03/11/2025,Sale,-640.0,0.0,26,ALLISON,Clam
Agrolatina,24A6364675,02/17/2025,Entry,1440.0,1440.0,0,IVORY,Clam
Agrolatina,24A6364675,02/17/2025,Entry,160.0,1600.0,0,IVORY,Clam
Agrolatina,24A6364675,02/25/2025,Sale,-1120.0,480.0,8,IVORY,Clam
Agrolatina,24A6364675,02/25/2025,Sale,-160.0,320.0,8,IVORY,Clam
Agrolatina,24A6364675,02/26/2025,Sale,-80.0,240.0,9,IVORY,Clam
Agrolatina,24A6364675,03/19/2025,Sale,-20.0,220.0,30,IVORY,Clam
Agrolatina,24A6364675,03/19/2025,Sale,-180.0,40.0,30,IVORY,Clam
Agrolatina,24A6382220,02/11/2025,Entry,880.0,880.0,0,SWEET GLOBE,Clam
Agrolatina,24A6382220,02/11/2025,Entry,720.0,1600.0,0,SWEET GLOBE,Clam
Agrolatina,24A6382220,02/18/2025,Sale,-400.0,1200.0,7,SWEET GLOBE,Clam
Agrolatina,24A6382220,02/20/2025,Sale,-80.0,1120.0,9,SWEET GLOBE,Clam
Agrolatina,24A6382220,02/22/2025,Sale,-80.0,1040.0,11,SWEET GLOBE,Clam
Agrolatina,24A6382220,02/22/2025,Sale,-160.0,880.0,11,SWEET GLOBE,Clam
Agrolatina,24A6382220,02/22/2025,Sale,-70.0,810.0,11,SWEET GLOBE,Clam
Agrolatina,24A6382220,02/22/2025,Sale,-80.0,730.0,11,SWEET GLOBE,Clam
Agrolatina,24A6382220,02/22/2025,Sale,-80.0,650.0,11,SWEET GLOBE,Clam
Agrolatina,24A6382220,02/24/2025,Sale,-252.0,398.0,13,SWEET GLOBE,Clam
Agrolatina,24A6382220,02/25/2025,Sale,-80.0,318.0,14,SWEET GLOBE,Clam
Agrolatina,24A6382220,02/27/2025,Sale,-80.0,238.0,16,SWEET GLOBE,Clam
Agrolatina,24A6382220,02/27/2025,Sale,-50.0,188.0,16,SWEET GLOBE,Clam
Agrolatina,24A6382220,02/27/2025,Sale,-40.0,148.0,16,SWEET GLOBE,Clam
Agrolatina,24A6408876,02/04/2025,Entry,720.0,720.0,0,SWEET GLOBE,Clam
Agrolatina,24A6408876,02/04/2025,Entry,880.0,1600.0,0,SWEET GLOBE,Clam
Agrolatina,24A6408876,02/13/2025,Sale,-480.0,1120.0,9,SWEET GLOBE,Clam
Agrolatina,24A6408876,02/19/2025,Sale,-720.0,400.0,15,SWEET GLOBE,Clam
Agrolatina,24A6408876,02/19/2025,Sale,-400.0,0.0,15,SWEET GLOBE,Clam
Agrolatina,24A6451553,01/03/2025,Entry,1120.0,1120.0,0,SWEET GLOBE,Clam
Agrolatina,24A6451553,01/03/2025,Entry,480.0,1600.0,0,SWEET GLOBE,Clam
Agrolatina,24A6451553,01/17/2025,Sale,-160.0,1440.0,14,SWEET GLOBE,Clam
Agrolatina,24A6451553,01/17/2025,Sale,-720.0,720.0,14,SWEET GLOBE,Clam
Agrolatina,24A6451553,01/17/2025,Sale,-240.0,480.0,14,SWEET GLOBE,Clam
Agrolatina,24A6451553,01/17/2025,Sale,-320.0,160.0,14,SWEET GLOBE,Clam
Agrolatina,24A6451553,01/21/2025,Sale,-80.0,80.0,18,SWEET GLOBE,Clam
Agrolatina,24A6451553,01/21/2025,Sale,-80.0,0.0,18,SWEET GLOBE,Clam
Agrolatina,24A6454758,01/01/2025,Entry,1360.0,1360.0,0,ALLISON,Clam
Agrolatina,24A6454758,01/01/2025,Entry,240.0,1600.0,0,ALLISON,Clam
Agrolatina,24A6454758,01/15/2025,Sale,-160.0,1440.0,14,ALLISON,Clam
Agrolatina,24A6454758,01/15/2025,Sale,-80.0,1360.0,14,ALLISON,Clam
Agrolatina,24A6454758,01/15/2025,Sale,-160.0,1200.0,14,ALLISON,Clam
Agrolatina,24A6454758,01/16/2025,Sale,-80.0,1120.0,15,ALLISON,Clam
Agrolatina,24A6454758,01/17/2025,Sale,-560.0,560.0,16,ALLISON,Clam
Agrolatina,24A6454758,01/17/2025,Sale,-480.0,80.0,16,ALLISON,Clam
Agrolatina,24A6454758,01/17/2025,Sale,-80.0,0.0,16,ALLISON,Clam
Agrolatina,24A6523416,03/04/2025,Entry,1040.0,1040.0,0,TIMCO,Clam
Agrolatina,24A6523416,03/04/2025,Entry,560.0,1600.0,0,TIMCO,Clam
Agrolatina,24A6523416,04/06/2025,Sale,-560.0,1040.0,33,TIMCO,Clam
Agrolatina,24A6523416,04/16/2025,Sale,-1040.0,0.0,43,TIMCO,Clam
Agrolatina,24A6558794,02/04/2025,Entry,640.0,640.0,0,SWEET GLOBE,Clam
Agrolatina,24A6558794,02/04/2025,Entry,960.0,1600.0,0,SWEET GLOBE,Clam
Agrolatina,24A6558794,02/13/2025,Sale,-960.0,640.0,9,SWEET GLOBE,Clam
Agrolatina,24A6558794,02/18/2025,Sale,-640.0,0.0,14,SWEET GLOBE,Clam
Agrolatina,24A6560277,02/11/2025,Entry,1280.0,1280.0,0,TIMCO,Clam
Agrolatina,24A6560277,02/11/2025,Entry,80.0,1360.0,0,TIMCO,Clam
Agrolatina,24A6560277,02/11/2025,Entry,240.0,1600.0,0,TIMCO,Clam
Agrolatina,24A6560277,03/05/2025,Sale,-80.0,1520.0,22,TIMCO,Clam
Agrolatina,24A6560277,03/08/2025,Sale,-720.0,800.0,25,TIMCO,Clam
Agrolatina,24A6560277,03/12/2025,Sale,-160.0,640.0,29,TIMCO,Clam
Agrolatina,24A6560277,03/13/2025,Sale,-400.0,240.0,30,TIMCO,Clam
Agrolatina,24A6560277,03/14/2025,Sale,-240.0,0.0,31,TIMCO,Clam
Agrolatina,24A6563912,01/03/2025,Entry,1440.0,1440.0,0,SWEET GLOBE,Clam
Agrolatina,24A6563912,01/03/2025,Entry,80.0,1520.0,0,SWEET GLOBE,Clam
Agrolatina,24A6563912,01/03/2025,Entry,80.0,1600.0,0,SWEET GLOBE,Clam
Agrolatina,24A6563912,01/16/2025,Sale,-1280.0,320.0,13,SWEET GLOBE,Clam
Agrolatina,24A6563912,01/17/2025,Sale,-80.0,240.0,14,SWEET GLOBE,Clam
Agrolatina,24A6563912,01/17/2025,Sale,-80.0,160.0,14,SWEET GLOBE,Clam
Agrolatina,24A6563912,01/20/2025,Sale,-80.0,80.0,17,SWEET GLOBE,Clam
Agrolatina,24A6563912,01/21/2025,Sale,-80.0,0.0,18,SWEET GLOBE,Clam
Agrolatina,24A6583138,02/06/2025,Entry,1140.0,1140.0,0,SWEET GLOBE,Bag
Agrolatina,24A6583138,02/06/2025,Entry,95.0,1235.0,0,SWEET GLOBE,Bag
Agrolatina,24A6583138,02/06/2025,Entry,665.0,1900.0,0,SWEET GLOBE,Bag
Agrolatina,24A6583138,02/08/2025,Sale,-95.0,1805.0,2,SWEET GLOBE,Bag
Agrolatina,24A6583138,02/13/2025,Sale,-180.0,1625.0,7,SWEET GLOBE,Bag
Agrolatina,24A6583138,02/18/2025,Sale,-95.0,1530.0,12,SWEET GLOBE,Bag
Agrolatina,24A6583138,02/21/2025,Sale,-251.0,1279.0,15,SWEET GLOBE,Bag
Agrolatina,24A6583138,02/22/2025,Sale,-630.0,649.0,16,SWEET GLOBE,Bag
Agrolatina,24A6583138,02/22/2025,Sale,-7.0,642.0,16,SWEET GLOBE,Bag
Agrolatina,24A6583138,02/24/2025,Sale,-240.0,402.0,18,SWEET GLOBE,Bag
Agrolatina,24A6583138,02/27/2025,Sale,-20.0,382.0,21,SWEET GLOBE,Bag
Agrolatina,24A6583138,02/27/2025,Sale,-29.0,353.0,21,SWEET GLOBE,Bag
Agrolatina,24A6583138,02/28/2025,Sale,-85.0,268.0,22,SWEET GLOBE,Bag
Agrolatina,24A6583138,03/11/2025,Sale,-58.0,210.0,33,SWEET GLOBE,Bag
Agrolatina,24A6583138,03/11/2025,Sale,-15.0,195.0,33,SWEET GLOBE,Bag
Agrolatina,24A6583138,03/12/2025,Sale,-40.0,155.0,34,SWEET GLOBE,Bag
Agrolatina,24A6583312,01/03/2025,Entry,1440.0,1440.0,0,CANDY SNAP,Clam
Agrolatina,24A6583312,01/03/2025,Entry,160.0,1600.0,0,CANDY SNAP,Clam
Agrolatina,24A6583312,01/27/2025,Sale,-240.0,1360.0,24,CANDY SNAP,Clam
Agrolatina,24A6583312,01/29/2025,Sale,-160.0,1200.0,26,CANDY SNAP,Clam
Agrolatina,24A6583312,01/29/2025,Sale,-400.0,800.0,26,CANDY SNAP,Clam
Agrolatina,24A6583312,01/29/2025,Sale,-320.0,480.0,26,CANDY SNAP,Clam
Agrolatina,24A6583312,01/29/2025,Sale,-80.0,400.0,26,CANDY SNAP,Clam
Agrolatina,24A6583312,01/31/2025,Sale,-240.0,160.0,28,CANDY SNAP,Clam
Agrolatina,24A6583312,02/03/2025,Sale,-80.0,80.0,31,CANDY SNAP,Clam
Agrolatina,24A6583312,02/13/2025,Sale,-80.0,0.0,41,CANDY SNAP,Clam
Agrolatina,24A6587920,01/03/2025,Entry,1280.0,1280.0,0,SWEET GLOBE,Clam
Agrolatina,24A6587920,01/03/2025,Entry,320.0,1600.0,0,SWEET GLOBE,Clam
Agrolatina,24A6587920,01/16/2025,Sale,-320.0,1280.0,13,SWEET GLOBE,Clam
Agrolatina,24A6587920,01/16/2025,Sale,-160.0,1120.0,13,SWEET GLOBE,Clam
Agrolatina,24A6587920,01/16/2025,Sale,-80.0,1040.0,13,SWEET GLOBE,Clam
Agrolatina,24A6587920,01/16/2025,Sale,-640.0,400.0,13,SWEET GLOBE,Clam
Agrolatina,24A6587920,01/21/2025,Sale,-320.0,80.0,18,SWEET GLOBE,Clam
Agrolatina,24A6587920,01/27/2025,Sale,-80.0,0.0,24,SWEET GLOBE,Clam
Agrolatina,24A6590862,03/04/2025,Entry,1280.0,1280.0,0,TIMCO,Clam
Agrolatina,24A6590862,03/04/2025,Entry,320.0,1600.0,0,TIMCO,Clam
Agrolatina,24A6590862,04/04/2025,Sale,-1280.0,320.0,31,TIMCO,Clam
Agrolatina,24A6590862,04/06/2025,Sale,-320.0,0.0,33,TIMCO,Clam
Agrolatina,24A7314756,02/06/2025,Entry,950.0,950.0,0,SWEET GLOBE,Bag
Agrolatina,24A7314756,02/06/2025,Entry,950.0,1900.0,0,SWEET GLOBE,Bag
Agrolatina,24A7314756,02/08/2025,Sale,-190.0,1710.0,2,SWEET GLOBE,Bag
Agrolatina,24A7314756,02/10/2025,Sale,-190.0,1520.0,4,SWEET GLOBE,Bag
Agrolatina,24A7314756,02/18/2025,Sale,-285.0,1235.0,12,SWEET GLOBE,Bag
Agrolatina,24A7314756,02/21/2025,Sale,-280.0,955.0,15,SWEET GLOBE,Bag
Agrolatina,24A7314756,02/22/2025,Sale,-187.0,768.0,16,SWEET GLOBE,Bag
Agrolatina,24A7314756,02/22/2025,Sale,-3.0,765.0,16,SWEET GLOBE,Bag
Agrolatina,24A7314756,02/24/2025,Sale,-335.0,430.0,18,SWEET GLOBE,Bag
Agrolatina,24A7314756,02/27/2025,Sale,-49.0,381.0,21,SWEET GLOBE,Bag
Agrolatina,24A7314756,02/28/2025,Sale,-90.0,291.0,22,SWEET GLOBE,Bag
Agrolatina,24A7314910,02/17/2025,Entry,1200.0,1200.0,0,IVORY,Clam
Agrolatina,24A7314910,02/17/2025,Entry,320.0,1520.0,0,IVORY,Clam
Agrolatina,24A7314910,02/17/2025,Entry,80.0,1600.0,0,IVORY,Clam
Agrolatina,24A7314910,02/25/2025,Sale,-160.0,1440.0,8,IVORY,Clam
Agrolatina,24A7314910,02/25/2025,Sale,-240.0,1200.0,8,IVORY,Clam
Agrolatina,24A7314910,02/26/2025,Sale,-800.0,400.0,9,IVORY,Clam
Agrolatina,24A7314910,02/26/2025,Sale,-80.0,320.0,9,IVORY,Clam
Agrolatina,24A7314910,03/27/2025,Sale,-80.0,240.0,38,IVORY,Clam
Agrolatina,24A7314910,03/28/2025,Sale,-140.0,100.0,39,IVORY,Clam
Agrolatina,24A7314910,03/29/2025,Sale,-40.0,60.0,40,IVORY,Clam
Agrolatina,24A7318068,03/04/2025,Entry,850.0,850.0,0,ALLISON,Bag
Agrolatina,24A7318068,03/04/2025,Entry,850.0,1700.0,0,ALLISON,Bag
Agrolatina,24A7318068,04/05/2025,Sale,-270.0,1430.0,32,ALLISON,Bag
Agrolatina,24A7318068,04/07/2025,Sale,-225.0,1205.0,34,ALLISON,Bag
Agrolatina,24A7318068,04/08/2025,Sale,-270.0,935.0,35,ALLISON,Bag
Agrolatina,24A7318068,04/12/2025,Sale,-511.0,424.0,39,ALLISON,Bag
Agrolatina,24A7318068,04/12/2025,Sale,-90.0,334.0,39,ALLISON,Bag
Agrolatina,24A8004043,02/24/2025,Entry,1520.0,1520.0,0,COTTON CANDY,Clam
Agrolatina,24A8004043,02/24/2025,Entry,80.0,1600.0,0,COTTON CANDY,Clam
Agrolatina,24A8004043,03/07/2025,Sale,-80.0,1520.0,11,COTTON CANDY,Clam
Agrolatina,24A8004043,03/07/2025,Sale,-80.0,1440.0,11,COTTON CANDY,Clam
Agrolatina,24A8004043,03/12/2025,Sale,-185.0,1255.0,16,COTTON CANDY,Clam
Agrolatina,24A8004043,03/13/2025,Sale,-80.0,1175.0,17,COTTON CANDY,Clam
Agrolatina,24A8004043,03/28/2025,Sale,-160.0,1015.0,32,COTTON CANDY,Clam
Agrolatina,24A8004043,04/02/2025,Sale,-40.0,975.0,37,COTTON CANDY,Clam
Agrolatina,24A8004043,04/02/2025,Sale,-80.0,895.0,37,COTTON CANDY,Clam
Agrolatina,24A8004043,04/10/2025,Sale,-80.0,815.0,45,COTTON CANDY,Clam
Agrolatina,24A8004383,02/20/2025,Entry,720.0,720.0,0,TIMCO,Clam
Agrolatina,24A8004383,02/20/2025,Entry,880.0,1600.0,0,TIMCO,Clam
Agrolatina,24A8004383,03/17/2025,Sale,-720.0,880.0,25,TIMCO,Clam
Agrolatina,24A8004383,03/27/2025,Sale,-160.0,720.0,35,TIMCO,Clam
Agrolatina,24A8004383,03/29/2025,Sale,-720.0,0.0,37,TIMCO,Clam
Agrolatina,24A8015186,02/03/2025,Entry,640.0,640.0,0,SWEET GLOBE,Clam
Agrolatina,24A8015186,02/03/2025,Entry,960.0,1600.0,0,SWEET GLOBE,Clam
Agrolatina,24A8015186,03/22/2025,Sale,-80.0,1520.0,47,SWEET GLOBE,Clam
Agrolatina,24A8015186,03/22/2025,Sale,-560.0,960.0,47,SWEET GLOBE,Clam
Agrolatina,24A8015186,03/22/2025,Sale,-320.0,640.0,47,SWEET GLOBE,Clam
Agrolatina,24A8015186,04/01/2025,Sale,-560.0,80.0,57,SWEET GLOBE,Clam
Agrolatina,24A8015186,04/04/2025,Sale,-80.0,0.0,60,SWEET GLOBE,Clam
Agrolatina,24A8015360,01/13/2025,Entry,1120.0,1120.0,0,CANDY SNAP,Clam
Agrolatina,24A8015360,01/13/2025,Entry,480.0,1600.0,0,CANDY SNAP,Clam
Agrolatina,24A8015360,01/25/2025,Sale,-480.0,1120.0,12,CANDY SNAP,Clam
Agrolatina,24A8015360,01/27/2025,Sale,-160.0,960.0,14,CANDY SNAP,Clam
Agrolatina,24A8015360,01/28/2025,Sale,-160.0,800.0,15,CANDY SNAP,Clam
Agrolatina,24A8015360,01/28/2025,Sale,-320.0,480.0,15,CANDY SNAP,Clam
Agrolatina,24A8015360,01/30/2025,Sale,-480.0,0.0,17,CANDY SNAP,Clam
Agrolatina,24A8015421,01/15/2025,Entry,1360.0,1360.0,0,SWEET GLOBE,Clam
Agrolatina,24A8015421,01/15/2025,Entry,80.0,1440.0,0,SWEET GLOBE,Clam
Agrolatina,24A8015421,01/15/2025,Entry,160.0,1600.0,0,SWEET GLOBE,Clam
Agrolatina,24A8015421,02/07/2025,Sale,-1360.0,240.0,23,SWEET GLOBE,Clam
Agrolatina,24A8015421,02/07/2025,Sale,-80.0,160.0,23,SWEET GLOBE,Clam
Agrolatina,24A8015421,02/08/2025,Sale,-160.0,0.0,24,SWEET GLOBE,Clam
Agrolatina,24A8015545,01/23/2025,Entry,400.0,400.0,0,SWEET GLOBE,Clam
Agrolatina,24A8015545,01/23/2025,Entry,1200.0,1600.0,0,SWEET GLOBE,Clam
Agrolatina,24A8015545,02/07/2025,Sale,-400.0,1200.0,15,SWEET GLOBE,Clam
Agrolatina,24A8015545,02/08/2025,Sale,-560.0,640.0,16,SWEET GLOBE,Clam
Agrolatina,24A8015545,02/17/2025,Sale,-240.0,400.0,25,SWEET GLOBE,Clam
Agrolatina,24A8015545,02/24/2025,Sale,-400.0,0.0,32,SWEET GLOBE,Clam
Agrolatina,24A8015587,01/20/2025,Entry,1440.0,1440.0,0,SWEET FAVORS,Clam
Agrolatina,24A8015587,01/20/2025,Entry,160.0,1600.0,0,SWEET FAVORS,Clam
Agrolatina,24A8015587,02/01/2025,Sale,-960.0,640.0,12,SWEET FAVORS,Clam
Agrolatina,24A8015587,02/01/2025,Sale,-80.0,560.0,12,SWEET FAVORS,Clam
Agrolatina,24A8015587,02/06/2025,Sale,-80.0,480.0,17,SWEET FAVORS,Clam
Agrolatina,24A8015587,02/15/2025,Sale,-80.0,400.0,26,SWEET FAVORS,Clam
Agrolatina,24A8015587,02/15/2025,Sale,-320.0,80.0,26,SWEET FAVORS,Clam
Agrolatina,24A8015587,02/18/2025,Sale,-80.0,0.0,29,SWEET FAVORS,Clam
Agrolatina,24A8015669,01/13/2025,Entry,1520.0,1520.0,0,CANDY SNAP,Clam
Agrolatina,24A8015669,01/13/2025,Entry,80.0,1600.0,0,CANDY SNAP,Clam
Agrolatina,24A8015669,01/20/2025,Sale,-80.0,1520.0,7,CANDY SNAP,Clam
Agrolatina,24A8015669,01/21/2025,Sale,-1040.0,480.0,8,CANDY SNAP,Clam
Agrolatina,24A8015669,01/23/2025,Sale,-400.0,80.0,10,CANDY SNAP,Clam
Agrolatina,24A8015669,02/19/2025,Sale,-73.0,7.0,37,CANDY SNAP,Clam
Agrolatina,24A8015695,01/13/2025,Entry,880.0,880.0,0,ALLISON,Clam
Agrolatina,24A8015695,01/13/2025,Entry,720.0,1600.0,0,ALLISON,Clam
Agrolatina,24A8015695,01/20/2025,Sale,-880.0,720.0,7,ALLISON,Clam
Agrolatina,24A8015695,01/21/2025,Sale,-720.0,0.0,8,ALLISON,Clam
Agrolatina,24A8015735,01/13/2025,Entry,160.0,160.0,0,IVORY,Clam
Agrolatina,24A8015735,01/13/2025,Entry,80.0,240.0,0,IVORY,Clam
Agrolatina,24A8015735,01/13/2025,Entry,1040.0,1280.0,0,SWEET GLOBE,Clam
Agrolatina,24A8015735,01/13/2025,Entry,320.0,1600.0,0,SWEET GLOBE,Clam
Agrolatina,24A8015735,01/20/2025,Sale,-160.0,1440.0,7,IVORY,Clam
Agrolatina,24A8015735,01/20/2025,Sale,-400.0,1040.0,7,SWEET GLOBE,Clam
Agrolatina,24A8015735,01/20/2025,Sale,-640.0,400.0,7,SWEET GLOBE,Clam
Agrolatina,24A8015735,01/20/2025,Sale,-320.0,80.0,7,SWEET GLOBE,Clam
Agrolatina,24A8015735,01/21/2025,Sale,-80.0,0.0,8,IVORY,Clam
Agrolatina,24A8015740,01/13/2025,Entry,1280.0,1280.0,0,SWEET GLOBE,Clam
Agrolatina,24A8015740,01/13/2025,Entry,320.0,1600.0,0,SWEET GLOBE,Clam
Agrolatina,24A8015740,01/21/2025,Sale,-320.0,1280.0,8,SWEET GLOBE,Clam
Agrolatina,24A8015740,01/27/2025,Sale,-320.0,960.0,14,SWEET GLOBE,Clam
Agrolatina,24A8015740,01/27/2025,Sale,-960.0,0.0,14,SWEET GLOBE,Clam
Agrolatina,24A8016095,02/17/2025,Entry,800.0,800.0,0,TIMCO,Clam
Agrolatina,24A8016095,02/17/2025,Entry,800.0,1600.0,0,TIMCO,Clam
Agrolatina,24A8016095,03/17/2025,Sale,-720.0,880.0,28,TIMCO,Clam
Agrolatina,24A8016095,03/20/2025,Sale,-240.0,640.0,31,TIMCO,Clam
Agrolatina,24A8016095,03/21/2025,Sale,-80.0,560.0,32,TIMCO,Clam
Agrolatina,24A8016095,03/22/2025,Sale,-560.0,0.0,33,TIMCO,Clam
Agrolatina,24A8016222,01/13/2025,Entry,80.0,80.0,0,ALLISON,Clam
Agrolatina,24A8016222,01/13/2025,Entry,160.0,240.0,0,ALLISON,Clam
Agrolatina,24A8016222,01/13/2025,Entry,720.0,960.0,0,CANDY SNAP,Clam
Agrolatina,24A8016222,01/13/2025,Entry,640.0,1600.0,0,CANDY SNAP,Clam
Agrolatina,24A8016222,01/15/2025,Sale,-80.0,1520.0,2,ALLISON,Clam
Agrolatina,24A8016222,01/15/2025,Sale,-160.0,1360.0,2,ALLISON,Clam
Agrolatina,24A8016222,01/18/2025,Sale,-480.0,880.0,5,CANDY SNAP,Clam
Agrolatina,24A8016222,01/30/2025,Sale,-80.0,800.0,17,CANDY SNAP,Clam
Agrolatina,24A8016222,01/30/2025,Sale,-320.0,480.0,17,CANDY SNAP,Clam
Agrolatina,24A8016222,02/01/2025,Sale,-160.0,320.0,19,CANDY SNAP,Clam
Agrolatina,24A8016222,02/01/2025,Sale,-160.0,160.0,19,CANDY SNAP,Clam
Agrolatina,24A8016222,02/19/2025,Sale,-148.0,12.0,37,CANDY SNAP,Clam
Agrolatina,24A8016238,02/17/2025,Entry,640.0,640.0,0,SWEET GLOBE,Clam
Agrolatina,24A8016238,02/17/2025,Entry,960.0,1600.0,0,SWEET GLOBE,Clam
Agrolatina,24A8016238,02/27/2025,Sale,-640.0,960.0,10,SWEET GLOBE,Clam
Agrolatina,24A8016238,03/06/2025,Sale,-960.0,0.0,17,SWEET GLOBE,Clam
Agrolatina,24A8016259,03/03/2025,Entry,1200.0,1200.0,0,TIMCO,Clam
Agrolatina,24A8016259,03/03/2025,Entry,400.0,1600.0,0,TIMCO,Clam
Agrolatina,24A8016259,04/08/2025,Sale,-1040.0,560.0,36,TIMCO,Clam
Agrolatina,24A8016259,04/17/2025,Sale,-160.0,400.0,45,TIMCO,Clam
Agrolatina,24A8016346,01/13/2025,Entry,1600.0,1600.0,0,SWEET FAVORS,Clam
Agrolatina,24A8016346,01/18/2025,Sale,-80.0,1520.0,5,SWEET FAVORS,Clam
Agrolatina,24A8016346,01/18/2025,Sale,-1200.0,320.0,5,SWEET FAVORS,Clam
Agrolatina,24A8016346,01/21/2025,Sale,-320.0,0.0,8,SWEET FAVORS,Clam
Agrolatina,24A8016393,01/23/2025,Entry,320.0,320.0,0,AUTUMN CRISP,Clam
Agrolatina,24A8016393,01/23/2025,Entry,1280.0,1600.0,0,AUTUMN CRISP,Clam
Agrolatina,24A8016393,01/30/2025,Sale,-320.0,1280.0,7,AUTUMN CRISP,Clam
Agrolatina,24A8016393,01/30/2025,Sale,-1200.0,80.0,7,AUTUMN CRISP,Clam
Agrolatina,24A8016393,02/17/2025,Sale,-80.0,0.0,25,AUTUMN CRISP,Clam
Agrolatina,24A8016475,02/17/2025,Entry,560.0,560.0,0,TIMCO,Clam
Agrolatina,24A8016475,02/17/2025,Entry,1040.0,1600.0,0,TIMCO,Clam
Agrolatina,24A8016536,01/23/2025,Entry,720.0,720.0,0,SWEET GLOBE,Clam
Agrolatina,24A8016536,01/23/2025,Entry,880.0,1600.0,0,SWEET GLOBE,Clam
Agrolatina,24A8016536,01/30/2025,Sale,-720.0,880.0,7,SWEET GLOBE,Clam
Agrolatina,24A8016536,01/30/2025,Sale,-560.0,320.0,7,SWEET GLOBE,Clam
Agrolatina,24A8016536,01/30/2025,Sale,-320.0,0.0,7,SWEET GLOBE,Clam
Agrolatina,24A8016855,01/13/2025,Entry,320.0,320.0,0,IVORY,Clam
Agrolatina,24A8016855,01/13/2025,Entry,1280.0,1600.0,0,SWEET GLOBE,Clam
Agrolatina,24A8016855,01/20/2025,Sale,-320.0,1280.0,7,IVORY,Clam
Agrolatina,24A8016855,01/20/2025,Sale,-640.0,640.0,7,SWEET GLOBE,Clam
Agrolatina,24A8016855,01/27/2025,Sale,-640.0,0.0,14,SWEET GLOBE,Clam
Agrolatina,24A8016897,01/13/2025,Entry,1360.0,1360.0,0,SWEET GLOBE,Clam
Agrolatina,24A8016897,01/13/2025,Entry,240.0,1600.0,0,SWEET GLOBE,Clam
Agrolatina,24A8016897,01/28/2025,Sale,-240.0,1360.0,15,SWEET GLOBE,Clam
Agrolatina,24A8016897,01/29/2025,Sale,-160.0,1200.0,16,SWEET GLOBE,Clam
Agrolatina,24A8016897,01/30/2025,Sale,-160.0,1040.0,17,SWEET GLOBE,Clam
Agrolatina,24A8016897,01/30/2025,Sale,-160.0,880.0,17,SWEET GLOBE,Clam
Agrolatina,24A8016897,01/31/2025,Sale,-160.0,720.0,18,SWEET GLOBE,Clam
Agrolatina,24A8016897,01/31/2025,Sale,-160.0,560.0,18,SWEET GLOBE,Clam
Agrolatina,24A8016897,02/01/2025,Sale,-160.0,400.0,19,SWEET GLOBE,Clam
Agrolatina,24A8016897,02/03/2025,Sale,-80.0,320.0,21,SWEET GLOBE,Clam
Agrolatina,24A8016897,02/04/2025,Sale,-80.0,240.0,22,SWEET GLOBE,Clam
Agrolatina,24A8016897,02/12/2025,Sale,-160.0,80.0,30,SWEET GLOBE,Clam
Agrolatina,24A8016897,02/14/2025,Sale,-78.0,2.0,32,SWEET GLOBE,Clam
Agrolatina,24A8017039,01/23/2025,Entry,1615.0,1615.0,0,SWEET GLOBE,Bag
Agrolatina,24A8017039,01/23/2025,Entry,285.0,1900.0,0,SWEET GLOBE,Bag
Agrolatina,24A8017039,01/31/2025,Sale,-380.0,1520.0,8,SWEET GLOBE,Bag
Agrolatina,24A8017039,02/10/2025,Sale,-475.0,1045.0,18,SWEET GLOBE,Bag
Agrolatina,24A8017039,02/13/2025,Sale,-90.0,955.0,21,SWEET GLOBE,Bag
Agrolatina,24A8017039,02/21/2025,Sale,-202.0,753.0,29,SWEET GLOBE,Bag
Agrolatina,24A8017039,02/22/2025,Sale,-270.0,483.0,30,SWEET GLOBE,Bag
Agrolatina,24A8017039,02/22/2025,Sale,-3.0,480.0,30,SWEET GLOBE,Bag
Agrolatina,24A8017039,02/27/2025,Sale,-70.0,410.0,35,SWEET GLOBE,Bag
Agrolatina,24A8017039,02/27/2025,Sale,-92.0,318.0,35,SWEET GLOBE,Bag
Agrolatina,24A8017039,03/10/2025,Sale,-47.0,271.0,46,SWEET GLOBE,Bag
Agrolatina,24A8017039,03/11/2025,Sale,-6.0,265.0,47,SWEET GLOBE,Bag
Agrolatina,24A8017039,03/12/2025,Sale,-36.0,229.0,48,SWEET GLOBE,Bag
Agrolatina,24A8017189,01/13/2025,Entry,1140.0,1140.0,0,SWEET GLOBE,Bag
Agrolatina,24A8017189,01/13/2025,Entry,190.0,1330.0,0,SWEET GLOBE,Bag
Agrolatina,24A8017189,01/13/2025,Entry,570.0,1900.0,0,SWEET GLOBE,Bag
Agrolatina,24A8017189,01/23/2025,Sale,-95.0,1805.0,10,SWEET GLOBE,Bag
Agrolatina,24A8017189,01/24/2025,Sale,-1045.0,760.0,11,SWEET GLOBE,Bag
Agrolatina,24A8017189,01/25/2025,Sale,-95.0,665.0,12,SWEET GLOBE,Bag
Agrolatina,24A8017189,01/27/2025,Sale,-475.0,190.0,14,SWEET GLOBE,Bag
Agrolatina,24A8017189,01/28/2025,Sale,-190.0,0.0,15,SWEET GLOBE,Bag
Agrolatina,24A8017933,01/23/2025,Entry,400.0,400.0,0,AUTUMN CRISP,Clam
Agrolatina,24A8017933,01/23/2025,Entry,1200.0,1600.0,0,AUTUMN CRISP,Clam
Agrolatina,24A8017933,01/29/2025,Sale,-1200.0,400.0,6,AUTUMN CRISP,Clam
Agrolatina,24A8017933,01/30/2025,Sale,-400.0,0.0,7,AUTUMN CRISP,Clam
Agrolatina,24A8017980,01/13/2025,Entry,1280.0,1280.0,0,ALLISON,Clam
Agrolatina,24A8017980,01/13/2025,Entry,320.0,1600.0,0,ALLISON,Clam
Agrolatina,24A8017980,01/21/2025,Sale,-320.0,1280.0,8,ALLISON,Clam
Agrolatina,24A8017980,01/23/2025,Sale,-1280.0,0.0,10,ALLISON,Clam
Agrolatina,24A8018181,02/27/2025,Entry,1200.0,1200.0,0,SWEET GLOBE,Clam
Agrolatina,24A8018181,02/27/2025,Entry,400.0,1600.0,0,SWEET GLOBE,Clam
Agrolatina,24A8018181,03/07/2025,Sale,-80.0,1520.0,8,SWEET GLOBE,Clam
Agrolatina,24A8018181,03/08/2025,Sale,-1040.0,480.0,9,SWEET GLOBE,Clam
Agrolatina,24A8018181,03/08/2025,Sale,-80.0,400.0,9,SWEET GLOBE,Clam
Agrolatina,24A8018181,03/10/2025,Sale,-18.0,382.0,11,SWEET GLOBE,Clam
Agrolatina,24A8018181,03/11/2025,Sale,-20.0,362.0,12,SWEET GLOBE,Clam
Agrolatina,24A8018181,03/11/2025,Sale,-20.0,342.0,12,SWEET GLOBE,Clam
Agrolatina,24A8018181,03/15/2025,Sale,-40.0,302.0,16,SWEET GLOBE,Clam
Agrolatina,24A8018181,03/15/2025,Sale,-160.0,142.0,16,SWEET GLOBE,Clam
Agrolatina,24A8018502,01/13/2025,Entry,1330.0,1330.0,0,SWEET GLOBE,Bag
Agrolatina,24A8018502,01/13/2025,Entry,190.0,1520.0,0,SWEET GLOBE,Bag
Agrolatina,24A8018502,01/13/2025,Entry,380.0,1900.0,0,SWEET GLOBE,Bag
Agrolatina,24A8018502,01/23/2025,Sale,-95.0,1805.0,10,SWEET GLOBE,Bag
Agrolatina,24A8018502,01/23/2025,Sale,-570.0,1235.0,10,SWEET GLOBE,Bag
Agrolatina,24A8018502,01/24/2025,Sale,-95.0,1140.0,11,SWEET GLOBE,Bag
Agrolatina,24A8018502,01/25/2025,Sale,-380.0,760.0,12,SWEET GLOBE,Bag
Agrolatina,24A8018502,01/28/2025,Sale,-190.0,570.0,15,SWEET GLOBE,Bag
Agrolatina,24A8018502,02/04/2025,Sale,-285.0,285.0,22,SWEET GLOBE,Bag
Agrolatina,24A8018502,02/21/2025,Sale,-60.0,225.0,39,SWEET GLOBE,Bag
Agrolatina,24A8018502,02/22/2025,Sale,-10.0,215.0,40,SWEET GLOBE,Bag
Agrolatina,24A8018502,02/27/2025,Sale,-90.0,125.0,45,SWEET GLOBE,Bag
Agrolatina,24A8018502,02/28/2025,Sale,-70.0,55.0,46,SWEET GLOBE,Bag
Agrolatina,24A8018781,01/13/2025,Entry,1280.0,1280.0,0,CANDY SNAP,Clam
Agrolatina,24A8018781,01/13/2025,Entry,320.0,1600.0,0,CANDY SNAP,Clam
Agrolatina,24A8018781,01/18/2025,Sale,-1280.0,320.0,5,CANDY SNAP,Clam
Agrolatina,24A8018781,01/20/2025,Sale,-320.0,0.0,7,CANDY SNAP,Clam
Agrolatina,24A8018797,01/13/2025,Entry,95.0,95.0,0,IVORY,Bag
Agrolatina,24A8018797,01/13/2025,Entry,1235.0,1330.0,0,SWEET GLOBE,Bag
Agrolatina,24A8018797,01/13/2025,Entry,190.0,1520.0,0,SWEET GLOBE,Bag
Agrolatina,24A8018797,01/13/2025,Entry,380.0,1900.0,0,SWEET GLOBE,Bag
Agrolatina,24A8018797,01/21/2025,Sale,-950.0,950.0,8,SWEET GLOBE,Bag
Agrolatina,24A8018797,01/21/2025,Sale,-190.0,760.0,8,SWEET GLOBE,Bag
Agrolatina,24A8018797,01/21/2025,Sale,-380.0,380.0,8,SWEET GLOBE,Bag
Agrolatina,24A8018797,02/04/2025,Sale,-285.0,95.0,22,SWEET GLOBE,Bag
Agrolatina,24A8018903,01/23/2025,Entry,1235.0,1235.0,0,SWEET GLOBE,Bag
Agrolatina,24A8018903,01/23/2025,Entry,285.0,1520.0,0,SWEET GLOBE,Bag
Agrolatina,24A8018903,01/23/2025,Entry,380.0,1900.0,0,SWEET GLOBE,Bag
Agrolatina,24A8018903,01/31/2025,Sale,-190.0,1710.0,8,SWEET GLOBE,Bag
Agrolatina,24A8018903,02/04/2025,Sale,-190.0,1520.0,12,SWEET GLOBE,Bag
Agrolatina,24A8018903,02/04/2025,Sale,-95.0,1425.0,12,SWEET GLOBE,Bag
Agrolatina,24A8018903,02/06/2025,Sale,-570.0,855.0,14,SWEET GLOBE,Bag
Agrolatina,24A8018903,02/10/2025,Sale,-380.0,475.0,18,SWEET GLOBE,Bag
Agrolatina,24A8018903,02/11/2025,Sale,-95.0,380.0,19,SWEET GLOBE,Bag
Agrolatina,24A8018903,02/17/2025,Sale,-95.0,285.0,25,SWEET GLOBE,Bag
Agrolatina,24A8018903,03/10/2025,Sale,-50.0,235.0,46,SWEET GLOBE,Bag
Agrolatina,24A8018903,03/11/2025,Sale,-70.0,165.0,47,SWEET GLOBE,Bag
Agrolatina,24A8018903,03/11/2025,Sale,-60.0,105.0,47,SWEET GLOBE,Bag
Agrolatina,24A8019345,01/13/2025,Entry,1200.0,1200.0,0,ALLISON,Clam
Agrolatina,24A8019345,01/13/2025,Entry,400.0,1600.0,0,ALLISON,Clam
Agrolatina,24A8019345,01/20/2025,Sale,-240.0,1360.0,7,ALLISON,Clam
Agrolatina,24A8019345,01/20/2025,Sale,-960.0,400.0,7,ALLISON,Clam
Agrolatina,24A8019345,01/21/2025,Sale,-400.0,0.0,8,ALLISON,Clam
Agrolatina,24A8019495,01/23/2025,Entry,480.0,480.0,0,AUTUMN CRISP,Clam
Agrolatina,24A8019495,01/23/2025,Entry,1120.0,1600.0,0,AUTUMN CRISP,Clam
Agrolatina,24A8019495,01/29/2025,Sale,-720.0,880.0,6,AUTUMN CRISP,Clam
Agrolatina,24A8019495,01/30/2025,Sale,-480.0,400.0,7,AUTUMN CRISP,Clam
Agrolatina,24A8019495,01/30/2025,Sale,-400.0,0.0,7,AUTUMN CRISP,Clam
Agrolatina,24A8019617,01/23/2025,Entry,1520.0,1520.0,0,SWEET GLOBE,Clam
Agrolatina,24A8019617,01/23/2025,Entry,80.0,1600.0,0,SWEET GLOBE,Clam
Agrolatina,24A8019617,01/28/2025,Sale,-240.0,1360.0,5,SWEET GLOBE,Clam
Agrolatina,24A8019617,01/28/2025,Sale,-960.0,400.0,5,SWEET GLOBE,Clam
Agrolatina,24A8019617,01/28/2025,Sale,-320.0,80.0,5,SWEET GLOBE,Clam
Agrolatina,24A8019617,01/28/2025,Sale,-80.0,0.0,5,SWEET GLOBE,Clam
Agrolatina,24A8019664,01/23/2025,Entry,1600.0,1600.0,0,ALLISON,Clam
Agrolatina,24A8019664,02/11/2025,Sale,-720.0,880.0,19,ALLISON,Clam
Agrolatina,24A8019664,02/12/2025,Sale,-320.0,560.0,20,ALLISON,Clam
Agrolatina,24A8019664,02/18/2025,Sale,-560.0,0.0,26,ALLISON,Clam
Agrolatina,24A8019978,01/13/2025,Entry,1360.0,1360.0,0,ALLISON,Clam
Agrolatina,24A8019978,01/13/2025,Entry,240.0,1600.0,0,ALLISON,Clam
Agrolatina,24A8019978,01/21/2025,Sale,-240.0,1360.0,8,ALLISON,Clam
Agrolatina,24A8019978,01/23/2025,Sale,-1200.0,160.0,10,ALLISON,Clam
Agrolatina,24A8019978,02/12/2025,Sale,-160.0,0.0,30,ALLISON,Clam
Agrolatina,24A8019983,01/13/2025,Entry,640.0,640.0,0,CANDY SNAP,Clam
Agrolatina,24A8019983,01/13/2025,Entry,960.0,1600.0,0,CANDY SNAP,Clam
Agrolatina,24A8019983,01/18/2025,Sale,-320.0,1280.0,5,CANDY SNAP,Clam
Agrolatina,24A8019983,01/30/2025,Sale,-640.0,640.0,17,CANDY SNAP,Clam
Agrolatina,24A8019983,01/30/2025,Sale,-320.0,320.0,17,CANDY SNAP,Clam
Agrolatina,24A8019983,02/01/2025,Sale,-320.0,0.0,19,CANDY SNAP,Clam
Agrolatina,24A8020032,04/14/2025,Entry,1200.0,1200.0,0,SWEET GLOBE,Clam
Agrolatina,24A8020032,04/14/2025,Entry,400.0,1600.0,0,SWEET GLOBE,Clam
Agrolatina,24A8020032,04/28/2025,Sale,-1200.0,400.0,14,SWEET GLOBE,Clam
Agrolatina,24A8020032,04/28/2025,Sale,-400.0,0.0,14,SWEET GLOBE,Clam
Agrolatina,24A8020095,01/13/2025,Entry,1200.0,1200.0,0,SWEET GLOBE,Clam
Agrolatina,24A8020095,01/13/2025,Entry,400.0,1600.0,0,SWEET GLOBE,Clam
Agrolatina,24A8020095,01/18/2025,Sale,-400.0,1200.0,5,SWEET GLOBE,Clam
Agrolatina,24A8020095,01/20/2025,Sale,-800.0,400.0,7,SWEET GLOBE,Clam
Agrolatina,24A8020095,01/20/2025,Sale,-80.0,320.0,7,SWEET GLOBE,Clam
Agrolatina,24A8020095,01/21/2025,Sale,-320.0,0.0,8,SWEET GLOBE,Clam
Agrolatina,24A8020182,01/13/2025,Entry,1360.0,1360.0,0,IVORY,Clam
Agrolatina,24A8020182,01/13/2025,Entry,240.0,1600.0,0,IVORY,Clam
Agrolatina,24A8020182,01/23/2025,Sale,-1280.0,320.0,10,IVORY,Clam
Agrolatina,24A8020182,01/29/2025,Sale,-80.0,240.0,16,IVORY,Clam
Agrolatina,24A8020182,01/29/2025,Sale,-240.0,0.0,16,IVORY,Clam
Agrolatina,24A8020238,01/23/2025,Entry,720.0,720.0,0,AUTUMN CRISP,Clam
Agrolatina,24A8020238,01/23/2025,Entry,880.0,1600.0,0,AUTUMN CRISP,Clam
Agrolatina,24A8020238,01/30/2025,Sale,-400.0,1200.0,7,AUTUMN CRISP,Clam
Agrolatina,24A8020238,01/30/2025,Sale,-320.0,880.0,7,AUTUMN CRISP,Clam
Agrolatina,24A8020238,01/31/2025,Sale,-320.0,560.0,8,AUTUMN CRISP,Clam
Agrolatina,24A8020238,01/31/2025,Sale,-560.0,0.0,8,AUTUMN CRISP,Clam
Agrolatina,24A8020639,01/23/2025,Entry,880.0,880.0,0,SWEET GLOBE,Clam
Agrolatina,24A8020639,01/23/2025,Entry,720.0,1600.0,0,SWEET GLOBE,Clam
Agrolatina,24A8020639,01/29/2025,Sale,-880.0,720.0,6,SWEET GLOBE,Clam
Agrolatina,24A8020639,01/29/2025,Sale,-720.0,0.0,6,SWEET GLOBE,Clam
Agrolatina,24A8021023,03/10/2025,Entry,880.0,880.0,0,TIMCO,Clam
Agrolatina,24A8021023,03/10/2025,Entry,80.0,960.0,0,TIMCO,Clam
Agrolatina,24A8021023,03/10/2025,Entry,640.0,1600.0,0,TIMCO,Clam
Agrolatina,24A8021023,03/25/2025,Sale,-560.0,1040.0,15,TIMCO,Clam
Agrolatina,24A8021023,03/28/2025,Sale,-80.0,960.0,18,TIMCO,Clam
Agrolatina,24A8021023,04/01/2025,Sale,-80.0,880.0,22,TIMCO,Clam
Agrolatina,24A8021023,04/01/2025,Sale,-80.0,800.0,22,TIMCO,Clam
Agrolatina,24A8021023,04/02/2025,Sale,-80.0,720.0,23,TIMCO,Clam
Agrolatina,24A8021023,04/03/2025,Sale,-160.0,560.0,24,TIMCO,Clam
Agrolatina,24A8021023,04/04/2025,Sale,-80.0,480.0,25,TIMCO,Clam
Agrolatina,24A8021023,04/07/2025,Sale,-80.0,400.0,28,TIMCO,Clam
Agrolatina,24A8021023,04/10/2025,Sale,-400.0,0.0,31,TIMCO,Clam
Agrolatina,24A8021070,02/17/2025,Entry,560.0,560.0,0,TIMCO,Clam
Agrolatina,24A8021070,02/17/2025,Entry,1040.0,1600.0,0,TIMCO,Clam
Agrolatina,24A8021110,01/23/2025,Entry,80.0,80.0,0,AUTUMN CRISP,Clam
Agrolatina,24A8021110,01/23/2025,Entry,320.0,400.0,0,AUTUMN CRISP,Clam
Agrolatina,24A8021110,01/23/2025,Entry,1200.0,1600.0,0,AUTUMN CRISP,Clam
Agrolatina,24A8021110,01/30/2025,Sale,-240.0,1360.0,7,AUTUMN CRISP,Clam
Agrolatina,24A8021110,01/31/2025,Sale,-80.0,1280.0,8,AUTUMN CRISP,Clam
Agrolatina,24A8021110,01/31/2025,Sale,-80.0,1200.0,8,AUTUMN CRISP,Clam
Agrolatina,24A8021110,02/01/2025,Sale,-80.0,1120.0,9,AUTUMN CRISP,Clam
Agrolatina,24A8021110,02/17/2025,Sale,-560.0,560.0,25,AUTUMN CRISP,Clam
Agrolatina,24A8021110,02/22/2025,Sale,-560.0,0.0,30,AUTUMN CRISP,Clam
Agrolatina,24A8021281,01/13/2025,Entry,1200.0,1200.0,0,ALLISON,Clam
Agrolatina,24A8021281,01/13/2025,Entry,400.0,1600.0,0,ALLISON,Clam
Agrolatina,24A8021281,01/21/2025,Sale,-320.0,1280.0,8,ALLISON,Clam
Agrolatina,24A8021281,01/22/2025,Sale,-800.0,480.0,9,ALLISON,Clam
Agrolatina,24A8021281,01/23/2025,Sale,-400.0,80.0,10,ALLISON,Clam
Agrolatina,24A8021281,01/23/2025,Sale,-80.0,0.0,10,ALLISON,Clam
Agrolatina,24A8021337,01/13/2025,Entry,1280.0,1280.0,0,ALLISON,Clam
Agrolatina,24A8021337,01/13/2025,Entry,320.0,1600.0,0,ALLISON,Clam
Agrolatina,24A8021337,01/22/2025,Sale,-480.0,1120.0,9,ALLISON,Clam
Agrolatina,24A8021337,01/22/2025,Sale,-800.0,320.0,9,ALLISON,Clam
Agrolatina,24A8021337,01/23/2025,Sale,-320.0,0.0,10,ALLISON,Clam
Agrolatina,24A8021450,01/13/2025,Entry,1235.0,1235.0,0,SWEET GLOBE,Bag
Agrolatina,24A8021450,01/13/2025,Entry,190.0,1425.0,0,SWEET GLOBE,Bag
Agrolatina,24A8021450,01/13/2025,Entry,475.0,1900.0,0,SWEET GLOBE,Bag
Agrolatina,24A8021450,01/25/2025,Sale,-475.0,1425.0,12,SWEET GLOBE,Bag
Agrolatina,24A8021450,02/06/2025,Sale,-475.0,950.0,24,SWEET GLOBE,Bag
Agrolatina,24A8021450,02/06/2025,Sale,-380.0,570.0,24,SWEET GLOBE,Bag
Agrolatina,24A8021450,02/11/2025,Sale,-380.0,190.0,29,SWEET GLOBE,Bag
Agrolatina,24A8021450,02/13/2025,Sale,-190.0,0.0,31,SWEET GLOBE,Bag
Agrolatina,24A8021713,02/03/2025,Entry,1440.0,1440.0,0,SWEET GLOBE,Clam
Agrolatina,24A8021713,02/03/2025,Entry,160.0,1600.0,0,SWEET GLOBE,Clam
Agrolatina,24A8021713,02/07/2025,Sale,-320.0,1280.0,4,SWEET GLOBE,Clam
Agrolatina,24A8021713,02/08/2025,Sale,-80.0,1200.0,5,SWEET GLOBE,Clam
Agrolatina,24A8021713,02/08/2025,Sale,-80.0,1120.0,5,SWEET GLOBE,Clam
Agrolatina,24A8021713,02/08/2025,Sale,-80.0,1040.0,5,SWEET GLOBE,Clam
Agrolatina,24A8021713,02/10/2025,Sale,-80.0,960.0,7,SWEET GLOBE,Clam
Agrolatina,24A8021713,02/10/2025,Sale,-160.0,800.0,7,SWEET GLOBE,Clam
Agrolatina,24A8021713,02/10/2025,Sale,-160.0,640.0,7,SWEET GLOBE,Clam
Agrolatina,24A8021713,02/11/2025,Sale,-80.0,560.0,8,SWEET GLOBE,Clam
Agrolatina,24A8021713,02/17/2025,Sale,-80.0,480.0,14,SWEET GLOBE,Clam
Agrolatina,24A8021713,02/18/2025,Sale,-80.0,400.0,15,SWEET GLOBE,Clam
Agrolatina,24A8021713,02/22/2025,Sale,-10.0,390.0,19,SWEET GLOBE,Clam
Agrolatina,24A8021713,02/22/2025,Sale,-60.0,330.0,19,SWEET GLOBE,Clam
Agrolatina,24A8021713,02/24/2025,Sale,-50.0,280.0,21,SWEET GLOBE,Clam
Agrolatina,24A8021713,02/25/2025,Sale,-45.0,235.0,22,SWEET GLOBE,Clam
Agrolatina,24A8021713,02/28/2025,Sale,-40.0,195.0,25,SWEET GLOBE,Clam
Agrolatina,24A8021713,03/05/2025,Sale,-40.0,155.0,30,SWEET GLOBE,Clam
Agrolatina,24A8022143,01/13/2025,Entry,1520.0,1520.0,0,CANDY SNAP,Clam
Agrolatina,24A8022143,01/13/2025,Entry,80.0,1600.0,0,CANDY SNAP,Clam
Agrolatina,24A8022143,01/27/2025,Sale,-640.0,960.0,14,CANDY SNAP,Clam
Agrolatina,24A8022143,01/29/2025,Sale,-160.0,800.0,16,CANDY SNAP,Clam
Agrolatina,24A8022143,01/29/2025,Sale,-160.0,640.0,16,CANDY SNAP,Clam
Agrolatina,24A8022143,01/30/2025,Sale,-80.0,560.0,17,CANDY SNAP,Clam
Agrolatina,24A8022143,02/01/2025,Sale,-560.0,0.0,19,CANDY SNAP,Clam
Agrolatina,24A8022225,01/23/2025,Entry,240.0,240.0,0,AUTUMN CRISP,Clam
Agrolatina,24A8022225,01/23/2025,Entry,960.0,1200.0,0,AUTUMN CRISP,Clam
Agrolatina,24A8022225,01/23/2025,Entry,400.0,1600.0,0,AUTUMN CRISP,Clam
Agrolatina,24A8022225,01/30/2025,Sale,-80.0,1520.0,7,AUTUMN CRISP,Clam
Agrolatina,24A8022225,01/31/2025,Sale,-880.0,640.0,8,AUTUMN CRISP,Clam
Agrolatina,24A8022225,02/01/2025,Sale,-240.0,400.0,9,AUTUMN CRISP,Clam
Agrolatina,24A8022225,02/22/2025,Sale,-400.0,0.0,30,AUTUMN CRISP,Clam
Agrolatina,24A8022354,01/13/2025,Entry,1520.0,1520.0,0,SWEET FAVORS,Clam
Agrolatina,24A8022354,01/13/2025,Entry,80.0,1600.0,0,SWEET FAVORS,Clam
Agrolatina,24A8022354,01/23/2025,Sale,-80.0,1520.0,10,SWEET FAVORS,Clam
Agrolatina,24A8022354,02/03/2025,Sale,-80.0,1440.0,21,SWEET FAVORS,Clam
Agrolatina,24A8022354,02/15/2025,Sale,-560.0,880.0,33,SWEET FAVORS,Clam
Agrolatina,24A8022354,02/17/2025,Sale,-480.0,400.0,35,SWEET FAVORS,Clam
Agrolatina,24A8022354,02/18/2025,Sale,-400.0,0.0,36,SWEET FAVORS,Clam
Agrolatina,24A8022499,01/23/2025,Entry,1330.0,1330.0,0,SWEET GLOBE,Bag
Agrolatina,24A8022499,01/23/2025,Entry,285.0,1615.0,0,SWEET GLOBE,Bag
Agrolatina,24A8022499,01/23/2025,Entry,285.0,1900.0,0,SWEET GLOBE,Bag
Agrolatina,24A8022499,02/04/2025,Sale,-95.0,1805.0,12,SWEET GLOBE,Bag
Agrolatina,24A8022499,02/06/2025,Sale,-190.0,1615.0,14,SWEET GLOBE,Bag
Agrolatina,24A8022499,02/07/2025,Sale,-190.0,1425.0,15,SWEET GLOBE,Bag
Agrolatina,24A8022499,02/08/2025,Sale,-570.0,855.0,16,SWEET GLOBE,Bag
Agrolatina,24A8022499,02/11/2025,Sale,-380.0,475.0,19,SWEET GLOBE,Bag
Agrolatina,24A8022499,02/13/2025,Sale,-95.0,380.0,21,SWEET GLOBE,Bag
Agrolatina,24A8022499,02/17/2025,Sale,-95.0,285.0,25,SWEET GLOBE,Bag
Agrolatina,24A8022499,02/22/2025,Sale,-7.0,278.0,30,SWEET GLOBE,Bag
Agrolatina,24A8022499,02/24/2025,Sale,-110.0,168.0,32,SWEET GLOBE,Bag
Agrolatina,24A8022499,02/27/2025,Sale,-45.0,123.0,35,SWEET GLOBE,Bag
Agrolatina,24A8022499,02/28/2025,Sale,-90.0,33.0,36,SWEET GLOBE,Bag
Agrolatina,24A8022586,02/10/2025,Entry,1280.0,1280.0,0,TIMCO,Clam
Agrolatina,24A8022586,02/10/2025,Entry,160.0,1440.0,0,TIMCO,Clam
Agrolatina,24A8022586,02/10/2025,Entry,160.0,1600.0,0,TIMCO,Clam
Agrolatina,24A8022586,03/08/2025,Sale,-800.0,800.0,26,TIMCO,Clam
Agrolatina,24A8022586,03/08/2025,Sale,-480.0,320.0,26,TIMCO,Clam
Agrolatina,24A8022586,03/14/2025,Sale,-160.0,160.0,32,TIMCO,Clam
Agrolatina,24A8022586,03/17/2025,Sale,-160.0,0.0,35,TIMCO,Clam
Agrolatina,24A8022673,01/23/2025,Entry,160.0,160.0,0,AUTUMN CRISP,Clam
Agrolatina,24A8022673,01/23/2025,Entry,1120.0,1280.0,0,AUTUMN CRISP,Clam
Agrolatina,24A8022673,01/23/2025,Entry,320.0,1600.0,0,AUTUMN CRISP,Clam
Agrolatina,24A8022673,02/05/2025,Sale,-160.0,1440.0,13,AUTUMN CRISP,Clam
Agrolatina,24A8022673,02/05/2025,Sale,-640.0,800.0,13,AUTUMN CRISP,Clam
Agrolatina,24A8022673,02/11/2025,Sale,-480.0,320.0,19,AUTUMN CRISP,Clam
Agrolatina,24A8022673,02/12/2025,Sale,-320.0,0.0,20,AUTUMN CRISP,Clam
Agrolatina,24A8022689,02/10/2025,Entry,1280.0,1280.0,0,TIMCO,Clam
Agrolatina,24A8022689,02/10/2025,Entry,160.0,1440.0,0,TIMCO,Clam
Agrolatina,24A8022689,02/10/2025,Entry,160.0,1600.0,0,TIMCO,Clam
Agrolatina,24A8022689,03/05/2025,Sale,-720.0,880.0,23,TIMCO,Clam
Agrolatina,24A8022689,03/05/2025,Sale,-160.0,720.0,23,TIMCO,Clam
Agrolatina,24A8022689,03/06/2025,Sale,-160.0,560.0,24,TIMCO,Clam
Agrolatina,24A8022689,03/07/2025,Sale,-240.0,320.0,25,TIMCO,Clam
Agrolatina,24A8022689,03/10/2025,Sale,-160.0,160.0,28,TIMCO,Clam
Agrolatina,24A8022689,03/10/2025,Sale,-160.0,0.0,28,TIMCO,Clam
Agrolatina,24A8022797,01/23/2025,Entry,1520.0,1520.0,0,SWEET GLOBE,Clam
Agrolatina,24A8022797,01/23/2025,Entry,80.0,1600.0,0,SWEET GLOBE,Clam
Agrolatina,24A8022797,02/03/2025,Sale,-320.0,1280.0,11,SWEET GLOBE,Clam
Agrolatina,24A8022797,02/04/2025,Sale,-1040.0,240.0,12,SWEET GLOBE,Clam
Agrolatina,24A8022797,02/04/2025,Sale,-80.0,160.0,12,SWEET GLOBE,Clam
Agrolatina,24A8022797,02/04/2025,Sale,-80.0,80.0,12,SWEET GLOBE,Clam
Agrolatina,24A8022797,02/05/2025,Sale,-80.0,0.0,13,SWEET GLOBE,Clam
Agrolatina,24A8023094,01/13/2025,Entry,1440.0,1440.0,0,SWEET GLOBE,Clam
Agrolatina,24A8023094,01/13/2025,Entry,160.0,1600.0,0,SWEET GLOBE,Clam
Agrolatina,24A8023094,01/18/2025,Sale,-160.0,1440.0,5,SWEET GLOBE,Clam
Agrolatina,24A8023094,01/28/2025,Sale,-960.0,480.0,15,SWEET GLOBE,Clam
Agrolatina,24A8023094,01/28/2025,Sale,-160.0,320.0,15,SWEET GLOBE,Clam
Agrolatina,24A8023094,01/29/2025,Sale,-160.0,160.0,16,SWEET GLOBE,Clam
Agrolatina,24A8023094,01/29/2025,Sale,-160.0,0.0,16,SWEET GLOBE,Clam
Agrolatina,24A8023134,01/13/2025,Entry,1280.0,1280.0,0,SWEET GLOBE,Clam
Agrolatina,24A8023134,01/13/2025,Entry,320.0,1600.0,0,SWEET GLOBE,Clam
Agrolatina,24A8023134,01/21/2025,Sale,-320.0,1280.0,8,SWEET GLOBE,Clam
Agrolatina,24A8023134,01/28/2025,Sale,-1280.0,0.0,15,SWEET GLOBE,Clam
Agrolatina,24A8023242,02/24/2025,Entry,1440.0,1440.0,0,TIMCO,Clam
Agrolatina,24A8023242,02/24/2025,Entry,160.0,1600.0,0,TIMCO,Clam
Agrolatina,24A8023242,03/05/2025,Sale,-880.0,720.0,9,TIMCO,Clam
Agrolatina,24A8023242,03/06/2025,Sale,-160.0,560.0,10,TIMCO,Clam
Agrolatina,24A8023242,03/12/2025,Sale,-560.0,0.0,16,TIMCO,Clam
Agrolatina,24A8023448,02/28/2025,Entry,1280.0,1280.0,0,TIMCO,Clam
Agrolatina,24A8023448,02/28/2025,Entry,320.0,1600.0,0,TIMCO,Clam
Agrolatina,24A8023448,03/29/2025,Sale,-80.0,1520.0,29,TIMCO,Clam
Agrolatina,24A8023448,04/02/2025,Sale,-1280.0,240.0,33,TIMCO,Clam
Agrolatina,24A8023448,04/06/2025,Sale,-240.0,0.0,37,TIMCO,Clam
Agrolatina,24A8023474,02/28/2025,Entry,1600.0,1600.0,0,TIMCO,Clam
Agrolatina,24A8023474,04/02/2025,Sale,-1040.0,560.0,33,TIMCO,Clam
Agrolatina,24A8023474,04/02/2025,Sale,-400.0,160.0,33,TIMCO,Clam
Agrolatina,24A8023474,04/07/2025,Sale,-160.0,0.0,38,TIMCO,Clam
Agrolatina,24A8023793,01/13/2025,Entry,1360.0,1360.0,0,ALLISON,Clam
Agrolatina,24A8023793,01/13/2025,Entry,240.0,1600.0,0,ALLISON,Clam
Agrolatina,24A8023793,01/21/2025,Sale,-240.0,1360.0,8,ALLISON,Clam
Agrolatina,24A8023793,01/22/2025,Sale,-1120.0,240.0,9,ALLISON,Clam
Agrolatina,24A8023793,01/23/2025,Sale,-240.0,0.0,10,ALLISON,Clam
Agrolatina,24A8023896,02/28/2025,Entry,1280.0,1280.0,0,TIMCO,Clam
Agrolatina,24A8023896,02/28/2025,Entry,320.0,1600.0,0,TIMCO,Clam
Agrolatina,24A8023896,03/29/2025,Sale,-240.0,1360.0,29,TIMCO,Clam
Agrolatina,24A8023896,04/06/2025,Sale,-80.0,1280.0,37,TIMCO,Clam
Agrolatina,24A8023896,04/07/2025,Sale,-1280.0,0.0,38,TIMCO,Clam
Agrolatina,24A8023920,01/13/2025,Entry,1600.0,1600.0,0,SWEET FAVORS,Clam
Agrolatina,24A8023920,01/22/2025,Sale,-720.0,880.0,9,SWEET FAVORS,Clam
Agrolatina,24A8023920,01/22/2025,Sale,-880.0,0.0,9,SWEET FAVORS,Clam
Agrolatina,24A8023936,03/03/2025,Entry,880.0,880.0,0,SWEET GLOBE,Clam
Agrolatina,24A8023936,03/03/2025,Entry,720.0,1600.0,0,SWEET GLOBE,Clam
Agrolatina,24A8023936,03/22/2025,Sale,-480.0,1120.0,19,SWEET GLOBE,Clam
Agrolatina,24A8023936,03/22/2025,Sale,-240.0,880.0,19,SWEET GLOBE,Clam
Agrolatina,24A8023936,03/22/2025,Sale,-720.0,160.0,19,SWEET GLOBE,Clam
Agrolatina,24A8023936,04/04/2025,Sale,-160.0,0.0,32,SWEET GLOBE,Clam
Agrolatina,24A8024038,04/14/2025,Entry,1360.0,1360.0,0,SWEET GLOBE,Clam
Agrolatina,24A8024038,04/14/2025,Entry,240.0,1600.0,0,SWEET GLOBE,Clam
Agrolatina,24A8024038,04/28/2025,Sale,-320.0,1280.0,14,SWEET GLOBE,Clam
Agrolatina,24A8024038,04/28/2025,Sale,-720.0,560.0,14,SWEET GLOBE,Clam
Agrolatina,24A8024038,04/28/2025,Sale,-240.0,320.0,14,SWEET GLOBE,Clam
Agrolatina,24A8024038,04/30/2025,Sale,-320.0,0.0,16,SWEET GLOBE,Clam
Agrolatina,24A8024104,01/23/2025,Entry,1330.0,1330.0,0,SWEET GLOBE,Bag
Agrolatina,24A8024104,01/23/2025,Entry,190.0,1520.0,0,SWEET GLOBE,Bag
Agrolatina,24A8024104,01/23/2025,Entry,380.0,1900.0,0,SWEET GLOBE,Bag
Agrolatina,24A8024104,01/30/2025,Sale,-95.0,1805.0,7,SWEET GLOBE,Bag
Agrolatina,24A8024104,02/11/2025,Sale,-190.0,1615.0,19,SWEET GLOBE,Bag
Agrolatina,24A8024104,02/11/2025,Sale,-1140.0,475.0,19,SWEET GLOBE,Bag
Agrolatina,24A8024104,02/17/2025,Sale,-95.0,380.0,25,SWEET GLOBE,Bag
Agrolatina,24A8024104,02/28/2025,Sale,-90.0,290.0,36,SWEET GLOBE,Bag
Agrolatina,24A8024104,03/10/2025,Sale,-25.0,265.0,46,SWEET GLOBE,Bag
Agrolatina,24A8024104,03/11/2025,Sale,-234.0,31.0,47,SWEET GLOBE,Bag
Agrolatina,24A8024254,01/20/2025,Entry,160.0,160.0,0,AUTUMN CRISP,Clam
Agrolatina,24A8024254,01/20/2025,Entry,880.0,1040.0,0,AUTUMN CRISP,Clam
Agrolatina,24A8024254,01/20/2025,Entry,560.0,1600.0,0,AUTUMN CRISP,Clam
Agrolatina,24A8024254,02/01/2025,Sale,-880.0,720.0,12,AUTUMN CRISP,Clam
Agrolatina,24A8024254,02/05/2025,Sale,-160.0,560.0,16,AUTUMN CRISP,Clam
Agrolatina,24A8024254,02/12/2025,Sale,-560.0,0.0,23,AUTUMN CRISP,Clam
Agrolatina,24A8024491,01/13/2025,Entry,1520.0,1520.0,0,SWEET GLOBE,Clam
Agrolatina,24A8024491,01/13/2025,Entry,80.0,1600.0,0,SWEET GLOBE,Clam
Agrolatina,24A8024491,01/17/2025,Sale,-80.0,1520.0,4,SWEET GLOBE,Clam
Agrolatina,24A8024491,01/18/2025,Sale,-240.0,1280.0,5,SWEET GLOBE,Clam
Agrolatina,24A8024491,01/18/2025,Sale,-80.0,1200.0,5,SWEET GLOBE,Clam
Agrolatina,24A8024491,01/19/2025,Sale,-80.0,1120.0,6,SWEET GLOBE,Clam
Agrolatina,24A8024491,01/20/2025,Sale,-480.0,640.0,7,SWEET GLOBE,Clam
Agrolatina,24A8024491,01/22/2025,Sale,-640.0,0.0,9,SWEET GLOBE,Clam
Agrolatina,24A8024510,01/23/2025,Entry,240.0,240.0,0,SWEET GLOBE,Clam
Agrolatina,24A8024510,01/23/2025,Entry,1360.0,1600.0,0,SWEET GLOBE,Clam
Agrolatina,24A8024510,01/28/2025,Sale,-160.0,1440.0,5,SWEET GLOBE,Clam
Agrolatina,24A8024510,01/28/2025,Sale,-960.0,480.0,5,SWEET GLOBE,Clam
Agrolatina,24A8024510,01/28/2025,Sale,-160.0,320.0,5,SWEET GLOBE,Clam
Agrolatina,24A8024510,01/29/2025,Sale,-80.0,240.0,6,SWEET GLOBE,Clam
Agrolatina,24A8024510,01/29/2025,Sale,-240.0,0.0,6,SWEET GLOBE,Clam
Agrolatina,24A8024526,01/23/2025,Entry,960.0,960.0,0,ALLISON,Clam
Agrolatina,24A8024526,01/23/2025,Entry,640.0,1600.0,0,ALLISON,Clam
Agrolatina,24A8024526,02/11/2025,Sale,-240.0,1360.0,19,ALLISON,Clam
Agrolatina,24A8024526,02/12/2025,Sale,-960.0,400.0,20,ALLISON,Clam
Agrolatina,24A8024526,02/18/2025,Sale,-240.0,160.0,26,ALLISON,Clam
Agrolatina,24A8024526,02/27/2025,Sale,-160.0,0.0,35,ALLISON,Clam
Agrolatina,24A8024634,01/23/2025,Entry,1040.0,1040.0,0,AUTUMN CRISP,Clam
Agrolatina,24A8024634,01/23/2025,Entry,560.0,1600.0,0,AUTUMN CRISP,Clam
Agrolatina,24A8024634,02/01/2025,Sale,-320.0,1280.0,9,AUTUMN CRISP,Clam
Agrolatina,24A8024634,02/11/2025,Sale,-240.0,1040.0,19,AUTUMN CRISP,Clam
Agrolatina,24A8024634,02/12/2025,Sale,-320.0,720.0,20,AUTUMN CRISP,Clam
Agrolatina,24A8024634,02/21/2025,Sale,-480.0,240.0,29,AUTUMN CRISP,Clam
Agrolatina,24A8024634,02/21/2025,Sale,-240.0,0.0,29,AUTUMN CRISP,Clam
Agrolatina,24A8024790,04/14/2025,Entry,960.0,960.0,0,SWEET GLOBE,Clam
Agrolatina,24A8024790,04/14/2025,Entry,640.0,1600.0,0,SWEET GLOBE,Clam
Agrolatina,24A8024790,04/28/2025,Sale,-640.0,960.0,14,SWEET GLOBE,Clam
Agrolatina,24A8024790,04/29/2025,Sale,-240.0,720.0,15,SWEET GLOBE,Clam
Agrolatina,24A8024790,04/30/2025,Sale,-720.0,0.0,16,SWEET GLOBE,Clam
Agrolatina,24A8024803,03/03/2025,Entry,960.0,960.0,0,SWEET GLOBE,Clam
Agrolatina,24A8024803,03/03/2025,Entry,640.0,1600.0,0,SWEET GLOBE,Clam
Agrolatina,24A8024803,04/02/2025,Sale,-960.0,640.0,30,SWEET GLOBE,Clam
Agrolatina,24A8024803,04/02/2025,Sale,-160.0,480.0,30,SWEET GLOBE,Clam
Agrolatina,24A8024803,04/03/2025,Sale,-320.0,160.0,31,SWEET GLOBE,Clam
Agrolatina,24A8030470,03/13/2025,Entry,1360.0,1360.0,0,TIMCO,Clam
Agrolatina,24A8030470,03/13/2025,Entry,240.0,1600.0,0,TIMCO,Clam
Agrolatina,24A8030470,03/24/2025,Sale,-80.0,1520.0,11,TIMCO,Clam
Agrolatina,24A8030470,03/26/2025,Sale,-240.0,1280.0,13,TIMCO,Clam
Agrolatina,24A8030470,03/27/2025,Sale,-320.0,960.0,14,TIMCO,Clam
Agrolatina,24A8030470,03/28/2025,Sale,-80.0,880.0,15,TIMCO,Clam
Agrolatina,24A8030470,03/31/2025,Sale,-240.0,640.0,18,TIMCO,Clam
Agrolatina,24A8030470,04/01/2025,Sale,-160.0,480.0,19,TIMCO,Clam
Agrolatina,24A8030470,04/02/2025,Sale,-160.0,320.0,20,TIMCO,Clam
Agrolatina,24A8030470,04/02/2025,Sale,-80.0,240.0,20,TIMCO,Clam
Agrolatina,24A8030470,04/05/2025,Sale,-160.0,80.0,23,TIMCO,Clam
Agrolatina,24A8030470,04/10/2025,Sale,-80.0,0.0,28,TIMCO,Clam
Agrolatina,24A8033782,01/16/2025,Entry,1520.0,1520.0,0,CANDY SNAP,Clam
Agrolatina,24A8033782,01/16/2025,Entry,80.0,1600.0,0,CANDY SNAP,Clam
Agrolatina,24A8033782,02/03/2025,Sale,-80.0,1520.0,18,CANDY SNAP,Clam
Agrolatina,24A8033782,02/10/2025,Sale,-319.0,1201.0,25,CANDY SNAP,Clam
Agrolatina,24A8033782,02/17/2025,Sale,-1200.0,1.0,32,CANDY SNAP,Clam
Agrolatina,24A8034259,03/03/2025,Entry,1615.0,1615.0,0,TIMCO,Clam
Agrolatina,24A8034259,03/03/2025,Entry,85.0,1700.0,0,TIMCO,Clam
Agrolatina,24A8034259,03/19/2025,Sale,-1190.0,510.0,16,TIMCO,Clam
Agrolatina,24A8034259,04/09/2025,Sale,-270.0,240.0,37,TIMCO,Bag
Agrolatina,24A8034259,04/14/2025,Sale,-60.0,180.0,42,TIMCO,Bag
Agrolatina,24A8034670,02/03/2025,Entry,720.0,720.0,0,CANDY DREAMS,Clam
Agrolatina,24A8034670,02/03/2025,Entry,880.0,1600.0,0,CANDY DREAMS,Clam
Agrolatina,24A8034670,02/08/2025,Sale,-40.0,1560.0,5,CANDY DREAMS,Clam
Agrolatina,24A8034670,02/08/2025,Sale,-80.0,1480.0,5,CANDY DREAMS,Clam
Agrolatina,24A8034670,02/10/2025,Sale,-80.0,1400.0,7,CANDY DREAMS,Clam
Agrolatina,24A8034670,02/10/2025,Sale,-320.0,1080.0,7,CANDY DREAMS,Clam
Agrolatina,24A8034670,02/11/2025,Sale,-80.0,1000.0,8,CANDY DREAMS,Clam
Agrolatina,24A8034670,02/11/2025,Sale,-80.0,920.0,8,CANDY DREAMS,Clam
Agrolatina,24A8034670,02/13/2025,Sale,-80.0,840.0,10,CANDY DREAMS,Clam
Agrolatina,24A8034670,02/17/2025,Sale,-160.0,680.0,14,CANDY DREAMS,Clam
Agrolatina,24A8034670,02/18/2025,Sale,-22.0,658.0,15,CANDY DREAMS,Clam
Agrolatina,24A8034670,02/18/2025,Sale,-80.0,578.0,15,CANDY DREAMS,Clam
Agrolatina,24A8034670,02/18/2025,Sale,-80.0,498.0,15,CANDY DREAMS,Clam
Agrolatina,24A8034670,02/20/2025,Sale,-240.0,258.0,17,CANDY DREAMS,Clam
Agrolatina,24A8034670,02/20/2025,Sale,-160.0,98.0,17,CANDY DREAMS,Clam
Agrolatina,24A8034670,02/25/2025,Sale,-10.0,88.0,22,CANDY DREAMS,Clam
Agrolatina,24A8034670,02/25/2025,Sale,-10.0,78.0,22,CANDY DREAMS,Clam
Agrolatina,24A8034670,02/25/2025,Sale,-50.0,28.0,22,CANDY DREAMS,Clam
Agrolatina,24A8034670,02/25/2025,Sale,-10.0,18.0,22,CANDY DREAMS,Clam
Agrolatina,24A8035297,02/03/2025,Entry,640.0,640.0,0,SWEET GLOBE,Clam
Agrolatina,24A8035297,02/03/2025,Entry,960.0,1600.0,0,SWEET GLOBE,Clam
Agrolatina,24A8035297,02/08/2025,Sale,-80.0,1520.0,5,SWEET GLOBE,Clam
Agrolatina,24A8035297,02/08/2025,Sale,-80.0,1440.0,5,SWEET GLOBE,Clam
Agrolatina,24A8035297,02/08/2025,Sale,-80.0,1360.0,5,SWEET GLOBE,Clam
Agrolatina,24A8035297,02/13/2025,Sale,-80.0,1280.0,10,SWEET GLOBE,Clam
Agrolatina,24A8035297,02/14/2025,Sale,-80.0,1200.0,11,SWEET GLOBE,Clam
Agrolatina,24A8035297,02/15/2025,Sale,-80.0,1120.0,12,SWEET GLOBE,Clam
Agrolatina,24A8035297,02/17/2025,Sale,-80.0,1040.0,14,SWEET GLOBE,Clam
Agrolatina,24A8035297,02/17/2025,Sale,-160.0,880.0,14,SWEET GLOBE,Clam
Agrolatina,24A8035297,02/18/2025,Sale,-80.0,800.0,15,SWEET GLOBE,Clam
Agrolatina,24A8035297,02/28/2025,Sale,-10.0,790.0,25,SWEET GLOBE,Clam
Agrolatina,24A8035297,02/28/2025,Sale,-40.0,750.0,25,SWEET GLOBE,Clam
Agrolatina,24A8035297,02/28/2025,Sale,-25.0,725.0,25,SWEET GLOBE,Clam
Agrolatina,24A8035297,03/01/2025,Sale,-60.0,665.0,26,SWEET GLOBE,Clam
Agrolatina,24A8035297,03/03/2025,Sale,-20.0,645.0,28,SWEET GLOBE,Clam
Agrolatina,24A8035297,03/05/2025,Sale,-200.0,445.0,30,SWEET GLOBE,Clam
Agrolatina,24A8035297,03/05/2025,Sale,-80.0,365.0,30,SWEET GLOBE,Clam
Agrolatina,24A8039440,02/03/2025,Entry,570.0,570.0,0,SWEET FAVORS,Bag
Agrolatina,24A8039440,02/03/2025,Entry,190.0,760.0,0,SWEET FAVORS,Bag
Agrolatina,24A8039440,02/03/2025,Entry,665.0,1425.0,0,SWEET GLOBE,Bag
Agrolatina,24A8039440,02/03/2025,Entry,475.0,1900.0,0,SWEET GLOBE,Bag
Agrolatina,24A8039440,02/07/2025,Sale,-285.0,1615.0,4,SWEET FAVORS,Bag
Agrolatina,24A8039440,02/07/2025,Sale,-95.0,1520.0,4,SWEET GLOBE,Bag
Agrolatina,24A8039440,03/01/2025,Sale,-95.0,1425.0,26,SWEET GLOBE,Bag
Agrolatina,24A8039440,03/01/2025,Sale,-190.0,1235.0,26,SWEET GLOBE,Bag
Agrolatina,24A8039440,03/04/2025,Sale,-190.0,1045.0,29,SWEET FAVORS,Bag
Agrolatina,24A8039440,03/06/2025,Sale,-95.0,950.0,31,SWEET FAVORS,Bag
Agrolatina,24A8039440,03/06/2025,Sale,-95.0,855.0,31,SWEET FAVORS,Bag
Agrolatina,24A8039440,03/06/2025,Sale,-95.0,760.0,31,SWEET FAVORS,Bag
Agrolatina,24A8039440,03/06/2025,Sale,-95.0,665.0,31,SWEET GLOBE,Bag
Agrolatina,24A8039440,03/11/2025,Sale,-45.0,620.0,36,SWEET GLOBE,Bag
Agrolatina,24A8039440,03/11/2025,Sale,-45.0,575.0,36,SWEET GLOBE,Bag
Agrolatina,24A8039440,03/11/2025,Sale,-70.0,505.0,36,SWEET GLOBE,Bag
Agrolatina,24A8039440,03/11/2025,Sale,-190.0,315.0,36,SWEET GLOBE,Bag
Agrolatina,24A8039440,03/12/2025,Sale,-95.0,220.0,37,SWEET GLOBE,Bag
Agrolatina,24A8039440,03/19/2025,Sale,-95.0,125.0,44,SWEET GLOBE,Bag
Agrolatina,24A8039440,03/31/2025,Sale,-5.0,120.0,56,SWEET GLOBE,Bag
Agrolatina,24A8039841,12/07/2024,Entry,1440.0,1440.0,0,ALLISON,Clam
Agrolatina,24A8039841,12/07/2024,Entry,160.0,1600.0,0,ALLISON,Clam
Agrolatina,24A8039841,01/07/2025,Sale,-640.0,960.0,31,ALLISON,Clam
Agrolatina,24A8039841,01/08/2025,Sale,-160.0,800.0,32,ALLISON,Clam
Agrolatina,24A8039841,01/11/2025,Sale,-800.0,0.0,35,ALLISON,Clam
Agrolatina,24A8042495,02/10/2025,Entry,320.0,320.0,0,AUTUMN CRISP,Clam
Agrolatina,24A8042495,02/10/2025,Entry,1280.0,1600.0,0,AUTUMN CRISP,Clam
Agrolatina,24A8042495,03/06/2025,Sale,-320.0,1280.0,24,AUTUMN CRISP,Clam
Agrolatina,24A8042495,03/14/2025,Sale,-320.0,960.0,32,AUTUMN CRISP,Clam
Agrolatina,24A8042495,03/14/2025,Sale,-960.0,0.0,32,AUTUMN CRISP,Clam
Agrolatina,24A8044435,03/04/2025,Entry,1120.0,1120.0,0,IVORY,Clam
Agrolatina,24A8044435,03/04/2025,Entry,480.0,1600.0,0,IVORY,Clam
Agrolatina,24A8044435,03/12/2025,Sale,-80.0,1520.0,8,IVORY,Clam
Agrolatina,24A8044435,03/12/2025,Sale,-400.0,1120.0,8,IVORY,Clam
Agrolatina,24A8044435,03/15/2025,Sale,-320.0,800.0,11,IVORY,Clam
Agrolatina,24A8044435,03/15/2025,Sale,-80.0,720.0,11,IVORY,Clam
Agrolatina,24A8044435,03/22/2025,Sale,-80.0,640.0,18,IVORY,Clam
Agrolatina,24A8044435,03/22/2025,Sale,-60.0,580.0,18,IVORY,Clam
Agrolatina,24A8044435,03/24/2025,Sale,-160.0,420.0,20,IVORY,Clam
Agrolatina,24A8044435,03/25/2025,Sale,-160.0,260.0,21,IVORY,Clam
Agrolatina,24A8044435,03/29/2025,Sale,-80.0,180.0,25,IVORY,Clam
Agrolatina,24A8044435,03/29/2025,Sale,-40.0,140.0,25,IVORY,Clam
Agrolatina,24A8045283,02/17/2025,Entry,800.0,800.0,0,SWEET GLOBE,Clam
Agrolatina,24A8045283,02/17/2025,Entry,800.0,1600.0,0,SWEET GLOBE,Clam
Agrolatina,24A8045283,02/27/2025,Sale,-320.0,1280.0,10,SWEET GLOBE,Clam
Agrolatina,24A8045283,02/28/2025,Sale,-80.0,1200.0,11,SWEET GLOBE,Clam
Agrolatina,24A8045283,02/28/2025,Sale,-80.0,1120.0,11,SWEET GLOBE,Clam
Agrolatina,24A8045283,03/03/2025,Sale,-80.0,1040.0,14,SWEET GLOBE,Clam
Agrolatina,24A8045283,03/03/2025,Sale,-80.0,960.0,14,SWEET GLOBE,Clam
Agrolatina,24A8045283,03/04/2025,Sale,-40.0,920.0,15,SWEET GLOBE,Clam
Agrolatina,24A8045283,03/06/2025,Sale,-160.0,760.0,17,SWEET GLOBE,Clam
Agrolatina,24A8045283,03/06/2025,Sale,-480.0,280.0,17,SWEET GLOBE,Clam
Agrolatina,24A8051753,02/17/2025,Entry,1200.0,1200.0,0,SWEET GLOBE,Clam
Agrolatina,24A8051753,02/17/2025,Entry,400.0,1600.0,0,SWEET GLOBE,Clam
Agrolatina,24A8051753,03/10/2025,Sale,-40.0,1560.0,21,SWEET GLOBE,Clam
Agrolatina,24A8051753,03/11/2025,Sale,-574.0,986.0,22,SWEET GLOBE,Clam
Agrolatina,24A8051753,03/11/2025,Sale,-160.0,826.0,22,SWEET GLOBE,Clam
Agrolatina,24A8051753,03/11/2025,Sale,-80.0,746.0,22,SWEET GLOBE,Clam
Agrolatina,24A8051753,03/11/2025,Sale,-120.0,626.0,22,SWEET GLOBE,Clam
Agrolatina,24A8051753,03/13/2025,Sale,-60.0,566.0,24,SWEET GLOBE,Clam
Agrolatina,24A8051753,03/13/2025,Sale,-100.0,466.0,24,SWEET GLOBE,Clam
Agrolatina,24A8051753,03/14/2025,Sale,-120.0,346.0,25,SWEET GLOBE,Clam
Agrolatina,24A8052992,02/06/2025,Entry,480.0,480.0,0,SWEET GLOBE,Clam
Agrolatina,24A8052992,02/06/2025,Entry,1120.0,1600.0,0,SWEET GLOBE,Clam
Agrolatina,24A8052992,02/08/2025,Sale,-80.0,1520.0,2,SWEET GLOBE,Clam
Agrolatina,24A8052992,02/10/2025,Sale,-80.0,1440.0,4,SWEET GLOBE,Clam
Agrolatina,24A8052992,02/11/2025,Sale,-160.0,1280.0,5,SWEET GLOBE,Clam
Agrolatina,24A8052992,02/12/2025,Sale,-80.0,1200.0,6,SWEET GLOBE,Clam
Agrolatina,24A8052992,02/17/2025,Sale,-80.0,1120.0,11,SWEET GLOBE,Clam
Agrolatina,24A8052992,02/18/2025,Sale,-160.0,960.0,12,SWEET GLOBE,Clam
Agrolatina,24A8052992,02/18/2025,Sale,-240.0,720.0,12,SWEET GLOBE,Clam
Agrolatina,24A8052992,02/18/2025,Sale,-400.0,320.0,12,SWEET GLOBE,Clam
Agrolatina,24A8052992,02/28/2025,Sale,-50.0,270.0,22,SWEET GLOBE,Clam
Agrolatina,24A8052992,03/01/2025,Sale,-80.0,190.0,23,SWEET GLOBE,Clam
Agrolatina,24A8052992,03/05/2025,Sale,-40.0,150.0,27,SWEET GLOBE,Clam
Agrolatina,24A8056539,03/07/2025,Entry,1120.0,1120.0,0,COTTON CANDY,Clam
Agrolatina,24A8056539,03/07/2025,Entry,480.0,1600.0,0,COTTON CANDY,Clam
Agrolatina,24A8056539,04/01/2025,Sale,-160.0,1440.0,25,COTTON CANDY,Clam
Agrolatina,24A8056539,04/03/2025,Sale,-400.0,1040.0,27,COTTON CANDY,Clam
Agrolatina,24A8056539,04/03/2025,Sale,-320.0,720.0,27,COTTON CANDY,Clam
Agrolatina,24A8056539,04/04/2025,Sale,-720.0,0.0,28,COTTON CANDY,Clam
Agrolatina,24A8057561,02/04/2025,Entry,80.0,80.0,0,CANDY DREAMS,Bag
Agrolatina,24A8057561,02/04/2025,Entry,320.0,400.0,0,CANDY DREAMS,Bag
Agrolatina,24A8057561,02/04/2025,Entry,285.0,685.0,0,SWEET FAVORS,Bag
Agrolatina,24A8057561,02/04/2025,Entry,95.0,780.0,0,SWEET FAVORS,Bag
Agrolatina,24A8057561,02/04/2025,Entry,160.0,940.0,0,SWEET GLOBE,Bag
Agrolatina,24A8057561,02/04/2025,Entry,720.0,1660.0,0,TIMCO,Bag
Agrolatina,24A8057561,02/12/2025,Sale,-285.0,1375.0,8,SWEET FAVORS,Bag
Agrolatina,24A8057561,02/12/2025,Sale,-95.0,1280.0,8,SWEET FAVORS,Bag
Agrolatina,24A8057561,02/14/2025,Sale,-80.0,1200.0,10,SWEET GLOBE,Clam
Agrolatina,24A8057561,02/21/2025,Sale,-80.0,1120.0,17,SWEET GLOBE,Clam
Agrolatina,24A8057561,03/01/2025,Sale,-720.0,400.0,25,TIMCO,Clam
Agrolatina,24A8057561,03/06/2025,Sale,-47.0,353.0,30,CANDY DREAMS,Clam
Agrolatina,24A8057561,03/11/2025,Sale,-6.0,347.0,35,CANDY DREAMS,Clam
Agrolatina,24A8057561,03/17/2025,Sale,-26.0,321.0,41,CANDY DREAMS,Clam
Agrolatina,24A8057561,03/17/2025,Sale,-55.0,266.0,41,CANDY DREAMS,Clam
Agrolatina,24A8057561,03/25/2025,Sale,-40.0,226.0,49,CANDY DREAMS,Clam
Agrolatina,24A8057561,03/26/2025,Sale,-186.0,40.0,50,CANDY DREAMS,Clam
Agrolatina,24A8059374,03/04/2025,Entry,1105.0,1105.0,0,ALLISON,Bag
Agrolatina,24A8059374,03/04/2025,Entry,595.0,1700.0,0,ALLISON,Bag
Agrolatina,24A8059374,04/04/2025,Sale,-90.0,1610.0,31,ALLISON,Bag
Agrolatina,24A8059374,04/05/2025,Sale,-270.0,1340.0,32,ALLISON,Bag
Agrolatina,24A8059374,04/07/2025,Sale,-675.0,665.0,34,ALLISON,Bag
Agrolatina,24A8059374,04/08/2025,Sale,-180.0,485.0,35,ALLISON,Bag
Agrolatina,24A8059374,04/12/2025,Sale,-265.0,220.0,39,ALLISON,Bag
Agrolatina,24A8059374,04/19/2025,Sale,-90.0,130.0,46,ALLISON,Bag
Agrolatina,24A8069887,01/13/2025,Entry,1280.0,1280.0,0,SWEET GLOBE,Clam
Agrolatina,24A8069887,01/13/2025,Entry,240.0,1520.0,0,SWEET GLOBE,Clam
Agrolatina,24A8069887,01/13/2025,Entry,80.0,1600.0,0,SWEET GLOBE,Clam
Agrolatina,24A8069887,01/27/2025,Sale,-9.0,1591.0,14,SWEET GLOBE,Clam
Agrolatina,24A8069887,01/28/2025,Sale,-160.0,1431.0,15,SWEET GLOBE,Clam
Agrolatina,24A8069887,01/28/2025,Sale,-240.0,1191.0,15,SWEET GLOBE,Clam
Agrolatina,24A8069887,01/28/2025,Sale,-240.0,951.0,15,SWEET GLOBE,Clam
Agrolatina,24A8069887,01/28/2025,Sale,-80.0,871.0,15,SWEET GLOBE,Clam
Agrolatina,24A8069887,01/29/2025,Sale,-240.0,631.0,16,SWEET GLOBE,Clam
Agrolatina,24A8069887,01/30/2025,Sale,-560.0,71.0,17,SWEET GLOBE,Clam
Agrolatina,24A8069887,02/10/2025,Sale,-71.0,0.0,28,SWEET GLOBE,Clam
Agrolatina,24A8070424,01/03/2025,Entry,1040.0,1040.0,0,SWEET GLOBE,Clam
Agrolatina,24A8070424,01/03/2025,Entry,80.0,1120.0,0,SWEET GLOBE,Clam
Agrolatina,24A8070424,01/03/2025,Entry,480.0,1600.0,0,SWEET GLOBE,Clam
Agrolatina,24A8070424,01/15/2025,Sale,-320.0,1280.0,12,SWEET GLOBE,Clam
Agrolatina,24A8070424,01/16/2025,Sale,-80.0,1200.0,13,SWEET GLOBE,Clam
Agrolatina,24A8070424,01/16/2025,Sale,-960.0,240.0,13,SWEET GLOBE,Clam
Agrolatina,24A8070424,01/21/2025,Sale,-80.0,160.0,18,SWEET GLOBE,Clam
Agrolatina,24A8070424,01/21/2025,Sale,-80.0,80.0,18,SWEET GLOBE,Clam
Agrolatina,24A8070424,02/12/2025,Sale,-80.0,0.0,40,SWEET GLOBE,Clam
Agrolatina,24A8070810,01/13/2025,Entry,1200.0,1200.0,0,ALLISON,Clam
Agrolatina,24A8070810,01/13/2025,Entry,400.0,1600.0,0,ALLISON,Clam
Agrolatina,24A8070810,01/18/2025,Sale,-960.0,640.0,5,ALLISON,Clam
Agrolatina,24A8070810,01/21/2025,Sale,-80.0,560.0,8,ALLISON,Clam
Agrolatina,24A8070810,01/29/2025,Sale,-240.0,320.0,16,ALLISON,Clam
Agrolatina,24A8070810,02/05/2025,Sale,-80.0,240.0,23,ALLISON,Clam
Agrolatina,24A8070810,02/05/2025,Sale,-80.0,160.0,23,ALLISON,Clam
Agrolatina,24A8070810,02/05/2025,Sale,-80.0,80.0,23,ALLISON,Clam
Agrolatina,24A8070810,02/06/2025,Sale,-80.0,0.0,24,ALLISON,Clam
Agrolatina,24A8085110,01/19/2025,Entry,1280.0,1280.0,0,ALLISON,Clam
Agrolatina,24A8085110,01/19/2025,Entry,320.0,1600.0,0,ALLISON,Clam
Agrolatina,24A8085110,02/21/2025,Sale,-80.0,1520.0,33,ALLISON,Clam
Agrolatina,24A8085110,02/25/2025,Sale,-80.0,1440.0,37,ALLISON,Clam
Agrolatina,24A8085110,03/04/2025,Sale,-80.0,1360.0,44,ALLISON,Clam
Agrolatina,24A8085110,03/04/2025,Sale,-160.0,1200.0,44,ALLISON,Clam
Agrolatina,24A8085110,03/06/2025,Sale,-80.0,1120.0,46,ALLISON,Clam
Agrolatina,24A8085110,03/07/2025,Sale,-560.0,560.0,47,ALLISON,Clam
Agrolatina,24A8085110,03/07/2025,Sale,-80.0,480.0,47,ALLISON,Clam
Agrolatina,24A8085110,03/07/2025,Sale,-160.0,320.0,47,ALLISON,Clam
Agrolatina,24A8085110,03/08/2025,Sale,-320.0,0.0,48,ALLISON,Clam
Agrolatina,24A8086077,02/06/2025,Entry,800.0,800.0,0,SWEET GLOBE,Clam
Agrolatina,24A8086077,02/06/2025,Entry,800.0,1600.0,0,SWEET GLOBE,Clam
Agrolatina,24A8086077,02/10/2025,Sale,-160.0,1440.0,4,SWEET GLOBE,Clam
Agrolatina,24A8086077,02/10/2025,Sale,-160.0,1280.0,4,SWEET GLOBE,Clam
Agrolatina,24A8086077,02/11/2025,Sale,-80.0,1200.0,5,SWEET GLOBE,Clam
Agrolatina,24A8086077,02/11/2025,Sale,-320.0,880.0,5,SWEET GLOBE,Clam
Agrolatina,24A8086077,02/17/2025,Sale,-80.0,800.0,11,SWEET GLOBE,Clam
Agrolatina,24A8086077,02/18/2025,Sale,-80.0,720.0,12,SWEET GLOBE,Clam
Agrolatina,24A8086077,02/18/2025,Sale,-80.0,640.0,12,SWEET GLOBE,Clam
Agrolatina,24A8086077,02/28/2025,Sale,-79.0,561.0,22,SWEET GLOBE,Clam
Agrolatina,24A8086077,03/01/2025,Sale,-200.0,361.0,23,SWEET GLOBE,Clam
Agrolatina,24A8086077,03/03/2025,Sale,-80.0,281.0,25,SWEET GLOBE,Clam
Agrolatina,24A8086077,03/05/2025,Sale,-50.0,231.0,27,SWEET GLOBE,Clam
Agrolatina,24A8092260,01/09/2025,Entry,1040.0,1040.0,0,SWEET GLOBE,Clam
Agrolatina,24A8092260,01/09/2025,Entry,80.0,1120.0,0,SWEET GLOBE,Clam
Agrolatina,24A8092260,01/09/2025,Entry,480.0,1600.0,0,SWEET GLOBE,Clam
Agrolatina,24A8092260,01/17/2025,Sale,-80.0,1520.0,8,SWEET GLOBE,Clam
Agrolatina,24A8092260,01/17/2025,Sale,-80.0,1440.0,8,SWEET GLOBE,Clam
Agrolatina,24A8092260,01/17/2025,Sale,-800.0,640.0,8,SWEET GLOBE,Clam
Agrolatina,24A8092260,01/17/2025,Sale,-160.0,480.0,8,SWEET GLOBE,Clam
Agrolatina,24A8092260,01/20/2025,Sale,-80.0,400.0,11,SWEET GLOBE,Clam
Agrolatina,24A8092260,01/21/2025,Sale,-80.0,320.0,12,SWEET GLOBE,Clam
Agrolatina,24A8092260,01/21/2025,Sale,-80.0,240.0,12,SWEET GLOBE,Clam
Agrolatina,24A8092260,01/21/2025,Sale,-240.0,0.0,12,SWEET GLOBE,Clam
Agrolatina,24A8092315,02/17/2025,Entry,1200.0,1200.0,0,IVORY,Clam
Agrolatina,24A8092315,02/17/2025,Entry,320.0,1520.0,0,IVORY,Clam
Agrolatina,24A8092315,02/17/2025,Entry,80.0,1600.0,0,IVORY,Clam
Agrolatina,24A8092315,02/25/2025,Sale,-80.0,1520.0,8,IVORY,Clam
Agrolatina,24A8092315,02/25/2025,Sale,-480.0,1040.0,8,IVORY,Clam
Agrolatina,24A8092315,02/25/2025,Sale,-80.0,960.0,8,IVORY,Clam
Agrolatina,24A8092315,02/26/2025,Sale,-80.0,880.0,9,IVORY,Clam
Agrolatina,24A8092315,02/26/2025,Sale,-80.0,800.0,9,IVORY,Clam
Agrolatina,24A8092315,02/26/2025,Sale,-400.0,400.0,9,IVORY,Clam
Agrolatina,24A8092315,03/19/2025,Sale,-40.0,360.0,30,IVORY,Clam
Agrolatina,24A8092315,03/28/2025,Sale,-80.0,280.0,39,IVORY,Clam
Agrolatina,24A8092315,03/29/2025,Sale,-40.0,240.0,40,IVORY,Clam
Agrolatina,24A8092315,03/29/2025,Sale,-40.0,200.0,40,IVORY,Clam
Agrolatina,24A8092315,03/29/2025,Sale,-40.0,160.0,40,IVORY,Clam
Agrolatina,24A8094956,03/07/2025,Entry,400.0,400.0,0,AUTUMN CRISP,Clam
Agrolatina,24A8094956,03/07/2025,Entry,1200.0,1600.0,0,AUTUMN CRISP,Clam
Agrolatina,24A8094956,03/26/2025,Sale,-240.0,1360.0,19,AUTUMN CRISP,Clam
Agrolatina,24A8094956,03/27/2025,Sale,-960.0,400.0,20,AUTUMN CRISP,Clam
Agrolatina,24A8094956,03/31/2025,Sale,-400.0,0.0,24,AUTUMN CRISP,Clam
Agrolatina,24A8099496,01/03/2025,Entry,1440.0,1440.0,0,ALLISON,Clam
Agrolatina,24A8099496,01/03/2025,Entry,160.0,1600.0,0,ALLISON,Clam
Agrolatina,24A8099496,01/22/2025,Sale,-1440.0,160.0,19,ALLISON,Clam
Agrolatina,24A8099496,01/22/2025,Sale,-80.0,80.0,19,ALLISON,Clam
Agrolatina,24A8099496,01/22/2025,Sale,-80.0,0.0,19,ALLISON,Clam
Agrolatina,24A8101530,02/04/2025,Entry,720.0,720.0,0,AUTUMN CRISP,Clam
Agrolatina,24A8101530,02/04/2025,Entry,880.0,1600.0,0,AUTUMN CRISP,Clam
Agrolatina,24A8101530,02/26/2025,Sale,-720.0,880.0,22,AUTUMN CRISP,Clam
Agrolatina,24A8101530,03/03/2025,Sale,-880.0,0.0,27,AUTUMN CRISP,Clam
Agrolatina,24A8104269,01/16/2025,Entry,1280.0,1280.0,0,ALLISON,Clam
Agrolatina,24A8104269,01/16/2025,Entry,320.0,1600.0,0,ALLISON,Clam
Agrolatina,24A8104269,01/31/2025,Sale,-880.0,720.0,15,ALLISON,Clam
Agrolatina,24A8104269,02/01/2025,Sale,-80.0,640.0,16,ALLISON,Clam
Agrolatina,24A8104269,02/04/2025,Sale,-80.0,560.0,19,ALLISON,Clam
Agrolatina,24A8104269,02/04/2025,Sale,-80.0,480.0,19,ALLISON,Clam
Agrolatina,24A8104269,02/05/2025,Sale,-160.0,320.0,20,ALLISON,Clam
Agrolatina,24A8104269,02/05/2025,Sale,-160.0,160.0,20,ALLISON,Clam
Agrolatina,24A8104269,02/06/2025,Sale,-80.0,80.0,21,ALLISON,Clam
Agrolatina,24A8104269,02/07/2025,Sale,-80.0,0.0,22,ALLISON,Clam
Agrolatina,24A8114712,01/27/2025,Entry,1520.0,1520.0,0,ALLISON,Clam
Agrolatina,24A8114712,01/27/2025,Entry,80.0,1600.0,0,ALLISON,Clam
Agrolatina,24A8114712,02/05/2025,Sale,-1520.0,80.0,9,ALLISON,Clam
Agrolatina,24A8114712,02/06/2025,Sale,-80.0,0.0,10,ALLISON,Clam
Agrolatina,24A8115792,03/04/2025,Entry,1280.0,1280.0,0,IVORY,Clam
Agrolatina,24A8115792,03/04/2025,Entry,160.0,1440.0,0,IVORY,Clam
Agrolatina,24A8115792,03/04/2025,Entry,160.0,1600.0,0,IVORY,Clam
Agrolatina,24A8115792,03/15/2025,Sale,-80.0,1520.0,11,IVORY,Clam
Agrolatina,24A8115792,03/22/2025,Sale,-60.0,1460.0,18,IVORY,Clam
Agrolatina,24A8115792,03/22/2025,Sale,-60.0,1400.0,18,IVORY,Clam
Agrolatina,24A8115792,03/22/2025,Sale,-40.0,1360.0,18,IVORY,Clam
Agrolatina,24A8115792,03/25/2025,Sale,-80.0,1280.0,21,IVORY,Clam
Agrolatina,24A8115792,03/28/2025,Sale,-40.0,1240.0,24,IVORY,Clam
Agrolatina,24A8115792,03/29/2025,Sale,-80.0,1160.0,25,IVORY,Clam
Agrolatina,24A8115792,03/29/2025,Sale,-120.0,1040.0,25,IVORY,Clam
Agrolatina,24A8115792,03/29/2025,Sale,-40.0,1000.0,25,IVORY,Clam
Agrolatina,24A8115792,04/02/2025,Sale,-160.0,840.0,29,IVORY,Clam
Agrolatina,24A8115792,04/02/2025,Sale,-120.0,720.0,29,IVORY,Clam
Agrolatina,24A8115792,04/02/2025,Sale,-80.0,640.0,29,IVORY,Clam
Agrolatina,24A8115792,04/03/2025,Sale,-80.0,560.0,30,IVORY,Clam
Agrolatina,24A8115792,04/05/2025,Sale,-80.0,480.0,32,IVORY,Clam
Agrolatina,24A8116439,03/10/2025,Entry,80.0,80.0,0,AUTUMN CRISP,Clam
Agrolatina,24A8116439,03/10/2025,Entry,1520.0,1600.0,0,AUTUMN CRISP,Clam
Agrolatina,24A8116439,03/17/2025,Sale,-960.0,640.0,7,AUTUMN CRISP,Clam
Agrolatina,24A8116439,03/19/2025,Sale,-80.0,560.0,9,AUTUMN CRISP,Clam
Agrolatina,24A8116439,03/19/2025,Sale,-80.0,480.0,9,AUTUMN CRISP,Clam
Agrolatina,24A8116439,03/19/2025,Sale,-80.0,400.0,9,AUTUMN CRISP,Clam
Agrolatina,24A8116439,03/19/2025,Sale,-400.0,0.0,9,AUTUMN CRISP,Clam
Agrolatina,24A8120736,01/30/2025,Entry,1360.0,1360.0,0,SWEET GLOBE,Clam
Agrolatina,24A8120736,01/30/2025,Entry,240.0,1600.0,0,SWEET GLOBE,Clam
Agrolatina,24A8120736,02/08/2025,Sale,-80.0,1520.0,9,SWEET GLOBE,Clam
Agrolatina,24A8120736,02/08/2025,Sale,-560.0,960.0,9,SWEET GLOBE,Clam
Agrolatina,24A8120736,02/10/2025,Sale,-80.0,880.0,11,SWEET GLOBE,Clam
Agrolatina,24A8120736,02/10/2025,Sale,-80.0,800.0,11,SWEET GLOBE,Clam
Agrolatina,24A8120736,02/11/2025,Sale,-400.0,400.0,12,SWEET GLOBE,Clam
Agrolatina,24A8120736,02/18/2025,Sale,-160.0,240.0,19,SWEET GLOBE,Clam
Agrolatina,24A8120736,02/25/2025,Sale,-120.0,120.0,26,SWEET GLOBE,Clam
Agrolatina,24A8120736,03/06/2025,Sale,-40.0,80.0,35,SWEET GLOBE,Clam
Agrolatina,24A8123479,02/17/2025,Entry,720.0,720.0,0,SWEET GLOBE,Clam
Agrolatina,24A8123479,02/17/2025,Entry,880.0,1600.0,0,SWEET GLOBE,Clam
Agrolatina,24A8123479,03/01/2025,Sale,-80.0,1520.0,12,SWEET GLOBE,Clam
Agrolatina,24A8123479,03/01/2025,Sale,-640.0,880.0,12,SWEET GLOBE,Clam
Agrolatina,24A8123479,03/01/2025,Sale,-800.0,80.0,12,SWEET GLOBE,Clam
Agrolatina,24A8123479,03/03/2025,Sale,-80.0,0.0,14,SWEET GLOBE,Clam
Agrolatina,24A8123843,01/19/2025,Entry,1360.0,1360.0,0,ALLISON,Clam
Agrolatina,24A8123843,01/19/2025,Entry,240.0,1600.0,0,ALLISON,Clam
Agrolatina,24A8123843,03/01/2025,Sale,-320.0,1280.0,41,ALLISON,Clam
Agrolatina,24A8123843,03/04/2025,Sale,-240.0,1040.0,44,ALLISON,Clam
Agrolatina,24A8123843,03/06/2025,Sale,-720.0,320.0,46,ALLISON,Clam
Agrolatina,24A8123843,03/07/2025,Sale,-80.0,240.0,47,ALLISON,Clam
Agrolatina,24A8123843,03/07/2025,Sale,-80.0,160.0,47,ALLISON,Clam
Agrolatina,24A8123843,03/07/2025,Sale,-80.0,80.0,47,ALLISON,Clam
Agrolatina,24A8123843,03/10/2025,Sale,-80.0,0.0,50,ALLISON,Clam
Agrolatina,24A8131710,02/06/2025,Entry,1200.0,1200.0,0,CANDY DREAMS,Clam
Agrolatina,24A8131710,02/06/2025,Entry,400.0,1600.0,0,CANDY DREAMS,Clam
Agrolatina,24A8131710,02/10/2025,Sale,-560.0,1040.0,4,CANDY DREAMS,Clam
Agrolatina,24A8131710,02/10/2025,Sale,-80.0,960.0,4,CANDY DREAMS,Clam
Agrolatina,24A8131710,02/11/2025,Sale,-160.0,800.0,5,CANDY DREAMS,Clam
Agrolatina,24A8131710,02/11/2025,Sale,-80.0,720.0,5,CANDY DREAMS,Clam
Agrolatina,24A8131710,02/12/2025,Sale,-80.0,640.0,6,CANDY DREAMS,Clam
Agrolatina,24A8131710,02/13/2025,Sale,-240.0,400.0,7,CANDY DREAMS,Clam
Agrolatina,24A8131710,02/17/2025,Sale,-80.0,320.0,11,CANDY DREAMS,Clam
Agrolatina,24A8131710,02/25/2025,Sale,-10.0,310.0,19,CANDY DREAMS,Clam
Agrolatina,24A8131710,02/25/2025,Sale,-190.0,120.0,19,CANDY DREAMS,Clam
Agrolatina,24A8131710,02/25/2025,Sale,-80.0,40.0,19,CANDY DREAMS,Clam
Agrolatina,24A8131710,02/26/2025,Sale,-20.0,20.0,20,CANDY DREAMS,Clam
Agrolatina,24A8132059,02/05/2025,Entry,320.0,320.0,0,CANDY DREAMS,Clam
Agrolatina,24A8132059,02/05/2025,Entry,1280.0,1600.0,0,CANDY DREAMS,Clam
Agrolatina,24A8132059,02/13/2025,Sale,-80.0,1520.0,8,CANDY DREAMS,Clam
Agrolatina,24A8132059,02/18/2025,Sale,-80.0,1440.0,13,CANDY DREAMS,Clam
Agrolatina,24A8132059,02/18/2025,Sale,-160.0,1280.0,13,CANDY DREAMS,Clam
Agrolatina,24A8132059,02/19/2025,Sale,-80.0,1200.0,14,CANDY DREAMS,Clam
Agrolatina,24A8132059,02/20/2025,Sale,-160.0,1040.0,15,CANDY DREAMS,Clam
Agrolatina,24A8132059,02/22/2025,Sale,-80.0,960.0,17,CANDY DREAMS,Clam
Agrolatina,24A8132059,02/22/2025,Sale,-160.0,800.0,17,CANDY DREAMS,Clam
Agrolatina,24A8132059,02/24/2025,Sale,-80.0,720.0,19,CANDY DREAMS,Clam
Agrolatina,24A8132059,02/24/2025,Sale,-160.0,560.0,19,CANDY DREAMS,Clam
Agrolatina,24A8132059,02/24/2025,Sale,-160.0,400.0,19,CANDY DREAMS,Clam
Agrolatina,24A8132059,02/25/2025,Sale,-80.0,320.0,20,CANDY DREAMS,Clam
Agrolatina,24A8132059,02/25/2025,Sale,-40.0,280.0,20,CANDY DREAMS,Clam
Agrolatina,24A8132059,02/26/2025,Sale,-10.0,270.0,21,CANDY DREAMS,Clam
Agrolatina,24A8132059,02/27/2025,Sale,-60.0,210.0,22,CANDY DREAMS,Clam
Agrolatina,24A8132059,03/01/2025,Sale,-60.0,150.0,24,CANDY DREAMS,Clam
Agrolatina,24A8132059,03/04/2025,Sale,-60.0,90.0,27,CANDY DREAMS,Clam
Agrolatina,24A8133245,02/11/2025,Entry,1140.0,1140.0,0,IVORY,Bag
Agrolatina,24A8133245,02/11/2025,Entry,760.0,1900.0,0,IVORY,Bag
Agrolatina,24A8133245,02/27/2025,Sale,-475.0,1425.0,16,IVORY,Bag
Agrolatina,24A8133245,02/27/2025,Sale,-190.0,1235.0,16,IVORY,Bag
Agrolatina,24A8133245,03/05/2025,Sale,-285.0,950.0,22,IVORY,Bag
Agrolatina,24A8133245,03/05/2025,Sale,-285.0,665.0,22,IVORY,Bag
Agrolatina,24A8133245,03/08/2025,Sale,-425.0,240.0,25,IVORY,Bag
Agrolatina,24A8133245,03/11/2025,Sale,-95.0,145.0,28,IVORY,Bag
Agrolatina,24A8133245,03/12/2025,Sale,-96.0,49.0,29,IVORY,Bag
Agrolatina,24A8135167,01/16/2025,Entry,1040.0,1040.0,0,CANDY SNAP,Clam
Agrolatina,24A8135167,01/16/2025,Entry,320.0,1360.0,0,CANDY SNAP,Clam
Agrolatina,24A8135167,01/16/2025,Entry,160.0,1520.0,0,SWEET GLOBE,Clam
Agrolatina,24A8135167,01/16/2025,Entry,80.0,1600.0,0,SWEET GLOBE,Clam
Agrolatina,24A8135167,01/30/2025,Sale,-1040.0,560.0,14,CANDY SNAP,Clam
Agrolatina,24A8135167,01/30/2025,Sale,-160.0,400.0,14,SWEET GLOBE,Clam
Agrolatina,24A8135167,01/31/2025,Sale,-80.0,320.0,15,SWEET GLOBE,Clam
Agrolatina,24A8135167,02/17/2025,Sale,-80.0,240.0,32,CANDY SNAP,Clam
Agrolatina,24A8135167,02/17/2025,Sale,-60.0,180.0,32,CANDY SNAP,Clam
Agrolatina,24A8135167,02/19/2025,Sale,-20.0,160.0,34,CANDY SNAP,Clam
Agrolatina,24A8135167,03/03/2025,Sale,-20.0,140.0,46,CANDY SNAP,Clam
Agrolatina,24A8140878,02/20/2025,Entry,800.0,800.0,0,SWEET GLOBE,Clam
Agrolatina,24A8140878,02/20/2025,Entry,800.0,1600.0,0,SWEET GLOBE,Clam
Agrolatina,24A8140878,02/27/2025,Sale,-120.0,1480.0,7,SWEET GLOBE,Clam
Agrolatina,24A8140878,02/28/2025,Sale,-480.0,1000.0,8,SWEET GLOBE,Clam
Agrolatina,24A8140878,02/28/2025,Sale,-30.0,970.0,8,SWEET GLOBE,Clam
Agrolatina,24A8140878,03/01/2025,Sale,-5.0,965.0,9,SWEET GLOBE,Clam
Agrolatina,24A8140878,03/03/2025,Sale,-160.0,805.0,11,SWEET GLOBE,Clam
Agrolatina,24A8140878,03/06/2025,Sale,-60.0,745.0,14,SWEET GLOBE,Clam
Agrolatina,24A8140878,03/10/2025,Sale,-62.0,683.0,18,SWEET GLOBE,Clam
Agrolatina,24A8140878,03/10/2025,Sale,-80.0,603.0,18,SWEET GLOBE,Clam
Agrolatina,24A8140878,03/11/2025,Sale,-60.0,543.0,19,SWEET GLOBE,Clam
Agrolatina,24A8140878,03/11/2025,Sale,-160.0,383.0,19,SWEET GLOBE,Clam
Agrolatina,24A8140878,03/12/2025,Sale,-120.0,263.0,20,SWEET GLOBE,Clam
Agrolatina,24A8140878,03/17/2025,Sale,-40.0,223.0,25,SWEET GLOBE,Clam
Agrolatina,24A8143773,02/04/2025,Entry,80.0,80.0,0,CANDY DREAMS,Clam
Agrolatina,24A8143773,02/04/2025,Entry,240.0,320.0,0,CANDY DREAMS,Clam
Agrolatina,24A8143773,02/04/2025,Entry,1120.0,1440.0,0,SWEET FAVORS,Clam
Agrolatina,24A8143773,02/04/2025,Entry,160.0,1600.0,0,SWEET FAVORS,Clam
Agrolatina,24A8143773,03/17/2025,Sale,-33.0,1567.0,41,CANDY DREAMS,Clam
Agrolatina,24A8143773,03/17/2025,Sale,-174.0,1393.0,41,CANDY DREAMS,Clam
Agrolatina,24A8143773,03/25/2025,Sale,-34.0,1359.0,49,CANDY DREAMS,Clam
Agrolatina,24A8143773,03/26/2025,Sale,-46.0,1313.0,50,CANDY DREAMS,Clam
Agrolatina,24A8143773,03/27/2025,Sale,-80.0,1233.0,51,SWEET FAVORS,Clam
Agrolatina,24A8143773,04/03/2025,Sale,-1118.0,115.0,58,SWEET FAVORS,Clam
Agrolatina,24A8143773,04/03/2025,Sale,-2.0,113.0,58,SWEET FAVORS,Clam
Agrolatina,24A8143773,04/03/2025,Sale,-80.0,33.0,58,SWEET FAVORS,Clam
Agrolatina,24A8143938,03/03/2025,Entry,1360.0,1360.0,0,TIMCO,Clam
Agrolatina,24A8143938,03/03/2025,Entry,240.0,1600.0,0,TIMCO,Clam
Agrolatina,24A8143938,03/25/2025,Sale,-80.0,1520.0,22,TIMCO,Clam
Agrolatina,24A8143938,03/28/2025,Sale,-720.0,800.0,25,TIMCO,Clam
Agrolatina,24A8143938,03/29/2025,Sale,-80.0,720.0,26,TIMCO,Clam
Agrolatina,24A8143938,04/01/2025,Sale,-80.0,640.0,29,TIMCO,Clam
Agrolatina,24A8143938,04/07/2025,Sale,-560.0,80.0,35,TIMCO,Clam
Agrolatina,24A8143938,04/07/2025,Sale,-80.0,0.0,35,TIMCO,Clam
Agrolatina,24A8145102,01/16/2025,Entry,720.0,720.0,0,SWEET GLOBE,Clam
Agrolatina,24A8145102,01/16/2025,Entry,80.0,800.0,0,SWEET GLOBE,Clam
Agrolatina,24A8145102,01/16/2025,Entry,800.0,1600.0,0,SWEET GLOBE,Clam
Agrolatina,24A8145102,01/31/2025,Sale,-160.0,1440.0,15,SWEET GLOBE,Clam
Agrolatina,24A8145102,02/01/2025,Sale,-240.0,1200.0,16,SWEET GLOBE,Clam
Agrolatina,24A8145102,02/03/2025,Sale,-80.0,1120.0,18,SWEET GLOBE,Clam
Agrolatina,24A8145102,02/03/2025,Sale,-80.0,1040.0,18,SWEET GLOBE,Clam
Agrolatina,24A8145102,02/03/2025,Sale,-160.0,880.0,18,SWEET GLOBE,Clam
Agrolatina,24A8145102,02/03/2025,Sale,-160.0,720.0,18,SWEET GLOBE,Clam
Agrolatina,24A8145102,02/12/2025,Sale,-80.0,640.0,27,SWEET GLOBE,Clam
Agrolatina,24A8145102,02/12/2025,Sale,-320.0,320.0,27,SWEET GLOBE,Clam
Agrolatina,24A8145102,02/13/2025,Sale,-160.0,160.0,28,SWEET GLOBE,Clam
Agrolatina,24A8145102,02/15/2025,Sale,-80.0,80.0,30,SWEET GLOBE,Clam
Agrolatina,24A8145102,03/17/2025,Sale,-70.0,10.0,60,SWEET GLOBE,Clam
Agrolatina,24A8152409,01/17/2025,Sale,-80.0,-80.0,0,ALLISON,Clam
Agrolatina,24A8152409,01/17/2025,Sale,-240.0,-320.0,0,ALLISON,Clam
Agrolatina,24A8152409,01/18/2025,Sale,-320.0,-640.0,1,ALLISON,Clam
Agrolatina,24A8152409,01/18/2025,Sale,-960.0,-1600.0,1,ALLISON,Clam
Agrolatina,24A8152409,01/31/2025,Entry,1360.0,-240.0,14,ALLISON,Clam
Agrolatina,24A8152409,01/31/2025,Entry,240.0,0.0,14,ALLISON,Clam
Agrolatina,24A8152944,02/11/2025,Entry,1275.0,1275.0,0,COTTON CANDY,Bag
Agrolatina,24A8152944,02/11/2025,Entry,425.0,1700.0,0,COTTON CANDY,Bag
Agrolatina,24A8152944,02/15/2025,Sale,-850.0,850.0,4,COTTON CANDY,Bag
Agrolatina,24A8152944,02/20/2025,Sale,-425.0,425.0,9,COTTON CANDY,Bag
Agrolatina,24A8152944,03/04/2025,Sale,-190.0,235.0,21,COTTON CANDY,Bag
Agrolatina,24A8152944,03/05/2025,Sale,-95.0,140.0,22,COTTON CANDY,Bag
Agrolatina,24A8152944,03/08/2025,Sale,-75.0,65.0,25,COTTON CANDY,Bag
Agrolatina,24A8152944,04/03/2025,Sale,-40.0,25.0,51,COTTON CANDY,Bag
Agrolatina,24A8169197,02/06/2025,Entry,560.0,560.0,0,ALLISON,Clam
Agrolatina,24A8169197,02/06/2025,Entry,1040.0,1600.0,0,ALLISON,Clam
Agrolatina,24A8169197,02/14/2025,Sale,-240.0,1360.0,8,ALLISON,Clam
Agrolatina,24A8169197,03/03/2025,Sale,-160.0,1200.0,25,ALLISON,Clam
Agrolatina,24A8169197,03/04/2025,Sale,-480.0,720.0,26,ALLISON,Clam
Agrolatina,24A8169197,03/04/2025,Sale,-80.0,640.0,26,ALLISON,Clam
Agrolatina,24A8169197,03/04/2025,Sale,-80.0,560.0,26,ALLISON,Clam
Agrolatina,24A8169197,03/08/2025,Sale,-80.0,480.0,30,ALLISON,Clam
Agrolatina,24A8169197,03/12/2025,Sale,-80.0,400.0,34,ALLISON,Clam
Agrolatina,24A8169197,03/13/2025,Sale,-240.0,160.0,35,ALLISON,Clam
Agrolatina,24A8172420,03/10/2025,Entry,1440.0,1440.0,0,TIMCO,Clam
Agrolatina,24A8172420,03/10/2025,Entry,160.0,1600.0,0,TIMCO,Clam
Agrolatina,24A8172420,04/09/2025,Sale,-160.0,1440.0,30,TIMCO,Clam
Agrolatina,24A8172420,04/12/2025,Sale,-960.0,480.0,33,TIMCO,Clam
Agrolatina,24A8172420,04/13/2025,Sale,-480.0,0.0,34,TIMCO,Clam
Agrolatina,24A8173134,01/19/2025,Entry,1280.0,1280.0,0,ALLISON,Clam
Agrolatina,24A8173134,01/19/2025,Entry,320.0,1600.0,0,ALLISON,Clam
Agrolatina,24A8173134,02/21/2025,Sale,-80.0,1520.0,33,ALLISON,Clam
Agrolatina,24A8173134,03/01/2025,Sale,-240.0,1280.0,41,ALLISON,Clam
Agrolatina,24A8173134,03/03/2025,Sale,-160.0,1120.0,43,ALLISON,Clam
Agrolatina,24A8173134,03/06/2025,Sale,-400.0,720.0,46,ALLISON,Clam
Agrolatina,24A8173134,03/07/2025,Sale,-80.0,640.0,47,ALLISON,Clam
Agrolatina,24A8173134,03/07/2025,Sale,-240.0,400.0,47,ALLISON,Clam
Agrolatina,24A8173134,03/07/2025,Sale,-240.0,160.0,47,ALLISON,Clam
Agrolatina,24A8173134,03/08/2025,Sale,-80.0,80.0,48,ALLISON,Clam
Agrolatina,24A8173134,03/14/2025,Sale,-40.0,40.0,54,ALLISON,Clam
Agrolatina,24A8173520,03/07/2025,Entry,1200.0,1200.0,0,AUTUMN CRISP,Clam
Agrolatina,24A8173520,03/07/2025,Entry,400.0,1600.0,0,AUTUMN CRISP,Clam
Agrolatina,24A8173520,03/27/2025,Sale,-400.0,1200.0,20,AUTUMN CRISP,Clam
Agrolatina,24A8173520,04/01/2025,Sale,-1200.0,0.0,25,AUTUMN CRISP,Clam
Agrolatina,24A8174378,03/04/2025,Entry,1040.0,1040.0,0,TIMCO,Clam
Agrolatina,24A8174378,03/04/2025,Entry,80.0,1120.0,0,TIMCO,Clam
Agrolatina,24A8174378,03/04/2025,Entry,480.0,1600.0,0,TIMCO,Clam
Agrolatina,24A8174378,03/29/2025,Sale,-480.0,1120.0,25,TIMCO,Clam
Agrolatina,24A8174378,04/16/2025,Sale,-480.0,640.0,43,TIMCO,Clam
Agrolatina,24A8174378,04/16/2025,Sale,-160.0,480.0,43,TIMCO,Clam
Agrolatina,24A8174378,04/20/2025,Sale,-160.0,320.0,47,TIMCO,Clam
Agrolatina,24A8174378,04/21/2025,Sale,-240.0,80.0,48,TIMCO,Clam
Agrolatina,24A8174378,04/22/2025,Sale,-80.0,0.0,49,TIMCO,Clam
Agrolatina,24A8180519,01/19/2025,Entry,1200.0,1200.0,0,IVORY,Clam
Agrolatina,24A8180519,01/19/2025,Entry,320.0,1520.0,0,IVORY,Clam
Agrolatina,24A8180519,01/19/2025,Entry,80.0,1600.0,0,IVORY,Clam
Agrolatina,24A8180519,02/12/2025,Sale,-560.0,1040.0,24,IVORY,Clam
Agrolatina,24A8180519,02/13/2025,Sale,-40.0,1000.0,25,IVORY,Clam
Agrolatina,24A8180519,02/15/2025,Sale,-80.0,920.0,27,IVORY,Clam
Agrolatina,24A8180519,02/15/2025,Sale,-160.0,760.0,27,IVORY,Clam
Agrolatina,24A8180519,02/15/2025,Sale,-80.0,680.0,27,IVORY,Clam
Agrolatina,24A8181984,02/17/2025,Entry,1330.0,1330.0,0,SWEET FAVORS,Bag
Agrolatina,24A8181984,02/17/2025,Entry,380.0,1710.0,0,SWEET FAVORS,Bag
Agrolatina,24A8181984,02/17/2025,Entry,190.0,1900.0,0,SWEET FAVORS,Bag
Agrolatina,24A8181984,03/07/2025,Sale,-95.0,1805.0,18,SWEET FAVORS,Bag
Agrolatina,24A8181984,03/21/2025,Sale,-95.0,1710.0,32,SWEET FAVORS,Bag
Agrolatina,24A8181984,03/25/2025,Sale,-95.0,1615.0,36,SWEET FAVORS,Bag
Agrolatina,24A8181984,03/27/2025,Sale,-95.0,1520.0,38,SWEET FAVORS,Bag
Agrolatina,24A8181984,04/12/2025,Sale,-120.0,1400.0,54,SWEET FAVORS,Bag
Agrolatina,24A8181984,04/12/2025,Sale,-85.0,1315.0,54,SWEET FAVORS,Bag
Agrolatina,24A8181984,04/14/2025,Sale,-719.0,596.0,56,SWEET FAVORS,Bag
Agrolatina,24A8181984,04/14/2025,Sale,-95.0,501.0,56,SWEET FAVORS,Bag
Agrolatina,24A8181984,04/14/2025,Sale,-95.0,406.0,56,SWEET FAVORS,Bag
Agrolatina,24A8181984,04/15/2025,Sale,-190.0,216.0,57,SWEET FAVORS,Bag
Agrolatina,24A8181984,04/17/2025,Sale,-26.0,190.0,59,SWEET FAVORS,Bag
Agrolatina,24A8183868,02/11/2025,Entry,1200.0,1200.0,0,SWEET GLOBE,Clam
Agrolatina,24A8183868,02/11/2025,Entry,400.0,1600.0,0,SWEET GLOBE,Clam
Agrolatina,24A8183868,02/20/2025,Sale,-800.0,800.0,9,SWEET GLOBE,Clam
Agrolatina,24A8183868,02/26/2025,Sale,-160.0,640.0,15,SWEET GLOBE,Clam
Agrolatina,24A8183868,02/27/2025,Sale,-80.0,560.0,16,SWEET GLOBE,Clam
Agrolatina,24A8183868,02/27/2025,Sale,-160.0,400.0,16,SWEET GLOBE,Clam
Agrolatina,24A8183868,03/06/2025,Sale,-160.0,240.0,23,SWEET GLOBE,Clam
Agrolatina,24A8183868,03/11/2025,Sale,-80.0,160.0,28,SWEET GLOBE,Clam
Agrolatina,24A8183868,03/11/2025,Sale,-160.0,0.0,28,SWEET GLOBE,Clam
Agrolatina,24A8183924,01/18/2025,Entry,1280.0,1280.0,0,ALLISON,Clam
Agrolatina,24A8183924,01/18/2025,Entry,320.0,1600.0,0,ALLISON,Clam
Agrolatina,24A8183924,02/15/2025,Sale,-80.0,1520.0,28,ALLISON,Clam
Agrolatina,24A8183924,02/19/2025,Sale,-160.0,1360.0,32,ALLISON,Clam
Agrolatina,24A8183924,02/19/2025,Sale,-800.0,560.0,32,ALLISON,Clam
Agrolatina,24A8183924,02/19/2025,Sale,-80.0,480.0,32,ALLISON,Clam
Agrolatina,24A8183924,02/20/2025,Sale,-160.0,320.0,33,ALLISON,Clam
Agrolatina,24A8183924,03/01/2025,Sale,-160.0,160.0,42,ALLISON,Clam
Agrolatina,24A8183924,03/03/2025,Sale,-80.0,80.0,44,ALLISON,Clam
Agrolatina,24A8183924,03/06/2025,Sale,-80.0,0.0,47,ALLISON,Clam
Agrolatina,24A8184258,01/13/2025,Entry,1360.0,1360.0,0,CANDY SNAP,Clam
Agrolatina,24A8184258,01/13/2025,Entry,240.0,1600.0,0,CANDY SNAP,Clam
Agrolatina,24A8184258,02/05/2025,Sale,-80.0,1520.0,23,CANDY SNAP,Clam
Agrolatina,24A8184258,02/06/2025,Sale,-160.0,1360.0,24,CANDY SNAP,Clam
Agrolatina,24A8184258,02/17/2025,Sale,-960.0,400.0,35,CANDY SNAP,Clam
Agrolatina,24A8184258,02/17/2025,Sale,-80.0,320.0,35,CANDY SNAP,Clam
Agrolatina,24A8184258,02/17/2025,Sale,-240.0,80.0,35,CANDY SNAP,Clam
Agrolatina,24A8184258,03/03/2025,Sale,-40.0,40.0,49,CANDY SNAP,Clam
Agrolatina,24A8184258,03/31/2025,Sale,-20.0,20.0,77,CANDY SNAP,Clam
Agrolatina,24A8195947,12/31/2024,Entry,1600.0,1600.0,0,ALLISON,Clam
Agrolatina,24A8195947,01/10/2025,Sale,-1040.0,560.0,10,ALLISON,Clam
Agrolatina,24A8195947,01/16/2025,Sale,-480.0,80.0,16,ALLISON,Clam
Agrolatina,24A8195947,01/17/2025,Sale,-80.0,0.0,17,ALLISON,Clam
Agrolatina,24A8201485,01/16/2025,Entry,1280.0,1280.0,0,SWEET GLOBE,Clam
Agrolatina,24A8201485,01/16/2025,Entry,320.0,1600.0,0,SWEET GLOBE,Clam
Agrolatina,24A8201485,02/01/2025,Sale,-80.0,1520.0,16,SWEET GLOBE,Clam
Agrolatina,24A8201485,02/03/2025,Sale,-400.0,1120.0,18,SWEET GLOBE,Clam
Agrolatina,24A8201485,02/03/2025,Sale,-80.0,1040.0,18,SWEET GLOBE,Clam
Agrolatina,24A8201485,02/03/2025,Sale,-480.0,560.0,18,SWEET GLOBE,Clam
Agrolatina,24A8201485,02/03/2025,Sale,-75.0,485.0,18,SWEET GLOBE,Clam
Agrolatina,24A8201485,02/05/2025,Sale,-80.0,405.0,20,SWEET GLOBE,Clam
Agrolatina,24A8201485,02/05/2025,Sale,-80.0,325.0,20,SWEET GLOBE,Clam
Agrolatina,24A8201485,02/12/2025,Sale,-320.0,5.0,27,SWEET GLOBE,Clam
Agrolatina,24A8205828,03/04/2025,Entry,1120.0,1120.0,0,IVORY,Clam
Agrolatina,24A8205828,03/04/2025,Entry,400.0,1520.0,0,IVORY,Clam
Agrolatina,24A8205828,03/04/2025,Entry,80.0,1600.0,0,IVORY,Clam
Agrolatina,24A8205828,03/11/2025,Sale,-400.0,1200.0,7,IVORY,Clam
Agrolatina,24A8205828,03/12/2025,Sale,-80.0,1120.0,8,IVORY,Clam
Agrolatina,24A8205828,03/21/2025,Sale,-28.0,1092.0,17,IVORY,Clam
Agrolatina,24A8205828,03/22/2025,Sale,-240.0,852.0,18,IVORY,Clam
Agrolatina,24A8205828,03/24/2025,Sale,-304.0,548.0,20,IVORY,Clam
Agrolatina,24A8205828,04/02/2025,Sale,-48.0,500.0,29,IVORY,Clam
Agrolatina,24A8205828,04/02/2025,Sale,-40.0,460.0,29,IVORY,Clam
Agrolatina,24A8205828,04/07/2025,Sale,-20.0,440.0,34,IVORY,Clam
Agrolatina,24A8208406,12/26/2024,Entry,1280.0,1280.0,0,ALLISON,Clam
Agrolatina,24A8208406,12/26/2024,Entry,320.0,1600.0,0,ALLISON,Clam
Agrolatina,24A8208406,01/07/2025,Sale,-1280.0,320.0,12,ALLISON,Clam
Agrolatina,24A8208406,01/07/2025,Sale,-320.0,0.0,12,ALLISON,Clam
Agrolatina,24A8211980,02/06/2025,Entry,1200.0,1200.0,0,ALLISON,Clam
Agrolatina,24A8211980,02/06/2025,Entry,400.0,1600.0,0,ALLISON,Clam
Agrolatina,24A8211980,02/21/2025,Sale,-80.0,1520.0,15,ALLISON,Clam
Agrolatina,24A8211980,03/04/2025,Sale,-320.0,1200.0,26,ALLISON,Clam
Agrolatina,24A8211980,03/11/2025,Sale,-80.0,1120.0,33,ALLISON,Clam
Agrolatina,24A8211980,03/12/2025,Sale,-1120.0,0.0,34,ALLISON,Clam
Agrolatina,24A8212290,02/07/2025,Entry,1040.0,1040.0,0,SWEET GLOBE,Clam
Agrolatina,24A8212290,02/07/2025,Entry,560.0,1600.0,0,SWEET GLOBE,Clam
Agrolatina,24A8212290,02/19/2025,Sale,-80.0,1520.0,12,SWEET GLOBE,Clam
Agrolatina,24A8212290,02/22/2025,Sale,-240.0,1280.0,15,SWEET GLOBE,Clam
Agrolatina,24A8212290,02/22/2025,Sale,-400.0,880.0,15,SWEET GLOBE,Clam
Agrolatina,24A8212290,02/24/2025,Sale,-54.0,826.0,17,SWEET GLOBE,Clam
Agrolatina,24A8212290,02/24/2025,Sale,-80.0,746.0,17,SWEET GLOBE,Clam
Agrolatina,24A8212290,02/27/2025,Sale,-400.0,346.0,20,SWEET GLOBE,Clam
Agrolatina,24A8212290,03/05/2025,Sale,-160.0,186.0,26,SWEET GLOBE,Clam
Agrolatina,24A8214820,03/03/2025,Entry,1600.0,1600.0,0,TIMCO,Clam
Agrolatina,24A8214820,04/01/2025,Sale,-320.0,1280.0,29,TIMCO,Clam
Agrolatina,24A8214820,04/02/2025,Sale,-80.0,1200.0,30,TIMCO,Clam
Agrolatina,24A8214820,04/05/2025,Sale,-720.0,480.0,33,TIMCO,Clam
Agrolatina,24A8214820,04/07/2025,Sale,-320.0,160.0,35,TIMCO,Clam
Agrolatina,24A8214820,04/10/2025,Sale,-80.0,80.0,38,TIMCO,Clam
Agrolatina,24A8214820,04/11/2025,Sale,-80.0,0.0,39,TIMCO,Clam
Agrolatina,24A8214902,01/16/2025,Entry,720.0,720.0,0,CANDY DREAMS,Clam
Agrolatina,24A8214902,01/16/2025,Entry,880.0,1600.0,0,CANDY DREAMS,Clam
Agrolatina,24A8214902,02/13/2025,Sale,-640.0,960.0,28,CANDY DREAMS,Clam
Agrolatina,24A8214902,02/18/2025,Sale,-80.0,880.0,33,CANDY DREAMS,Clam
Agrolatina,24A8214902,02/22/2025,Sale,-80.0,800.0,37,CANDY DREAMS,Clam
Agrolatina,24A8214902,02/24/2025,Sale,-80.0,720.0,39,CANDY DREAMS,Clam
Agrolatina,24A8214902,02/27/2025,Sale,-80.0,640.0,42,CANDY DREAMS,Clam
Agrolatina,24A8214902,03/01/2025,Sale,-330.0,310.0,44,CANDY DREAMS,Clam
Agrolatina,24A8214902,03/04/2025,Sale,-60.0,250.0,47,CANDY DREAMS,Clam
Agrolatina,24A8214902,03/08/2025,Sale,-80.0,170.0,51,CANDY DREAMS,Clam
Agrolatina,24A8214902,03/11/2025,Sale,-27.0,143.0,54,CANDY DREAMS,Clam
Agrolatina,24A8214902,04/21/2025,Sale,-60.0,83.0,95,CANDY DREAMS,Clam
Agrolatina,24A8218609,02/11/2025,Entry,1040.0,1040.0,0,SWEET GLOBE,Clam
Agrolatina,24A8218609,02/11/2025,Entry,560.0,1600.0,0,SWEET GLOBE,Clam
Agrolatina,24A8218609,02/25/2025,Sale,-240.0,1360.0,14,SWEET GLOBE,Clam
Agrolatina,24A8218609,02/27/2025,Sale,-240.0,1120.0,16,SWEET GLOBE,Clam
Agrolatina,24A8218609,02/27/2025,Sale,-240.0,880.0,16,SWEET GLOBE,Clam
Agrolatina,24A8218609,03/01/2025,Sale,-320.0,560.0,18,SWEET GLOBE,Clam
Agrolatina,24A8218609,03/05/2025,Sale,-80.0,480.0,22,SWEET GLOBE,Clam
Agrolatina,24A8218609,03/11/2025,Sale,-480.0,0.0,28,SWEET GLOBE,Clam
Agrolatina,24A8347870,02/17/2025,Entry,1360.0,1360.0,0,IVORY,Clam
Agrolatina,24A8347870,02/17/2025,Entry,240.0,1600.0,0,IVORY,Clam
Agrolatina,24A8347870,02/25/2025,Sale,-1280.0,320.0,8,IVORY,Clam
Agrolatina,24A8347870,02/25/2025,Sale,-80.0,240.0,8,IVORY,Clam
Agrolatina,24A8347870,02/26/2025,Sale,-80.0,160.0,9,IVORY,Clam
Agrolatina,24A8347870,03/27/2025,Sale,-40.0,120.0,38,IVORY,Clam
Agrolatina,24A8347870,03/28/2025,Sale,-60.0,60.0,39,IVORY,Clam
Agrolatina,24A8347870,03/29/2025,Sale,-20.0,40.0,40,IVORY,Clam
Agrolatina,24A8348855,02/17/2025,Entry,960.0,960.0,0,SWEET GLOBE,Clam
Agrolatina,24A8348855,02/17/2025,Entry,640.0,1600.0,0,SWEET GLOBE,Clam
Agrolatina,24A8348855,03/05/2025,Sale,-320.0,1280.0,16,SWEET GLOBE,Clam
Agrolatina,24A8348855,03/08/2025,Sale,-400.0,880.0,19,SWEET GLOBE,Clam
Agrolatina,24A8348855,03/11/2025,Sale,-80.0,800.0,22,SWEET GLOBE,Clam
Agrolatina,24A8348855,03/11/2025,Sale,-40.0,760.0,22,SWEET GLOBE,Clam
Agrolatina,24A8348855,03/13/2025,Sale,-40.0,720.0,24,SWEET GLOBE,Clam
Agrolatina,24A8348855,03/14/2025,Sale,-80.0,640.0,25,SWEET GLOBE,Clam
Agrolatina,24A8348855,03/14/2025,Sale,-170.0,470.0,25,SWEET GLOBE,Clam
Agrolatina,24A8348855,03/15/2025,Sale,-220.0,250.0,26,SWEET GLOBE,Clam
Agrolatina,24A8349609,01/09/2025,Entry,1280.0,1280.0,0,SWEET GLOBE,Clam
Agrolatina,24A8349609,01/09/2025,Entry,320.0,1600.0,0,SWEET GLOBE,Clam
Agrolatina,24A8349609,01/27/2025,Sale,-320.0,1280.0,18,SWEET GLOBE,Clam
Agrolatina,24A8349609,02/01/2025,Sale,-80.0,1200.0,23,SWEET GLOBE,Clam
Agrolatina,24A8349609,02/03/2025,Sale,-480.0,720.0,25,SWEET GLOBE,Clam
Agrolatina,24A8349609,02/03/2025,Sale,-160.0,560.0,25,SWEET GLOBE,Clam
Agrolatina,24A8349609,02/03/2025,Sale,-560.0,0.0,25,SWEET GLOBE,Clam
Agrolatina,24A8367095,02/11/2025,Entry,1040.0,1040.0,0,SWEET GLOBE,Clam
Agrolatina,24A8367095,02/11/2025,Entry,560.0,1600.0,0,SWEET GLOBE,Clam
Agrolatina,24A8367095,02/21/2025,Sale,-80.0,1520.0,10,SWEET GLOBE,Clam
Agrolatina,24A8367095,03/01/2025,Sale,-1040.0,480.0,18,SWEET GLOBE,Clam
Agrolatina,24A8367095,03/05/2025,Sale,-480.0,0.0,22,SWEET GLOBE,Clam
Agrolatina,24A8367984,02/17/2025,Entry,960.0,960.0,0,SWEET GLOBE,Clam
Agrolatina,24A8367984,02/17/2025,Entry,640.0,1600.0,0,SWEET GLOBE,Clam
Agrolatina,24A8367984,03/01/2025,Sale,-240.0,1360.0,12,SWEET GLOBE,Clam
Agrolatina,24A8367984,03/01/2025,Sale,-320.0,1040.0,12,SWEET GLOBE,Clam
Agrolatina,24A8367984,03/01/2025,Sale,-80.0,960.0,12,SWEET GLOBE,Clam
Agrolatina,24A8367984,03/01/2025,Sale,-320.0,640.0,12,SWEET GLOBE,Clam
Agrolatina,24A8367984,03/01/2025,Sale,-80.0,560.0,12,SWEET GLOBE,Clam
Agrolatina,24A8367984,03/03/2025,Sale,-160.0,400.0,14,SWEET GLOBE,Clam
Agrolatina,24A8367984,03/03/2025,Sale,-240.0,160.0,14,SWEET GLOBE,Clam
Agrolatina,24A8367984,03/10/2025,Sale,-60.0,100.0,21,SWEET GLOBE,Clam
Agrolatina,24A8367984,03/15/2025,Sale,-60.0,40.0,26,SWEET GLOBE,Clam
Agrolatina,24A8368527,02/10/2025,Entry,1280.0,1280.0,0,SWEET FAVORS,Clam
Agrolatina,24A8368527,02/10/2025,Entry,320.0,1600.0,0,SWEET FAVORS,Clam
Agrolatina,24A8368527,03/11/2025,Sale,-480.0,1120.0,29,SWEET FAVORS,Clam
Agrolatina,24A8368527,03/17/2025,Sale,-320.0,800.0,35,SWEET FAVORS,Clam
Agrolatina,24A8368527,03/27/2025,Sale,-160.0,640.0,45,SWEET FAVORS,Clam
Agrolatina,24A8368527,03/27/2025,Sale,-560.0,80.0,45,SWEET FAVORS,Clam
Agrolatina,24A8368527,04/03/2025,Sale,-80.0,0.0,52,SWEET FAVORS,Clam
Agrolatina,24A8370571,02/05/2025,Entry,1330.0,1330.0,0,SWEET GLOBE,Bag
Agrolatina,24A8370571,02/05/2025,Entry,95.0,1425.0,0,SWEET GLOBE,Bag
Agrolatina,24A8370571,02/05/2025,Entry,475.0,1900.0,0,SWEET GLOBE,Bag
Agrolatina,24A8370571,02/11/2025,Sale,-950.0,950.0,6,SWEET GLOBE,Bag
Agrolatina,24A8370571,02/11/2025,Sale,-95.0,855.0,6,SWEET GLOBE,Bag
Agrolatina,24A8370571,02/11/2025,Sale,-95.0,760.0,6,SWEET GLOBE,Bag
Agrolatina,24A8370571,02/12/2025,Sale,-285.0,475.0,7,SWEET GLOBE,Bag
Agrolatina,24A8370571,02/12/2025,Sale,-475.0,0.0,7,SWEET GLOBE,Bag
Agrolatina,24A8409360,03/10/2025,Entry,880.0,880.0,0,TIMCO,Clam
Agrolatina,24A8409360,03/10/2025,Entry,720.0,1600.0,0,TIMCO,Clam
Agrolatina,24A8409360,04/21/2025,Sale,-880.0,720.0,42,TIMCO,Clam
Agrolatina,24A8409360,04/22/2025,Sale,-400.0,320.0,43,TIMCO,Clam
Agrolatina,24A8436930,03/04/2025,Entry,80.0,80.0,0,ALLISON,Clam
Agrolatina,24A8436930,03/04/2025,Entry,880.0,960.0,0,ALLISON,Clam
Agrolatina,24A8436930,03/04/2025,Entry,160.0,1120.0,0,TIMCO,Clam
Agrolatina,24A8436930,03/04/2025,Entry,480.0,1600.0,0,TIMCO,Clam
Agrolatina,24A8436930,03/17/2025,Sale,-80.0,1520.0,13,ALLISON,Clam
Agrolatina,24A8436930,04/09/2025,Sale,-160.0,1360.0,36,TIMCO,Clam
Agrolatina,24A8436930,04/16/2025,Sale,-320.0,1040.0,43,TIMCO,Clam
Agrolatina,24A8436930,04/21/2025,Sale,-160.0,880.0,48,TIMCO,Clam
Agrolatina,24A8436930,05/02/2025,Sale,-141.0,739.0,59,ALLISON,Clam
Agrolatina,24A8436930,05/02/2025,Sale,-132.0,607.0,59,ALLISON,Clam
Agrolatina,24A8436930,05/03/2025,Sale,-560.0,47.0,60,ALLISON,Clam
Agrolatina,24A8436930,05/11/2025,Sale,-15.0,32.0,68,ALLISON,Clam
Agrolatina,24A8443538,02/11/2025,Entry,640.0,640.0,0,SWEET GLOBE,Clam
Agrolatina,24A8443538,02/11/2025,Entry,960.0,1600.0,0,SWEET GLOBE,Clam
Agrolatina,24A8443538,02/22/2025,Sale,-480.0,1120.0,11,SWEET GLOBE,Clam
Agrolatina,24A8443538,02/25/2025,Sale,-240.0,880.0,14,SWEET GLOBE,Clam
Agrolatina,24A8443538,02/26/2025,Sale,-160.0,720.0,15,SWEET GLOBE,Clam
Agrolatina,24A8443538,03/03/2025,Sale,-80.0,640.0,20,SWEET GLOBE,Clam
Agrolatina,24A8443538,03/04/2025,Sale,-80.0,560.0,21,SWEET GLOBE,Clam
Agrolatina,24A8443538,03/04/2025,Sale,-240.0,320.0,21,SWEET GLOBE,Clam
Agrolatina,24A8443538,03/06/2025,Sale,-240.0,80.0,23,SWEET GLOBE,Clam
Agrolatina,24A8443538,03/06/2025,Sale,-80.0,0.0,23,SWEET GLOBE,Clam
Agrolatina,24A8453104,02/06/2025,Entry,950.0,950.0,0,SWEET GLOBE,Bag
Agrolatina,24A8453104,02/06/2025,Entry,950.0,1900.0,0,SWEET GLOBE,Bag
Agrolatina,24A8453104,02/08/2025,Sale,-285.0,1615.0,2,SWEET GLOBE,Bag
Agrolatina,24A8453104,02/10/2025,Sale,-95.0,1520.0,4,SWEET GLOBE,Bag
Agrolatina,24A8453104,02/13/2025,Sale,-90.0,1430.0,7,SWEET GLOBE,Bag
Agrolatina,24A8453104,02/18/2025,Sale,-475.0,955.0,12,SWEET GLOBE,Bag
Agrolatina,24A8453104,02/21/2025,Sale,-264.0,691.0,15,SWEET GLOBE,Bag
Agrolatina,24A8453104,02/22/2025,Sale,-115.0,576.0,16,SWEET GLOBE,Bag
Agrolatina,24A8453104,02/22/2025,Sale,-45.0,531.0,16,SWEET GLOBE,Bag
Agrolatina,24A8453104,02/24/2025,Sale,-160.0,371.0,18,SWEET GLOBE,Bag
Agrolatina,24A8453104,02/27/2025,Sale,-37.0,334.0,21,SWEET GLOBE,Bag
Agrolatina,24A8453104,03/12/2025,Sale,-90.0,244.0,34,SWEET GLOBE,Bag
Agrolatina,24A8453188,03/04/2025,Entry,1200.0,1200.0,0,SWEET GLOBE,Clam
Agrolatina,24A8453188,03/04/2025,Entry,400.0,1600.0,0,SWEET GLOBE,Clam
Agrolatina,24A8453188,03/08/2025,Sale,-800.0,800.0,4,SWEET GLOBE,Clam
Agrolatina,24A8453188,03/08/2025,Sale,-400.0,400.0,4,SWEET GLOBE,Clam
Agrolatina,24A8453188,03/13/2025,Sale,-240.0,160.0,9,SWEET GLOBE,Clam
Agrolatina,24A8453188,03/15/2025,Sale,-40.0,120.0,11,SWEET GLOBE,Clam
Agrolatina,24A8453188,03/15/2025,Sale,-40.0,80.0,11,SWEET GLOBE,Clam
Agrolatina,24A8453336,02/11/2025,Entry,960.0,960.0,0,SWEET GLOBE,Clam
Agrolatina,24A8453336,02/11/2025,Entry,640.0,1600.0,0,SWEET GLOBE,Clam
Agrolatina,24A8453336,02/19/2025,Sale,-80.0,1520.0,8,SWEET GLOBE,Clam
Agrolatina,24A8453336,02/24/2025,Sale,-560.0,960.0,13,SWEET GLOBE,Clam
Agrolatina,24A8453336,02/26/2025,Sale,-960.0,0.0,15,SWEET GLOBE,Clam
Agrolatina,24A8460525,02/04/2025,Entry,960.0,960.0,0,SWEET GLOBE,Clam
Agrolatina,24A8460525,02/04/2025,Entry,640.0,1600.0,0,SWEET GLOBE,Clam
Agrolatina,24A8460525,02/19/2025,Sale,-640.0,960.0,15,SWEET GLOBE,Clam
Agrolatina,24A8460525,02/20/2025,Sale,-880.0,80.0,16,SWEET GLOBE,Clam
Agrolatina,24A8460525,02/21/2025,Sale,-80.0,0.0,17,SWEET GLOBE,Clam
Agrolatina,24A8462528,03/04/2025,Entry,1280.0,1280.0,0,SWEET GLOBE,Clam
Agrolatina,24A8462528,03/04/2025,Entry,320.0,1600.0,0,SWEET GLOBE,Clam
Agrolatina,24A8462528,03/08/2025,Sale,-80.0,1520.0,4,SWEET GLOBE,Clam
Agrolatina,24A8462528,03/11/2025,Sale,-80.0,1440.0,7,SWEET GLOBE,Clam
Agrolatina,24A8462528,03/11/2025,Sale,-120.0,1320.0,7,SWEET GLOBE,Clam
Agrolatina,24A8462528,03/13/2025,Sale,-300.0,1020.0,9,SWEET GLOBE,Clam
Agrolatina,24A8462528,03/13/2025,Sale,-240.0,780.0,9,SWEET GLOBE,Clam
Agrolatina,24A8462528,03/13/2025,Sale,-80.0,700.0,9,SWEET GLOBE,Clam
Agrolatina,24A8462528,03/15/2025,Sale,-100.0,600.0,11,SWEET GLOBE,Clam
Agrolatina,24A8462528,03/15/2025,Sale,-40.0,560.0,11,SWEET GLOBE,Clam
Agrolatina,24A8482118,01/03/2025,Entry,1360.0,1360.0,0,SWEET GLOBE,Clam
Agrolatina,24A8482118,01/03/2025,Entry,240.0,1600.0,0,SWEET GLOBE,Clam
Agrolatina,24A8482118,01/20/2025,Sale,-80.0,1520.0,17,SWEET GLOBE,Clam
Agrolatina,24A8482118,01/21/2025,Sale,-640.0,880.0,18,SWEET GLOBE,Clam
Agrolatina,24A8482118,01/21/2025,Sale,-80.0,800.0,18,SWEET GLOBE,Clam
Agrolatina,24A8482118,01/21/2025,Sale,-240.0,560.0,18,SWEET GLOBE,Clam
Agrolatina,24A8482118,01/27/2025,Sale,-160.0,400.0,24,SWEET GLOBE,Clam
Agrolatina,24A8482118,01/28/2025,Sale,-80.0,320.0,25,SWEET GLOBE,Clam
Agrolatina,24A8482118,01/28/2025,Sale,-80.0,240.0,25,SWEET GLOBE,Clam
Agrolatina,24A8482118,01/28/2025,Sale,-240.0,0.0,25,SWEET GLOBE,Clam
Agrolatina,24A8483515,02/10/2025,Entry,720.0,720.0,0,ALLISON,Clam
Agrolatina,24A8483515,02/10/2025,Entry,560.0,1280.0,0,ALLISON,Clam
Agrolatina,24A8483515,02/10/2025,Entry,240.0,1520.0,0,TIMCO,Clam
Agrolatina,24A8483515,02/10/2025,Entry,80.0,1600.0,0,TIMCO,Clam
Agrolatina,24A8483515,03/05/2025,Sale,-720.0,880.0,23,ALLISON,Clam
Agrolatina,24A8483515,03/05/2025,Sale,-160.0,720.0,23,ALLISON,Clam
Agrolatina,24A8483515,03/05/2025,Sale,-400.0,320.0,23,ALLISON,Clam
Agrolatina,24A8483515,03/06/2025,Sale,-80.0,240.0,24,TIMCO,Clam
Agrolatina,24A8483515,03/10/2025,Sale,-240.0,0.0,28,TIMCO,Clam
Agrolatina,24A8494094,03/09/2025,Entry,1520.0,1520.0,0,IVORY,Clam
Agrolatina,24A8494094,03/09/2025,Entry,80.0,1600.0,0,IVORY,Clam
Agrolatina,24A8494094,03/12/2025,Sale,-80.0,1520.0,3,IVORY,Clam
Agrolatina,24A8494094,03/24/2025,Sale,-60.0,1460.0,15,IVORY,Clam
Agrolatina,24A8494094,03/25/2025,Sale,-640.0,820.0,16,IVORY,Clam
Agrolatina,24A8494094,03/29/2025,Sale,-80.0,740.0,20,IVORY,Clam
Agrolatina,24A8494094,04/01/2025,Sale,-40.0,700.0,23,IVORY,Clam
Agrolatina,24A8494094,04/02/2025,Sale,-320.0,380.0,24,IVORY,Clam
Agrolatina,24A8494094,04/03/2025,Sale,-120.0,260.0,25,IVORY,Clam
Agrolatina,24A8494094,04/05/2025,Sale,-72.0,188.0,27,IVORY,Clam
Agrolatina,24A8496034,02/11/2025,Entry,1200.0,1200.0,0,SWEET GLOBE,Clam
Agrolatina,24A8496034,02/11/2025,Entry,400.0,1600.0,0,SWEET GLOBE,Clam
Agrolatina,24A8496034,02/19/2025,Sale,-80.0,1520.0,8,SWEET GLOBE,Clam
Agrolatina,24A8496034,02/21/2025,Sale,-80.0,1440.0,10,SWEET GLOBE,Clam
Agrolatina,24A8496034,02/22/2025,Sale,-80.0,1360.0,11,SWEET GLOBE,Clam
Agrolatina,24A8496034,02/22/2025,Sale,-40.0,1320.0,11,SWEET GLOBE,Clam
Agrolatina,24A8496034,02/24/2025,Sale,-160.0,1160.0,13,SWEET GLOBE,Clam
Agrolatina,24A8496034,02/24/2025,Sale,-480.0,680.0,13,SWEET GLOBE,Clam
Agrolatina,24A8496034,02/25/2025,Sale,-80.0,600.0,14,SWEET GLOBE,Clam
Agrolatina,24A8496034,02/26/2025,Sale,-40.0,560.0,15,SWEET GLOBE,Clam
Agrolatina,24A8496034,02/27/2025,Sale,-40.0,520.0,16,SWEET GLOBE,Clam
Agrolatina,24A8496034,03/01/2025,Sale,-60.0,460.0,18,SWEET GLOBE,Clam
Agrolatina,24A8496034,03/05/2025,Sale,-80.0,380.0,22,SWEET GLOBE,Clam
Agrolatina,24A8497323,02/11/2025,Entry,1120.0,1120.0,0,IVORY,Clam
Agrolatina,24A8497323,02/11/2025,Entry,240.0,1360.0,0,IVORY,Clam
Agrolatina,24A8497323,02/11/2025,Entry,240.0,1600.0,0,IVORY,Clam
Agrolatina,24A8497323,04/11/2025,Sale,-984.0,616.0,59,IVORY,Clam
Agrolatina,24A8497323,04/11/2025,Sale,-240.0,376.0,59,IVORY,Clam
Agrolatina,24A8497323,04/11/2025,Sale,-240.0,136.0,59,IVORY,Clam
Agrolatina,24A8497961,03/10/2025,Entry,1280.0,1280.0,0,TIMCO,Clam
Agrolatina,24A8497961,03/10/2025,Entry,320.0,1600.0,0,TIMCO,Clam
Agrolatina,24A8497961,04/01/2025,Sale,-160.0,1440.0,22,TIMCO,Clam
Agrolatina,24A8497961,04/01/2025,Sale,-320.0,1120.0,22,TIMCO,Clam
Agrolatina,24A8497961,04/07/2025,Sale,-880.0,240.0,28,TIMCO,Clam
Agrolatina,24A8497961,04/07/2025,Sale,-240.0,0.0,28,TIMCO,Clam
Agrolatina,24A8498090,01/19/2025,Entry,1600.0,1600.0,0,ALLISON,Clam
Agrolatina,24A8498090,02/20/2025,Sale,-29.0,1571.0,32,ALLISON,Clam
Agrolatina,24A8498090,02/20/2025,Sale,-160.0,1411.0,32,ALLISON,Clam
Agrolatina,24A8498090,02/25/2025,Sale,-720.0,691.0,37,ALLISON,Clam
Agrolatina,24A8498090,02/27/2025,Sale,-240.0,451.0,39,ALLISON,Clam
Agrolatina,24A8498090,03/03/2025,Sale,-240.0,211.0,43,ALLISON,Clam
Agrolatina,24A8498090,03/03/2025,Sale,-33.0,178.0,43,ALLISON,Clam
Agrolatina,24A8498090,03/08/2025,Sale,-160.0,18.0,48,ALLISON,Clam
Agrolatina,24A8498090,03/14/2025,Sale,-10.0,8.0,54,ALLISON,Clam
Agrolatina,24A8500751,03/07/2025,Entry,1120.0,1120.0,0,TIMCO,Clam
Agrolatina,24A8500751,03/07/2025,Entry,480.0,1600.0,0,TIMCO,Clam
Agrolatina,24A8500751,04/23/2025,Sale,-480.0,1120.0,47,TIMCO,Clam
Agrolatina,24A8500751,04/24/2025,Sale,-1120.0,0.0,48,TIMCO,Clam
Agrolatina,24A8525380,02/17/2025,Entry,1280.0,1280.0,0,IVORY,Clam
Agrolatina,24A8525380,02/17/2025,Entry,160.0,1440.0,0,IVORY,Clam
Agrolatina,24A8525380,02/17/2025,Entry,160.0,1600.0,0,IVORY,Clam
Agrolatina,24A8525380,03/06/2025,Sale,-240.0,1360.0,17,IVORY,Clam
Agrolatina,24A8525380,03/12/2025,Sale,-480.0,880.0,23,IVORY,Clam
Agrolatina,24A8525380,03/12/2025,Sale,-320.0,560.0,23,IVORY,Clam
Agrolatina,24A8525380,03/12/2025,Sale,-160.0,400.0,23,IVORY,Clam
Agrolatina,24A8525380,03/22/2025,Sale,-40.0,360.0,33,IVORY,Clam
Agrolatina,24A8525380,03/22/2025,Sale,-80.0,280.0,33,IVORY,Clam
Agrolatina,24A8525380,03/22/2025,Sale,-20.0,260.0,33,IVORY,Clam
Agrolatina,24A8525380,03/27/2025,Sale,-70.0,190.0,38,IVORY,Clam
Agrolatina,24A8525380,03/28/2025,Sale,-60.0,130.0,39,IVORY,Clam
Agrolatina,24A8526535,02/06/2025,Entry,1520.0,1520.0,0,SWEET FAVORS,Bag
Agrolatina,24A8526535,02/06/2025,Entry,380.0,1900.0,0,SWEET FAVORS,Bag
Agrolatina,24A8526535,02/12/2025,Sale,-90.0,1810.0,6,SWEET FAVORS,Bag
Agrolatina,24A8526535,02/13/2025,Sale,-90.0,1720.0,7,SWEET FAVORS,Bag
Agrolatina,24A8526535,02/14/2025,Sale,-450.0,1270.0,8,SWEET FAVORS,Bag
Agrolatina,24A8526535,02/28/2025,Sale,-95.0,1175.0,22,SWEET FAVORS,Bag
Agrolatina,24A8526535,02/28/2025,Sale,-150.0,1025.0,22,SWEET FAVORS,Clam
Agrolatina,24A8526535,03/01/2025,Sale,-15.0,1010.0,23,SWEET FAVORS,Clam
Agrolatina,24A8526535,03/03/2025,Sale,-150.0,860.0,25,SWEET FAVORS,Clam
Agrolatina,24A8526535,03/26/2025,Sale,-90.0,770.0,48,SWEET FAVORS,Bag
Agrolatina,24A8526535,03/27/2025,Sale,-94.0,676.0,49,SWEET FAVORS,Bag
Agrolatina,24A8526535,04/14/2025,Sale,-190.0,486.0,67,SWEET FAVORS,Bag
Agrolatina,24A8526535,04/14/2025,Sale,-125.0,361.0,67,SWEET FAVORS,Bag
Agrolatina,24A8526535,04/17/2025,Sale,-139.0,222.0,70,SWEET FAVORS,Bag
Agrolatina,24A8526535,04/17/2025,Sale,-1.0,221.0,70,SWEET FAVORS,Bag
Agrolatina,24A8564988,02/10/2025,Entry,1360.0,1360.0,0,SWEET FAVORS,Clam
Agrolatina,24A8564988,02/10/2025,Entry,240.0,1600.0,0,SWEET FAVORS,Clam
Agrolatina,24A8564988,02/28/2025,Sale,-960.0,640.0,18,SWEET FAVORS,Clam
Agrolatina,24A8564988,03/01/2025,Sale,-240.0,400.0,19,SWEET FAVORS,Clam
Agrolatina,24A8564988,03/02/2025,Sale,-400.0,0.0,20,SWEET FAVORS,Clam
Agrolatina,24A8580783,03/10/2025,Entry,1360.0,1360.0,0,TIMCO,Clam
Agrolatina,24A8580783,03/10/2025,Entry,240.0,1600.0,0,TIMCO,Clam
Agrolatina,24A8580783,04/09/2025,Sale,-160.0,1440.0,30,TIMCO,Clam
Agrolatina,24A8580783,04/15/2025,Sale,-720.0,720.0,36,TIMCO,Clam
Agrolatina,24A8580783,04/21/2025,Sale,-475.0,245.0,42,TIMCO,Clam
Agrolatina,24A8580783,05/08/2025,Sale,-50.0,195.0,59,TIMCO,Clam
Agrolatina,24A8593348,02/11/2025,Entry,1600.0,1600.0,0,TIMCO,Clam
Agrolatina,24A8593348,03/10/2025,Sale,-1600.0,0.0,27,TIMCO,Clam
Agrolatina,24A8651249,02/17/2025,Entry,1520.0,1520.0,0,SWEET FAVORS,Bag
Agrolatina,24A8651249,02/17/2025,Entry,285.0,1805.0,0,SWEET FAVORS,Bag
Agrolatina,24A8651249,02/17/2025,Entry,95.0,1900.0,0,SWEET FAVORS,Bag
Agrolatina,24A8651249,03/10/2025,Sale,-285.0,1615.0,21,SWEET FAVORS,Bag
Agrolatina,24A8651249,04/10/2025,Sale,-340.0,1275.0,52,SWEET FAVORS,Bag
Agrolatina,24A8651249,04/12/2025,Sale,-135.0,1140.0,54,SWEET FAVORS,Bag
Agrolatina,24A8651249,04/14/2025,Sale,-190.0,950.0,56,SWEET FAVORS,Bag
Agrolatina,24A8651249,04/14/2025,Sale,-285.0,665.0,56,SWEET FAVORS,Bag
Agrolatina,24A8651249,04/14/2025,Sale,-95.0,570.0,56,SWEET FAVORS,Bag
Agrolatina,24A8651249,04/15/2025,Sale,-150.0,420.0,57,SWEET FAVORS,Bag
Agrolatina,24A8651249,04/17/2025,Sale,-250.0,170.0,59,SWEET FAVORS,Bag
Agrolatina,24A8651249,04/17/2025,Sale,-170.0,0.0,59,SWEET FAVORS,Bag
Agrolatina,24A8651510,02/17/2025,Entry,320.0,320.0,0,CANDY DREAMS,Clam
Agrolatina,24A8651510,02/17/2025,Entry,480.0,800.0,0,CANDY DREAMS,Clam
Agrolatina,24A8651510,02/17/2025,Entry,800.0,1600.0,0,IVORY,Clam
Agrolatina,24A8651510,02/24/2025,Sale,-240.0,1360.0,7,CANDY DREAMS,Clam
Agrolatina,24A8651510,02/25/2025,Sale,-320.0,1040.0,8,IVORY,Clam
Agrolatina,24A8651510,02/25/2025,Sale,-400.0,640.0,8,IVORY,Clam
Agrolatina,24A8651510,02/26/2025,Sale,-80.0,560.0,9,IVORY,Clam
Agrolatina,24A8651510,02/27/2025,Sale,-393.0,167.0,10,CANDY DREAMS,Clam
Agrolatina,24A8651510,03/04/2025,Sale,-60.0,107.0,15,CANDY DREAMS,Clam
Agrolatina,24A8681095,01/03/2025,Entry,1280.0,1280.0,0,CANDY SNAP,Clam
Agrolatina,24A8681095,01/03/2025,Entry,320.0,1600.0,0,CANDY SNAP,Clam
Agrolatina,24A8681095,02/03/2025,Sale,-80.0,1520.0,31,CANDY SNAP,Clam
Agrolatina,24A8681095,02/03/2025,Sale,-800.0,720.0,31,CANDY SNAP,Clam
Agrolatina,24A8681095,02/05/2025,Sale,-51.0,669.0,33,CANDY SNAP,Clam
Agrolatina,24A8681095,02/06/2025,Sale,-109.0,560.0,34,CANDY SNAP,Clam
Agrolatina,24A8681095,02/10/2025,Sale,-80.0,480.0,38,CANDY SNAP,Clam
Agrolatina,24A8681095,02/17/2025,Sale,-160.0,320.0,45,CANDY SNAP,Clam
Agrolatina,24A8681095,02/17/2025,Sale,-320.0,0.0,45,CANDY SNAP,Clam
Agrolatina,24A8710666,02/10/2025,Entry,240.0,240.0,0,AUTUMN CRISP,Clam
Agrolatina,24A8710666,02/10/2025,Entry,1360.0,1600.0,0,AUTUMN CRISP,Clam
Agrolatina,24A8717172,03/04/2025,Entry,1440.0,1440.0,0,COTTON CANDY,Clam
Agrolatina,24A8717172,03/04/2025,Entry,160.0,1600.0,0,COTTON CANDY,Clam
Agrolatina,24A8717172,03/27/2025,Sale,-160.0,1440.0,23,COTTON CANDY,Clam
Agrolatina,24A8717172,03/28/2025,Sale,-480.0,960.0,24,COTTON CANDY,Clam
Agrolatina,24A8717172,03/28/2025,Sale,-160.0,800.0,24,COTTON CANDY,Clam
Agrolatina,24A8717172,03/28/2025,Sale,-640.0,160.0,24,COTTON CANDY,Clam
Agrolatina,24A8717172,04/01/2025,Sale,-160.0,0.0,28,COTTON CANDY,Clam
Agrolatina,24A8723175,03/10/2025,Entry,1200.0,1200.0,0,TIMCO,Clam
Agrolatina,24A8723175,03/10/2025,Entry,320.0,1520.0,0,TIMCO,Clam
Agrolatina,24A8723175,03/10/2025,Entry,80.0,1600.0,0,TIMCO,Clam
Agrolatina,24A8723175,04/09/2025,Sale,-80.0,1520.0,30,TIMCO,Clam
Agrolatina,24A8723175,04/21/2025,Sale,-240.0,1280.0,42,TIMCO,Clam
Agrolatina,24A8723175,04/22/2025,Sale,-320.0,960.0,43,TIMCO,Clam
Agrolatina,24A8723175,04/24/2025,Sale,-31.0,929.0,45,TIMCO,Clam
Agrolatina,24A8723175,05/12/2025,Sale,-929.0,0.0,63,TIMCO,Clam
Agrolatina,24A8730256,02/17/2025,Entry,1040.0,1040.0,0,SWEET GLOBE,Clam
Agrolatina,24A8730256,02/17/2025,Entry,560.0,1600.0,0,SWEET GLOBE,Clam
Agrolatina,24A8730256,03/08/2025,Sale,-720.0,880.0,19,SWEET GLOBE,Clam
Agrolatina,24A8730256,03/08/2025,Sale,-320.0,560.0,19,SWEET GLOBE,Clam
Agrolatina,24A8730256,03/14/2025,Sale,-80.0,480.0,25,SWEET GLOBE,Clam
Agrolatina,24A8730256,03/15/2025,Sale,-400.0,80.0,26,SWEET GLOBE,Clam
Agrolatina,24A8730472,02/05/2025,Entry,1120.0,1120.0,0,SWEET GLOBE,Clam
Agrolatina,24A8730472,02/05/2025,Entry,480.0,1600.0,0,SWEET GLOBE,Clam
Agrolatina,24A8730472,02/18/2025,Sale,-80.0,1520.0,13,SWEET GLOBE,Clam
Agrolatina,24A8730472,02/18/2025,Sale,-80.0,1440.0,13,SWEET GLOBE,Clam
Agrolatina,24A8730472,02/19/2025,Sale,-80.0,1360.0,14,SWEET GLOBE,Clam
Agrolatina,24A8730472,02/20/2025,Sale,-400.0,960.0,15,SWEET GLOBE,Clam
Agrolatina,24A8730472,02/20/2025,Sale,-160.0,800.0,15,SWEET GLOBE,Clam
Agrolatina,24A8730472,02/20/2025,Sale,-160.0,640.0,15,SWEET GLOBE,Clam
Agrolatina,24A8730472,02/22/2025,Sale,-156.0,484.0,17,SWEET GLOBE,Clam
Agrolatina,24A8730472,02/26/2025,Sale,-115.0,369.0,21,SWEET GLOBE,Clam
Agrolatina,24A8730472,02/26/2025,Sale,-40.0,329.0,21,SWEET GLOBE,Clam
Agrolatina,24A8730472,02/27/2025,Sale,-10.0,319.0,22,SWEET GLOBE,Clam
Agrolatina,24A8730472,02/27/2025,Sale,-10.0,309.0,22,SWEET GLOBE,Clam
Agrolatina,24A8730472,03/01/2025,Sale,-80.0,229.0,24,SWEET GLOBE,Clam
Agrolatina,24A8730472,03/11/2025,Sale,-40.0,189.0,34,SWEET GLOBE,Clam
Agrolatina,24A8745820,03/04/2025,Entry,960.0,960.0,0,SWEET GLOBE,Clam
Agrolatina,24A8745820,03/04/2025,Entry,640.0,1600.0,0,SWEET GLOBE,Clam
Agrolatina,24A8745820,03/06/2025,Sale,-320.0,1280.0,2,SWEET GLOBE,Clam
Agrolatina,24A8745820,03/08/2025,Sale,-80.0,1200.0,4,SWEET GLOBE,Clam
Agrolatina,24A8745820,03/08/2025,Sale,-160.0,1040.0,4,SWEET GLOBE,Clam
Agrolatina,24A8745820,03/08/2025,Sale,-160.0,880.0,4,SWEET GLOBE,Clam
Agrolatina,24A8745820,03/10/2025,Sale,-40.0,840.0,6,SWEET GLOBE,Clam
Agrolatina,24A8745820,03/10/2025,Sale,-160.0,680.0,6,SWEET GLOBE,Clam
Agrolatina,24A8745820,03/11/2025,Sale,-50.0,630.0,7,SWEET GLOBE,Clam
Agrolatina,24A8745820,03/13/2025,Sale,-40.0,590.0,9,SWEET GLOBE,Clam
Agrolatina,24A8745820,03/15/2025,Sale,-100.0,490.0,11,SWEET GLOBE,Clam
Agrolatina,24A8745820,03/19/2025,Sale,-80.0,410.0,15,SWEET GLOBE,Clam
Agrolatina,24A8745820,04/02/2025,Sale,-40.0,370.0,29,SWEET GLOBE,Clam
Agrolatina,24A8753282,01/03/2025,Entry,1120.0,1120.0,0,CANDY SNAP,Clam
Agrolatina,24A8753282,01/03/2025,Entry,480.0,1600.0,0,CANDY SNAP,Clam
Agrolatina,24A8753282,01/17/2025,Sale,-480.0,1120.0,14,CANDY SNAP,Clam
Agrolatina,24A8753282,01/18/2025,Sale,-160.0,960.0,15,CANDY SNAP,Clam
Agrolatina,24A8753282,01/18/2025,Sale,-320.0,640.0,15,CANDY SNAP,Clam
Agrolatina,24A8753282,01/21/2025,Sale,-480.0,160.0,18,CANDY SNAP,Clam
Agrolatina,24A8753282,01/21/2025,Sale,-160.0,0.0,18,CANDY SNAP,Clam
Agrolatina,24A8779394,01/30/2025,Entry,800.0,800.0,0,SWEET GLOBE,Clam
Agrolatina,24A8779394,01/30/2025,Entry,800.0,1600.0,0,SWEET GLOBE,Clam
Agrolatina,24A8779394,02/15/2025,Sale,-720.0,880.0,16,SWEET GLOBE,Clam
Agrolatina,24A8779394,02/18/2025,Sale,-560.0,320.0,19,SWEET GLOBE,Clam
Agrolatina,24A8779394,02/18/2025,Sale,-80.0,240.0,19,SWEET GLOBE,Clam
Agrolatina,24A8779394,02/24/2025,Sale,-50.0,190.0,25,SWEET GLOBE,Clam
Agrolatina,24A8779394,03/01/2025,Sale,-60.0,130.0,30,SWEET GLOBE,Clam
Agrolatina,24A8779394,03/03/2025,Sale,-40.0,90.0,32,SWEET GLOBE,Clam
Agrolatina,24A8784699,01/30/2025,Entry,1600.0,1600.0,0,SWEET GLOBE,Clam
Agrolatina,24A8784699,02/08/2025,Sale,-80.0,1520.0,9,SWEET GLOBE,Clam
Agrolatina,24A8784699,02/14/2025,Sale,-80.0,1440.0,15,SWEET GLOBE,Clam
Agrolatina,24A8784699,02/15/2025,Sale,-80.0,1360.0,16,SWEET GLOBE,Clam
Agrolatina,24A8784699,02/15/2025,Sale,-240.0,1120.0,16,SWEET GLOBE,Clam
Agrolatina,24A8784699,02/15/2025,Sale,-400.0,720.0,16,SWEET GLOBE,Clam
Agrolatina,24A8784699,02/17/2025,Sale,-240.0,480.0,18,SWEET GLOBE,Clam
Agrolatina,24A8784699,02/17/2025,Sale,-80.0,400.0,18,SWEET GLOBE,Clam
Agrolatina,24A8784699,02/24/2025,Sale,-80.0,320.0,25,SWEET GLOBE,Clam
Agrolatina,24A8784699,02/25/2025,Sale,-280.0,40.0,26,SWEET GLOBE,Clam
Agrolatina,24A8784699,02/28/2025,Sale,-40.0,0.0,29,SWEET GLOBE,Clam
Agrolatina,24A8784699,03/13/2025,Sale,-40.0,-40.0,42,SWEET GLOBE,Clam
Agrolatina,24A8786599,01/30/2025,Entry,1280.0,1280.0,0,SWEET GLOBE,Clam
Agrolatina,24A8786599,01/30/2025,Entry,320.0,1600.0,0,SWEET GLOBE,Clam
Agrolatina,24A8786599,02/08/2025,Sale,-80.0,1520.0,9,SWEET GLOBE,Clam
Agrolatina,24A8786599,02/10/2025,Sale,-80.0,1440.0,11,SWEET GLOBE,Clam
Agrolatina,24A8786599,02/11/2025,Sale,-80.0,1360.0,12,SWEET GLOBE,Clam
Agrolatina,24A8786599,02/15/2025,Sale,-80.0,1280.0,16,SWEET GLOBE,Clam
Agrolatina,24A8786599,02/15/2025,Sale,-80.0,1200.0,16,SWEET GLOBE,Clam
Agrolatina,24A8786599,02/15/2025,Sale,-80.0,1120.0,16,SWEET GLOBE,Clam
Agrolatina,24A8786599,02/17/2025,Sale,-160.0,960.0,18,SWEET GLOBE,Clam
Agrolatina,24A8786599,02/17/2025,Sale,-160.0,800.0,18,SWEET GLOBE,Clam
Agrolatina,24A8786599,02/17/2025,Sale,-80.0,720.0,18,SWEET GLOBE,Clam
Agrolatina,24A8786599,02/18/2025,Sale,-80.0,640.0,19,SWEET GLOBE,Clam
Agrolatina,24A8786599,02/18/2025,Sale,-80.0,560.0,19,SWEET GLOBE,Clam
Agrolatina,24A8786599,02/26/2025,Sale,-25.0,535.0,27,SWEET GLOBE,Clam
Agrolatina,24A8786599,02/28/2025,Sale,-80.0,455.0,29,SWEET GLOBE,Clam
Agrolatina,24A8786599,03/01/2025,Sale,-60.0,395.0,30,SWEET GLOBE,Clam
Agrolatina,24A8815598,03/04/2025,Entry,800.0,800.0,0,AUTUMN CRISP,Clam
Agrolatina,24A8815598,03/04/2025,Entry,800.0,1600.0,0,AUTUMN CRISP,Clam
Agrolatina,24A8815598,03/20/2025,Sale,-720.0,880.0,16,AUTUMN CRISP,Clam
Agrolatina,24A8815598,03/21/2025,Sale,-80.0,800.0,17,AUTUMN CRISP,Clam
Agrolatina,24A8815598,03/29/2025,Sale,-800.0,0.0,25,AUTUMN CRISP,Clam
Agrolatina,24A8817230,01/10/2025,Entry,1360.0,1360.0,0,ALLISON,Clam
Agrolatina,24A8817230,01/10/2025,Entry,240.0,1600.0,0,ALLISON,Clam
Agrolatina,24A8817230,01/16/2025,Sale,-880.0,720.0,6,ALLISON,Clam
Agrolatina,24A8817230,01/21/2025,Sale,-240.0,480.0,11,ALLISON,Clam
Agrolatina,24A8817230,01/23/2025,Sale,-480.0,0.0,13,ALLISON,Clam
Agrolatina,24A8822473,02/26/2025,Entry,400.0,400.0,0,CANDY DREAMS,Clam
Agrolatina,24A8822473,02/26/2025,Entry,1200.0,1600.0,0,CANDY DREAMS,Clam
Agrolatina,24A8822473,03/06/2025,Sale,-1200.0,400.0,8,CANDY DREAMS,Clam
Agrolatina,24A8822473,03/28/2025,Sale,-400.0,0.0,30,CANDY DREAMS,Clam
Agrolatina,24A8823546,02/26/2025,Entry,720.0,720.0,0,SWEET GLOBE,Clam
Agrolatina,24A8823546,02/26/2025,Entry,880.0,1600.0,0,SWEET GLOBE,Clam
Agrolatina,24A8823546,03/01/2025,Sale,-160.0,1440.0,3,SWEET GLOBE,Clam
Agrolatina,24A8823546,03/11/2025,Sale,-560.0,880.0,13,SWEET GLOBE,Clam
Agrolatina,24A8823546,03/11/2025,Sale,-55.0,825.0,13,SWEET GLOBE,Clam
Agrolatina,24A8823546,03/11/2025,Sale,-240.0,585.0,13,SWEET GLOBE,Clam
Agrolatina,24A8823546,03/11/2025,Sale,-160.0,425.0,13,SWEET GLOBE,Clam
Agrolatina,24A8823546,03/11/2025,Sale,-80.0,345.0,13,SWEET GLOBE,Clam
Agrolatina,24A8823546,03/13/2025,Sale,-80.0,265.0,15,SWEET GLOBE,Clam
Agrolatina,24A8823546,03/17/2025,Sale,-240.0,25.0,19,SWEET GLOBE,Clam
Agrolatina,24A8825111,01/17/2025,Entry,80.0,80.0,0,CANDY SNAP,Clam
Agrolatina,24A8825111,01/17/2025,Entry,1520.0,1600.0,0,CANDY SNAP,Clam
Agrolatina,24A8825111,01/29/2025,Sale,-80.0,1520.0,12,CANDY SNAP,Clam
Agrolatina,24A8825111,01/30/2025,Sale,-80.0,1440.0,13,CANDY SNAP,Clam
Agrolatina,24A8825111,02/03/2025,Sale,-1360.0,80.0,17,CANDY SNAP,Clam
Agrolatina,24A8825111,02/19/2025,Sale,-72.0,8.0,33,CANDY SNAP,Clam
Agrolatina,24A8825370,02/26/2025,Entry,320.0,320.0,0,CANDY DREAMS,Clam
Agrolatina,24A8825370,02/26/2025,Entry,1280.0,1600.0,0,CANDY DREAMS,Clam
Agrolatina,24A8825370,03/25/2025,Sale,-80.0,1520.0,27,CANDY DREAMS,Clam
Agrolatina,24A8825370,03/27/2025,Sale,-80.0,1440.0,29,CANDY DREAMS,Clam
Agrolatina,24A8825370,03/27/2025,Sale,-80.0,1360.0,29,CANDY DREAMS,Clam
Agrolatina,24A8825370,03/27/2025,Sale,-80.0,1280.0,29,CANDY DREAMS,Clam
Agrolatina,24A8825370,03/28/2025,Sale,-320.0,960.0,30,CANDY DREAMS,Clam
Agrolatina,24A8825370,03/28/2025,Sale,-320.0,640.0,30,CANDY DREAMS,Clam
Agrolatina,24A8825370,03/31/2025,Sale,-480.0,160.0,33,CANDY DREAMS,Clam
Agrolatina,24A8825370,04/01/2025,Sale,-80.0,80.0,34,CANDY DREAMS,Clam
Agrolatina,24A8830442,03/04/2025,Entry,1040.0,1040.0,0,TIMCO,Clam
Agrolatina,24A8830442,03/04/2025,Entry,560.0,1600.0,0,TIMCO,Clam
Agrolatina,24A8830442,04/02/2025,Sale,-80.0,1520.0,29,TIMCO,Clam
Agrolatina,24A8830442,04/04/2025,Sale,-560.0,960.0,31,TIMCO,Clam
Agrolatina,24A8830442,04/06/2025,Sale,-400.0,560.0,33,TIMCO,Clam
Agrolatina,24A8830442,04/09/2025,Sale,-240.0,320.0,36,TIMCO,Clam
Agrolatina,24A8830442,04/18/2025,Sale,-260.0,60.0,45,TIMCO,Clam
Agrolatina,24A8831140,01/03/2025,Entry,1600.0,1600.0,0,ALLISON,Clam
Agrolatina,24A8831140,01/18/2025,Sale,-1040.0,560.0,15,ALLISON,Clam
Agrolatina,24A8831140,01/20/2025,Sale,-560.0,0.0,17,ALLISON,Clam
Agrolatina,24A8834237,02/24/2025,Entry,1200.0,1200.0,0,TIMCO,Clam
Agrolatina,24A8834237,02/24/2025,Entry,400.0,1600.0,0,TIMCO,Clam
Agrolatina,24A8834237,03/01/2025,Sale,-640.0,960.0,5,TIMCO,Clam
Agrolatina,24A8834237,03/11/2025,Sale,-160.0,800.0,15,TIMCO,Clam
Agrolatina,24A8834237,04/02/2025,Sale,-400.0,400.0,37,TIMCO,Clam
Agrolatina,24A8834237,04/02/2025,Sale,-80.0,320.0,37,TIMCO,Clam
Agrolatina,24A8834237,04/04/2025,Sale,-320.0,0.0,39,TIMCO,Clam
Agrolatina,24A8837982,01/17/2025,Entry,1120.0,1120.0,0,CANDY DREAMS,Clam
Agrolatina,24A8837982,01/17/2025,Entry,480.0,1600.0,0,CANDY DREAMS,Clam
Agrolatina,24A8837982,01/27/2025,Sale,-240.0,1360.0,10,CANDY DREAMS,Clam
Agrolatina,24A8837982,01/27/2025,Sale,-400.0,960.0,10,CANDY DREAMS,Clam
Agrolatina,24A8837982,01/27/2025,Sale,-480.0,480.0,10,CANDY DREAMS,Clam
Agrolatina,24A8837982,01/30/2025,Sale,-80.0,400.0,13,CANDY DREAMS,Clam
Agrolatina,24A8837982,02/01/2025,Sale,-80.0,320.0,15,CANDY DREAMS,Clam
Agrolatina,24A8837982,02/01/2025,Sale,-320.0,0.0,15,CANDY DREAMS,Clam
Agrolatina,24A8840923,03/04/2025,Entry,960.0,960.0,0,COTTON CANDY,Clam
Agrolatina,24A8840923,03/04/2025,Entry,640.0,1600.0,0,COTTON CANDY,Clam
Agrolatina,24A8840923,03/28/2025,Sale,-320.0,1280.0,24,COTTON CANDY,Clam
Agrolatina,24A8840923,03/28/2025,Sale,-640.0,640.0,24,COTTON CANDY,Clam
Agrolatina,24A8840923,04/01/2025,Sale,-640.0,0.0,28,COTTON CANDY,Clam
Agrolatina,24A8846752,02/07/2025,Entry,960.0,960.0,0,SWEET GLOBE,Clam
Agrolatina,24A8846752,02/07/2025,Entry,640.0,1600.0,0,SWEET GLOBE,Clam
Agrolatina,24A8846752,02/17/2025,Sale,-400.0,1200.0,10,SWEET GLOBE,Clam
Agrolatina,24A8846752,02/19/2025,Sale,-960.0,240.0,12,SWEET GLOBE,Clam
Agrolatina,24A8846752,02/19/2025,Sale,-240.0,0.0,12,SWEET GLOBE,Clam
Agrolatina,24A8846881,01/27/2025,Entry,800.0,800.0,0,IVORY,Clam
Agrolatina,24A8846881,01/27/2025,Entry,800.0,1600.0,0,IVORY,Clam
Agrolatina,24A8846881,02/17/2025,Sale,-800.0,800.0,21,IVORY,Clam
Agrolatina,24A8846881,02/17/2025,Sale,-480.0,320.0,21,IVORY,Clam
Agrolatina,24A8846881,02/24/2025,Sale,-320.0,0.0,28,IVORY,Clam
Agrolatina,24A8849068,01/17/2025,Entry,1360.0,1360.0,0,SWEET GLOBE,Clam
Agrolatina,24A8849068,01/17/2025,Entry,240.0,1600.0,0,SWEET GLOBE,Clam
Agrolatina,24A8849068,01/28/2025,Sale,-240.0,1360.0,11,SWEET GLOBE,Clam
Agrolatina,24A8849068,01/29/2025,Sale,-1360.0,0.0,12,SWEET GLOBE,Clam
Agrolatina,24A8850665,02/26/2025,Entry,1200.0,1200.0,0,TIMCO,Clam
Agrolatina,24A8850665,02/26/2025,Entry,400.0,1600.0,0,TIMCO,Clam
Agrolatina,24A8850665,03/10/2025,Sale,-880.0,720.0,12,TIMCO,Clam
Agrolatina,24A8850665,03/11/2025,Sale,-240.0,480.0,13,TIMCO,Clam
Agrolatina,24A8850665,04/02/2025,Sale,-80.0,400.0,35,TIMCO,Clam
Agrolatina,24A8850665,04/02/2025,Sale,-400.0,0.0,35,TIMCO,Clam
Agrolatina,24A8851933,01/27/2025,Entry,1200.0,1200.0,0,SWEET GLOBE,Clam
Agrolatina,24A8851933,01/27/2025,Entry,400.0,1600.0,0,SWEET GLOBE,Clam
Agrolatina,24A8851933,01/28/2025,Sale,-640.0,960.0,1,SWEET GLOBE,Clam
Agrolatina,24A8851933,01/28/2025,Sale,-400.0,560.0,1,SWEET GLOBE,Clam
Agrolatina,24A8851933,01/29/2025,Sale,-320.0,240.0,2,SWEET GLOBE,Clam
Agrolatina,24A8851933,01/29/2025,Sale,-240.0,0.0,2,SWEET GLOBE,Clam
Agrolatina,24A8856616,03/04/2025,Entry,800.0,800.0,0,COTTON CANDY,Clam
Agrolatina,24A8856616,03/04/2025,Entry,800.0,1600.0,0,COTTON CANDY,Clam
Agrolatina,24A8856616,03/27/2025,Sale,-80.0,1520.0,23,COTTON CANDY,Clam
Agrolatina,24A8856616,03/28/2025,Sale,-160.0,1360.0,24,COTTON CANDY,Clam
Agrolatina,24A8856616,03/28/2025,Sale,-160.0,1200.0,24,COTTON CANDY,Clam
Agrolatina,24A8856616,03/28/2025,Sale,-400.0,800.0,24,COTTON CANDY,Clam
Agrolatina,24A8856616,03/28/2025,Sale,-240.0,560.0,24,COTTON CANDY,Clam
Agrolatina,24A8856616,04/01/2025,Sale,-560.0,0.0,28,COTTON CANDY,Clam
Agrolatina,24A8860133,01/17/2025,Entry,1200.0,1200.0,0,SWEET GLOBE,Clam
Agrolatina,24A8860133,01/17/2025,Entry,400.0,1600.0,0,SWEET GLOBE,Clam
Agrolatina,24A8860133,01/25/2025,Sale,-1120.0,480.0,8,SWEET GLOBE,Clam
Agrolatina,24A8860133,01/28/2025,Sale,-80.0,400.0,11,SWEET GLOBE,Clam
Agrolatina,24A8860133,01/28/2025,Sale,-400.0,0.0,11,SWEET GLOBE,Clam
Agrolatina,24A8860600,01/27/2025,Entry,1520.0,1520.0,0,ALLISON,Clam
Agrolatina,24A8860600,01/27/2025,Entry,80.0,1600.0,0,ALLISON,Clam
Agrolatina,24A8860600,02/05/2025,Sale,-160.0,1440.0,9,ALLISON,Clam
Agrolatina,24A8860600,02/17/2025,Sale,-480.0,960.0,21,ALLISON,Clam
Agrolatina,24A8860600,02/21/2025,Sale,-80.0,880.0,25,ALLISON,Clam
Agrolatina,24A8860600,02/21/2025,Sale,-80.0,800.0,25,ALLISON,Clam
Agrolatina,24A8860600,02/22/2025,Sale,-800.0,0.0,26,ALLISON,Clam
Agrolatina,24A8862028,01/27/2025,Entry,1600.0,1600.0,0,TIMCO,Clam
Agrolatina,24A8862028,02/03/2025,Sale,-1600.0,0.0,7,TIMCO,Clam
Agrolatina,24A8863390,01/27/2025,Entry,1600.0,1600.0,0,SWEET GLOBE,Clam
Agrolatina,24A8863390,01/28/2025,Sale,-400.0,1200.0,1,SWEET GLOBE,Clam
Agrolatina,24A8863390,01/28/2025,Sale,-880.0,320.0,1,SWEET GLOBE,Clam
Agrolatina,24A8863390,01/29/2025,Sale,-80.0,240.0,2,SWEET GLOBE,Clam
Agrolatina,24A8863390,01/30/2025,Sale,-240.0,0.0,3,SWEET GLOBE,Clam
Agrolatina,24A8865270,01/27/2025,Entry,1120.0,1120.0,0,SWEET GLOBE,Clam
Agrolatina,24A8865270,01/27/2025,Entry,80.0,1200.0,0,SWEET GLOBE,Clam
Agrolatina,24A8865270,01/27/2025,Entry,400.0,1600.0,0,SWEET GLOBE,Clam
Agrolatina,24A8865270,01/28/2025,Sale,-1120.0,480.0,1,SWEET GLOBE,Clam
Agrolatina,24A8865270,01/28/2025,Sale,-400.0,80.0,1,SWEET GLOBE,Clam
Agrolatina,24A8865270,01/30/2025,Sale,-80.0,0.0,3,SWEET GLOBE,Clam
Agrolatina,24A8870791,01/10/2025,Entry,1520.0,1520.0,0,ALLISON,Clam
Agrolatina,24A8870791,01/10/2025,Entry,80.0,1600.0,0,ALLISON,Clam
Agrolatina,24A8870791,01/13/2025,Sale,-80.0,1520.0,3,ALLISON,Clam
Agrolatina,24A8870791,01/14/2025,Sale,-240.0,1280.0,4,ALLISON,Clam
Agrolatina,24A8870791,01/15/2025,Sale,-1280.0,0.0,5,ALLISON,Clam
Agrolatina,24A8871360,01/03/2025,Entry,1600.0,1600.0,0,ALLISON,Clam
Agrolatina,24A8871360,01/18/2025,Sale,-1040.0,560.0,15,ALLISON,Clam
Agrolatina,24A8871360,01/18/2025,Sale,-560.0,0.0,15,ALLISON,Clam
Agrolatina,24A8872738,02/17/2025,Entry,1280.0,1280.0,0,IVORY,Clam
Agrolatina,24A8872738,02/17/2025,Entry,320.0,1600.0,0,IVORY,Clam
Agrolatina,24A8872738,02/25/2025,Sale,-160.0,1440.0,8,IVORY,Clam
Agrolatina,24A8872738,02/25/2025,Sale,-400.0,1040.0,8,IVORY,Clam
Agrolatina,24A8872738,02/25/2025,Sale,-80.0,960.0,8,IVORY,Clam
Agrolatina,24A8872738,02/26/2025,Sale,-80.0,880.0,9,IVORY,Clam
Agrolatina,24A8872738,02/26/2025,Sale,-240.0,640.0,9,IVORY,Clam
Agrolatina,24A8872738,03/27/2025,Sale,-165.0,475.0,38,IVORY,Clam
Agrolatina,24A8872738,03/28/2025,Sale,-80.0,395.0,39,IVORY,Clam
Agrolatina,24A8872738,03/29/2025,Sale,-173.0,222.0,40,IVORY,Clam
Agrolatina,24A8872738,03/29/2025,Sale,-34.0,188.0,40,IVORY,Clam
Agrolatina,24A8873547,01/17/2025,Entry,1280.0,1280.0,0,SWEET GLOBE,Clam
Agrolatina,24A8873547,01/17/2025,Entry,320.0,1600.0,0,SWEET GLOBE,Clam
Agrolatina,24A8873547,01/22/2025,Sale,-1280.0,320.0,5,SWEET GLOBE,Clam
Agrolatina,24A8873547,01/29/2025,Sale,-320.0,0.0,12,SWEET GLOBE,Clam
Agrolatina,24A8880931,01/10/2025,Entry,1280.0,1280.0,0,SWEET GLOBE,Clam
Agrolatina,24A8880931,01/10/2025,Entry,320.0,1600.0,0,SWEET GLOBE,Clam
Agrolatina,24A8880931,01/15/2025,Sale,-880.0,720.0,5,SWEET GLOBE,Clam
Agrolatina,24A8880931,01/15/2025,Sale,-400.0,320.0,5,SWEET GLOBE,Clam
Agrolatina,24A8880931,01/15/2025,Sale,-160.0,160.0,5,SWEET GLOBE,Clam
Agrolatina,24A8880931,01/15/2025,Sale,-160.0,0.0,5,SWEET GLOBE,Clam
Agrolatina,24A8886164,01/17/2025,Entry,1280.0,1280.0,0,SWEET GLOBE,Clam
Agrolatina,24A8886164,01/17/2025,Entry,320.0,1600.0,0,SWEET GLOBE,Clam
Agrolatina,24A8886164,01/23/2025,Sale,-640.0,960.0,6,SWEET GLOBE,Clam
Agrolatina,24A8886164,01/23/2025,Sale,-160.0,800.0,6,SWEET GLOBE,Clam
Agrolatina,24A8886164,01/25/2025,Sale,-480.0,320.0,8,SWEET GLOBE,Clam
Agrolatina,24A8886164,01/28/2025,Sale,-160.0,160.0,11,SWEET GLOBE,Clam
Agrolatina,24A8886164,01/29/2025,Sale,-80.0,80.0,12,SWEET GLOBE,Clam
Agrolatina,24A8886164,01/30/2025,Sale,-80.0,0.0,13,SWEET GLOBE,Clam
Agrolatina,24A8886328,01/31/2025,Entry,950.0,950.0,0,SWEET GLOBE,Bag
Agrolatina,24A8886328,01/31/2025,Entry,95.0,1045.0,0,SWEET GLOBE,Bag
Agrolatina,24A8886328,01/31/2025,Entry,855.0,1900.0,0,SWEET GLOBE,Bag
Agrolatina,24A8886328,03/10/2025,Sale,-760.0,1140.0,38,SWEET GLOBE,Bag
Agrolatina,24A8886328,03/10/2025,Sale,-95.0,1045.0,38,SWEET GLOBE,Bag
Agrolatina,24A8886328,03/10/2025,Sale,-95.0,950.0,38,SWEET GLOBE,Bag
Agrolatina,24A8886328,03/11/2025,Sale,-95.0,855.0,39,SWEET GLOBE,Bag
Agrolatina,24A8886328,03/19/2025,Sale,-855.0,0.0,47,SWEET GLOBE,Bag
Agrolatina,24A8894318,01/27/2025,Entry,1200.0,1200.0,0,SWEET GLOBE,Clam
Agrolatina,24A8894318,01/27/2025,Entry,400.0,1600.0,0,SWEET GLOBE,Clam
Agrolatina,24A8894318,01/29/2025,Sale,-1200.0,400.0,2,SWEET GLOBE,Clam
Agrolatina,24A8894318,01/30/2025,Sale,-400.0,0.0,3,SWEET GLOBE,Clam
Agrolatina,24A8897997,01/10/2025,Entry,240.0,240.0,0,IVORY,Clam
Agrolatina,24A8897997,01/10/2025,Entry,80.0,320.0,0,IVORY,Clam
Agrolatina,24A8897997,01/10/2025,Entry,720.0,1040.0,0,SWEET GLOBE,Clam
Agrolatina,24A8897997,01/10/2025,Entry,560.0,1600.0,0,SWEET GLOBE,Clam
Agrolatina,24A8897997,01/14/2025,Sale,-640.0,960.0,4,SWEET GLOBE,Clam
Agrolatina,24A8897997,01/14/2025,Sale,-560.0,400.0,4,SWEET GLOBE,Clam
Agrolatina,24A8897997,01/15/2025,Sale,-240.0,160.0,5,IVORY,Clam
Agrolatina,24A8897997,01/15/2025,Sale,-80.0,80.0,5,SWEET GLOBE,Clam
Agrolatina,24A8897997,02/04/2025,Sale,-80.0,0.0,25,IVORY,Clam
Agrolatina,24A8898015,01/10/2025,Entry,1520.0,1520.0,0,SWEET GLOBE,Clam
Agrolatina,24A8898015,01/10/2025,Entry,80.0,1600.0,0,SWEET GLOBE,Clam
Agrolatina,24A8898015,01/16/2025,Sale,-400.0,1200.0,6,SWEET GLOBE,Clam
Agrolatina,24A8898015,01/16/2025,Sale,-880.0,320.0,6,SWEET GLOBE,Clam
Agrolatina,24A8898015,01/17/2025,Sale,-240.0,80.0,7,SWEET GLOBE,Clam
Agrolatina,24A8898015,01/22/2025,Sale,-80.0,0.0,12,SWEET GLOBE,Clam
Agrolatina,24A8911705,03/07/2025,Entry,320.0,320.0,0,AUTUMN CRISP,Clam
Agrolatina,24A8911705,03/07/2025,Entry,1280.0,1600.0,0,AUTUMN CRISP,Clam
Agrolatina,24A8911705,04/01/2025,Sale,-320.0,1280.0,25,AUTUMN CRISP,Clam
Agrolatina,24A8911705,04/04/2025,Sale,-1280.0,0.0,28,AUTUMN CRISP,Clam
Agrolatina,24A8912089,01/27/2025,Entry,1600.0,1600.0,0,SWEET GLOBE,Clam
Agrolatina,24A8912089,01/28/2025,Sale,-80.0,1520.0,1,SWEET GLOBE,Clam
Agrolatina,24A8912089,01/29/2025,Sale,-80.0,1440.0,2,SWEET GLOBE,Clam
Agrolatina,24A8912089,01/29/2025,Sale,-80.0,1360.0,2,SWEET GLOBE,Clam
Agrolatina,24A8912089,01/30/2025,Sale,-1360.0,0.0,3,SWEET GLOBE,Clam
Agrolatina,24A8912661,02/06/2025,Entry,800.0,800.0,0,SWEET GLOBE,Clam
Agrolatina,24A8912661,02/06/2025,Entry,800.0,1600.0,0,SWEET GLOBE,Clam
Agrolatina,24A8912661,02/08/2025,Sale,-80.0,1520.0,2,SWEET GLOBE,Clam
Agrolatina,24A8912661,02/10/2025,Sale,-160.0,1360.0,4,SWEET GLOBE,Clam
Agrolatina,24A8912661,02/11/2025,Sale,-80.0,1280.0,5,SWEET GLOBE,Clam
Agrolatina,24A8912661,02/11/2025,Sale,-240.0,1040.0,5,SWEET GLOBE,Clam
Agrolatina,24A8912661,02/17/2025,Sale,-160.0,880.0,11,SWEET GLOBE,Clam
Agrolatina,24A8912661,02/18/2025,Sale,-160.0,720.0,12,SWEET GLOBE,Clam
Agrolatina,24A8912661,02/24/2025,Sale,-50.0,670.0,18,SWEET GLOBE,Clam
Agrolatina,24A8912661,02/28/2025,Sale,-90.0,580.0,22,SWEET GLOBE,Clam
Agrolatina,24A8912661,03/01/2025,Sale,-100.0,480.0,23,SWEET GLOBE,Clam
Agrolatina,24A8912661,03/05/2025,Sale,-60.0,420.0,27,SWEET GLOBE,Clam
Agrolatina,24A8912661,03/05/2025,Sale,-80.0,340.0,27,SWEET GLOBE,Clam
Agrolatina,24A8931050,03/04/2025,Entry,1120.0,1120.0,0,TIMCO,Clam
Agrolatina,24A8931050,03/04/2025,Entry,480.0,1600.0,0,TIMCO,Clam
Agrolatina,24A8931129,01/27/2025,Entry,1040.0,1040.0,0,IVORY,Clam
Agrolatina,24A8931129,01/27/2025,Entry,560.0,1600.0,0,IVORY,Clam
Agrolatina,24A8931129,01/28/2025,Sale,-1040.0,560.0,1,IVORY,Clam
Agrolatina,24A8931129,01/28/2025,Sale,-480.0,80.0,1,IVORY,Clam
Agrolatina,24A8931129,01/29/2025,Sale,-80.0,0.0,2,IVORY,Clam
Agrolatina,24A8931445,02/05/2025,Entry,880.0,880.0,0,SWEET GLOBE,Clam
Agrolatina,24A8931445,02/05/2025,Entry,720.0,1600.0,0,SWEET GLOBE,Clam
Agrolatina,24A8931445,02/08/2025,Sale,-160.0,1440.0,3,SWEET GLOBE,Clam
Agrolatina,24A8931445,02/11/2025,Sale,-80.0,1360.0,6,SWEET GLOBE,Clam
Agrolatina,24A8931445,02/11/2025,Sale,-80.0,1280.0,6,SWEET GLOBE,Clam
Agrolatina,24A8931445,02/18/2025,Sale,-480.0,800.0,13,SWEET GLOBE,Clam
Agrolatina,24A8931445,02/20/2025,Sale,-80.0,720.0,15,SWEET GLOBE,Clam
Agrolatina,24A8931445,02/20/2025,Sale,-80.0,640.0,15,SWEET GLOBE,Clam
Agrolatina,24A8931445,02/22/2025,Sale,-80.0,560.0,17,SWEET GLOBE,Clam
Agrolatina,24A8931445,02/22/2025,Sale,-60.0,500.0,17,SWEET GLOBE,Clam
Agrolatina,24A8931445,02/22/2025,Sale,-10.0,490.0,17,SWEET GLOBE,Clam
Agrolatina,24A8931445,02/24/2025,Sale,-80.0,410.0,19,SWEET GLOBE,Clam
Agrolatina,24A8931445,02/25/2025,Sale,-65.0,345.0,20,SWEET GLOBE,Clam
Agrolatina,24A8931445,02/26/2025,Sale,-60.0,285.0,21,SWEET GLOBE,Clam
Agrolatina,24A8931445,03/01/2025,Sale,-80.0,205.0,24,SWEET GLOBE,Clam
Agrolatina,24A8931445,03/04/2025,Sale,-40.0,165.0,27,SWEET GLOBE,Clam
Agrolatina,24A8931445,03/05/2025,Sale,-40.0,125.0,28,SWEET GLOBE,Clam
Agrolatina,24A8936874,03/04/2025,Entry,1280.0,1280.0,0,IVORY,Clam
Agrolatina,24A8936874,03/04/2025,Entry,320.0,1600.0,0,IVORY,Clam
Agrolatina,24A8936874,03/22/2025,Sale,-40.0,1560.0,18,IVORY,Clam
Agrolatina,24A8936874,03/22/2025,Sale,-60.0,1500.0,18,IVORY,Clam
Agrolatina,24A8936874,03/22/2025,Sale,-20.0,1480.0,18,IVORY,Clam
Agrolatina,24A8936874,03/25/2025,Sale,-120.0,1360.0,21,IVORY,Clam
Agrolatina,24A8936874,03/26/2025,Sale,-80.0,1280.0,22,IVORY,Clam
Agrolatina,24A8936874,03/26/2025,Sale,-80.0,1200.0,22,IVORY,Clam
Agrolatina,24A8936874,03/27/2025,Sale,-560.0,640.0,23,IVORY,Clam
Agrolatina,24A8936874,03/27/2025,Sale,-80.0,560.0,23,IVORY,Clam
Agrolatina,24A8936874,03/29/2025,Sale,-20.0,540.0,25,IVORY,Clam
Agrolatina,24A8936874,03/29/2025,Sale,-40.0,500.0,25,IVORY,Clam
Agrolatina,24A8936874,03/31/2025,Sale,-160.0,340.0,27,IVORY,Clam
Agrolatina,24A8938389,03/09/2025,Entry,960.0,960.0,0,COTTON CANDY,Clam
Agrolatina,24A8938389,03/09/2025,Entry,640.0,1600.0,0,COTTON CANDY,Clam
Agrolatina,24A8938389,03/22/2025,Sale,-80.0,1520.0,13,COTTON CANDY,Clam
Agrolatina,24A8938389,03/28/2025,Sale,-160.0,1360.0,19,COTTON CANDY,Clam
Agrolatina,24A8938389,03/31/2025,Sale,-80.0,1280.0,22,COTTON CANDY,Clam
Agrolatina,24A8941791,02/14/2025,Entry,1280.0,1280.0,0,TIMCO,Clam
Agrolatina,24A8941791,02/14/2025,Entry,80.0,1360.0,0,TIMCO,Clam
Agrolatina,24A8941791,02/14/2025,Entry,240.0,1600.0,0,TIMCO,Clam
Agrolatina,24A8941791,03/14/2025,Sale,-80.0,1520.0,28,TIMCO,Clam
Agrolatina,24A8941791,03/15/2025,Sale,-720.0,800.0,29,TIMCO,Clam
Agrolatina,24A8941791,03/17/2025,Sale,-240.0,560.0,31,TIMCO,Clam
Agrolatina,24A8941791,03/20/2025,Sale,-560.0,0.0,34,TIMCO,Clam
Agrolatina,24A8944661,02/14/2025,Entry,1120.0,1120.0,0,TIMCO,Clam
Agrolatina,24A8944661,02/14/2025,Entry,480.0,1600.0,0,TIMCO,Clam
Agrolatina,24A8944661,03/01/2025,Sale,-400.0,1200.0,15,TIMCO,Clam
Agrolatina,24A8944661,03/12/2025,Sale,-720.0,480.0,26,TIMCO,Clam
Agrolatina,24A8944661,03/27/2025,Sale,-480.0,0.0,41,TIMCO,Clam
Agrolatina,24A8946258,02/14/2025,Entry,1120.0,1120.0,0,TIMCO,Clam
Agrolatina,24A8946258,02/14/2025,Entry,400.0,1520.0,0,TIMCO,Clam
Agrolatina,24A8946258,02/14/2025,Entry,80.0,1600.0,0,TIMCO,Clam
Agrolatina,24A8946258,03/14/2025,Sale,-400.0,1200.0,28,TIMCO,Clam
Agrolatina,24A8946258,03/17/2025,Sale,-80.0,1120.0,31,TIMCO,Clam
Agrolatina,24A8946258,03/20/2025,Sale,-1120.0,0.0,34,TIMCO,Clam
Agrolatina,24A8947950,03/09/2025,Entry,850.0,850.0,0,SWEET FAVORS,Clam
Agrolatina,24A8947950,03/09/2025,Entry,850.0,1700.0,0,SWEET FAVORS,Clam
Agrolatina,24A8947950,03/13/2025,Sale,-85.0,1615.0,4,SWEET FAVORS,Clam
Agrolatina,24A8947950,03/19/2025,Sale,-85.0,1530.0,10,SWEET FAVORS,Clam
Agrolatina,24A8947950,03/24/2025,Sale,-85.0,1445.0,15,SWEET FAVORS,Clam
Agrolatina,24A8947950,03/28/2025,Sale,-85.0,1360.0,19,SWEET FAVORS,Clam
Agrolatina,24A8947950,03/28/2025,Sale,-30.0,1330.0,19,SWEET FAVORS,Clam
Agrolatina,24A8947950,03/29/2025,Sale,-85.0,1245.0,20,SWEET FAVORS,Clam
Agrolatina,24A8947950,03/29/2025,Sale,-255.0,990.0,20,SWEET FAVORS,Clam
Agrolatina,24A8947950,03/31/2025,Sale,-255.0,735.0,22,SWEET FAVORS,Clam
Agrolatina,24A8947950,03/31/2025,Sale,-85.0,650.0,22,SWEET FAVORS,Clam
Agrolatina,24A8947950,04/18/2025,Sale,-40.0,610.0,40,SWEET FAVORS,Clam
Agrolatina,24A8947950,04/24/2025,Sale,-40.0,570.0,46,SWEET FAVORS,Clam
Agrolatina,24A8947950,04/28/2025,Sale,-40.0,530.0,50,SWEET FAVORS,Clam
Agrolatina,24A8947950,05/01/2025,Sale,-45.0,485.0,53,SWEET FAVORS,Clam
Agrolatina,24A8948406,03/07/2025,Entry,1440.0,1440.0,0,TIMCO,Bag
Agrolatina,24A8948406,03/07/2025,Entry,80.0,1520.0,0,TIMCO,Bag
Agrolatina,24A8948406,03/07/2025,Entry,80.0,1600.0,0,TIMCO,Bag
Agrolatina,24A8949151,02/17/2025,Entry,1330.0,1330.0,0,IVORY,Bag
Agrolatina,24A8949151,02/17/2025,Entry,475.0,1805.0,0,IVORY,Bag
Agrolatina,24A8949151,02/17/2025,Entry,95.0,1900.0,0,IVORY,Bag
Agrolatina,24A8949151,03/01/2025,Sale,-285.0,1615.0,12,IVORY,Bag
Agrolatina,24A8949151,03/05/2025,Sale,-950.0,665.0,16,IVORY,Bag
Agrolatina,24A8949151,03/08/2025,Sale,-95.0,570.0,19,IVORY,Bag
Agrolatina,24A8949151,03/10/2025,Sale,-190.0,380.0,21,IVORY,Bag
Agrolatina,24A8949151,03/12/2025,Sale,-165.0,215.0,23,IVORY,Bag
Agrolatina,24A8949151,03/12/2025,Sale,-70.0,145.0,23,IVORY,Bag
Agrolatina,24A8950258,01/10/2025,Entry,1520.0,1520.0,0,SWEET GLOBE,Clam
Agrolatina,24A8950258,01/10/2025,Entry,80.0,1600.0,0,SWEET GLOBE,Clam
Agrolatina,24A8950258,01/16/2025,Sale,-480.0,1120.0,6,SWEET GLOBE,Clam
Agrolatina,24A8950258,01/16/2025,Sale,-1040.0,80.0,6,SWEET GLOBE,Clam
Agrolatina,24A8950258,01/22/2025,Sale,-80.0,0.0,12,SWEET GLOBE,Clam
Agrolatina,24A8952440,01/27/2025,Entry,1520.0,1520.0,0,SWEET GLOBE,Clam
Agrolatina,24A8952440,01/27/2025,Entry,80.0,1600.0,0,SWEET GLOBE,Clam
Agrolatina,24A8952440,01/29/2025,Sale,-1520.0,80.0,2,SWEET GLOBE,Clam
Agrolatina,24A8952440,01/30/2025,Sale,-80.0,0.0,3,SWEET GLOBE,Clam
Agrolatina,24A8954395,03/09/2025,Entry,1120.0,1120.0,0,IVORY,Clam
Agrolatina,24A8954395,03/09/2025,Entry,480.0,1600.0,0,IVORY,Clam
Agrolatina,24A8954395,03/14/2025,Sale,-400.0,1200.0,5,IVORY,Clam
Agrolatina,24A8954395,03/19/2025,Sale,-80.0,1120.0,10,IVORY,Clam
Agrolatina,24A8954395,03/24/2025,Sale,-80.0,1040.0,15,IVORY,Clam
Agrolatina,24A8954395,03/25/2025,Sale,-80.0,960.0,16,IVORY,Clam
Agrolatina,24A8954395,03/26/2025,Sale,-80.0,880.0,17,IVORY,Clam
Agrolatina,24A8954395,03/27/2025,Sale,-320.0,560.0,18,IVORY,Clam
Agrolatina,24A8954395,03/28/2025,Sale,-40.0,520.0,19,IVORY,Clam
Agrolatina,24A8954395,03/31/2025,Sale,-60.0,460.0,22,IVORY,Clam
Agrolatina,24A8954395,04/02/2025,Sale,-60.0,400.0,24,IVORY,Clam
Agrolatina,24A8957542,01/13/2025,Entry,1520.0,1520.0,0,CANDY SNAP,Clam
Agrolatina,24A8957542,01/13/2025,Entry,80.0,1600.0,0,CANDY SNAP,Clam
Agrolatina,24A8957542,01/27/2025,Sale,-160.0,1440.0,14,CANDY SNAP,Clam
Agrolatina,24A8957542,01/29/2025,Sale,-240.0,1200.0,16,CANDY SNAP,Clam
Agrolatina,24A8957542,01/29/2025,Sale,-240.0,960.0,16,CANDY SNAP,Clam
Agrolatina,24A8957542,01/29/2025,Sale,-240.0,720.0,16,CANDY SNAP,Clam
Agrolatina,24A8957542,01/29/2025,Sale,-160.0,560.0,16,CANDY SNAP,Clam
Agrolatina,24A8957542,01/31/2025,Sale,-80.0,480.0,18,CANDY SNAP,Clam
Agrolatina,24A8957542,01/31/2025,Sale,-400.0,80.0,18,CANDY SNAP,Clam
Agrolatina,24A8957542,02/03/2025,Sale,-80.0,0.0,21,CANDY SNAP,Clam
Agrolatina,24A8960385,03/04/2025,Entry,1120.0,1120.0,0,COTTON CANDY,Clam
Agrolatina,24A8960385,03/04/2025,Entry,480.0,1600.0,0,COTTON CANDY,Clam
Agrolatina,24A8960385,03/26/2025,Sale,-880.0,720.0,22,COTTON CANDY,Clam
Agrolatina,24A8960385,03/27/2025,Sale,-160.0,560.0,23,COTTON CANDY,Clam
Agrolatina,24A8960385,03/28/2025,Sale,-79.0,481.0,24,COTTON CANDY,Clam
Agrolatina,24A8960385,04/01/2025,Sale,-480.0,1.0,28,COTTON CANDY,Clam
Agrolatina,24A8961100,02/17/2025,Entry,1280.0,1280.0,0,IVORY,Clam
Agrolatina,24A8961100,02/17/2025,Entry,240.0,1520.0,0,IVORY,Clam
Agrolatina,24A8961100,02/17/2025,Entry,80.0,1600.0,0,IVORY,Clam
Agrolatina,24A8961100,03/04/2025,Sale,-160.0,1440.0,15,IVORY,Clam
Agrolatina,24A8961100,03/04/2025,Sale,-320.0,1120.0,15,IVORY,Clam
Agrolatina,24A8961100,03/11/2025,Sale,-80.0,1040.0,22,IVORY,Clam
Agrolatina,24A8961100,03/15/2025,Sale,-480.0,560.0,26,IVORY,Clam
Agrolatina,24A8961100,03/21/2025,Sale,-100.0,460.0,32,IVORY,Clam
Agrolatina,24A8961100,03/22/2025,Sale,-140.0,320.0,33,IVORY,Clam
Agrolatina,24A8961100,03/27/2025,Sale,-40.0,280.0,38,IVORY,Clam
Agrolatina,24A8961100,03/28/2025,Sale,-40.0,240.0,39,IVORY,Clam
Agrolatina,24A8961100,03/29/2025,Sale,-20.0,220.0,40,IVORY,Clam
Agrolatina,24A8962670,02/26/2025,Entry,960.0,960.0,0,TIMCO,Clam
Agrolatina,24A8962670,02/26/2025,Entry,640.0,1600.0,0,TIMCO,Clam
Agrolatina,24A8962670,04/02/2025,Sale,-720.0,880.0,35,TIMCO,Clam
Agrolatina,24A8962670,04/02/2025,Sale,-240.0,640.0,35,TIMCO,Clam
Agrolatina,24A8962670,04/09/2025,Sale,-640.0,0.0,42,TIMCO,Clam
Agrolatina,24A8963674,12/27/2024,Entry,640.0,640.0,0,IVORY,Clam
Agrolatina,24A8963674,12/27/2024,Entry,880.0,1520.0,0,IVORY,Clam
Agrolatina,24A8963674,12/27/2024,Entry,80.0,1600.0,0,IVORY,Clam
Agrolatina,24A8963674,01/07/2025,Sale,-640.0,960.0,11,IVORY,Clam
Agrolatina,24A8963674,01/07/2025,Sale,-880.0,80.0,11,IVORY,Clam
Agrolatina,24A8963674,01/07/2025,Sale,-80.0,0.0,11,IVORY,Clam
Agrolatina,24A8963695,03/04/2025,Entry,1105.0,1105.0,0,SWEET GLOBE,Clam
Agrolatina,24A8963695,03/04/2025,Entry,595.0,1700.0,0,SWEET GLOBE,Clam
Agrolatina,24A8963695,03/19/2025,Sale,-595.0,1105.0,15,SWEET GLOBE,Clam
Agrolatina,24A8963695,03/19/2025,Sale,-170.0,935.0,15,SWEET GLOBE,Clam
Agrolatina,24A8963695,03/20/2025,Sale,-85.0,850.0,16,SWEET GLOBE,Clam
Agrolatina,24A8963695,04/03/2025,Sale,-270.0,580.0,30,SWEET GLOBE,Bag
Agrolatina,24A8963695,04/07/2025,Sale,-60.0,520.0,34,SWEET GLOBE,Bag
Agrolatina,24A8964631,01/17/2025,Entry,1120.0,1120.0,0,SWEET GLOBE,Clam
Agrolatina,24A8964631,01/17/2025,Entry,480.0,1600.0,0,SWEET GLOBE,Clam
Agrolatina,24A8964631,01/23/2025,Sale,-160.0,1440.0,6,SWEET GLOBE,Clam
Agrolatina,24A8964631,01/23/2025,Sale,-960.0,480.0,6,SWEET GLOBE,Clam
Agrolatina,24A8964631,01/25/2025,Sale,-80.0,400.0,8,SWEET GLOBE,Clam
Agrolatina,24A8964631,01/27/2025,Sale,-160.0,240.0,10,SWEET GLOBE,Clam
Agrolatina,24A8964631,01/30/2025,Sale,-240.0,0.0,13,SWEET GLOBE,Clam
Agrolatina,24A8968513,01/17/2025,Entry,1280.0,1280.0,0,CANDY DREAMS,Clam
Agrolatina,24A8968513,01/17/2025,Entry,320.0,1600.0,0,CANDY DREAMS,Clam
Agrolatina,24A8968513,01/25/2025,Sale,-240.0,1360.0,8,CANDY DREAMS,Clam
Agrolatina,24A8968513,01/27/2025,Sale,-960.0,400.0,10,CANDY DREAMS,Clam
Agrolatina,24A8968513,01/27/2025,Sale,-80.0,320.0,10,CANDY DREAMS,Clam
Agrolatina,24A8968513,02/25/2025,Sale,-258.0,62.0,39,CANDY DREAMS,Clam
Agrolatina,24A8968513,03/01/2025,Sale,-31.0,31.0,43,CANDY DREAMS,Clam
Agrolatina,24A8970378,01/17/2025,Entry,560.0,560.0,0,ALLISON,Clam
Agrolatina,24A8970378,01/17/2025,Entry,1040.0,1600.0,0,ALLISON,Clam
Agrolatina,24A8970378,02/03/2025,Sale,-560.0,1040.0,17,ALLISON,Clam
Agrolatina,24A8970378,02/03/2025,Sale,-1040.0,0.0,17,ALLISON,Clam
Agrolatina,24A8972920,01/27/2025,Entry,1040.0,1040.0,0,SWEET GLOBE,Clam
Agrolatina,24A8972920,01/27/2025,Entry,560.0,1600.0,0,SWEET GLOBE,Clam
Agrolatina,24A8972920,01/29/2025,Sale,-400.0,1200.0,2,SWEET GLOBE,Clam
Agrolatina,24A8972920,01/29/2025,Sale,-560.0,640.0,2,SWEET GLOBE,Clam
Agrolatina,24A8972920,01/30/2025,Sale,-640.0,0.0,3,SWEET GLOBE,Clam
Agrolatina,24A8987300,03/09/2025,Entry,1440.0,1440.0,0,IVORY,Clam
Agrolatina,24A8987300,03/09/2025,Entry,160.0,1600.0,0,IVORY,Clam
Agrolatina,24A8987300,03/12/2025,Sale,-80.0,1520.0,3,IVORY,Clam
Agrolatina,24A8987300,03/12/2025,Sale,-240.0,1280.0,3,IVORY,Clam
Agrolatina,24A8987300,03/12/2025,Sale,-720.0,560.0,3,IVORY,Clam
Agrolatina,24A8987300,03/12/2025,Sale,-80.0,480.0,3,IVORY,Clam
Agrolatina,24A8987300,03/22/2025,Sale,-60.0,420.0,13,IVORY,Clam
Agrolatina,24A8987300,03/22/2025,Sale,-40.0,380.0,13,IVORY,Clam
Agrolatina,24A8987300,04/01/2025,Sale,-40.0,340.0,23,IVORY,Clam
Agrolatina,24A8987300,04/02/2025,Sale,-20.0,320.0,24,IVORY,Clam
Agrolatina,24A8987300,04/03/2025,Sale,-4.0,316.0,25,IVORY,Clam
Agrolatina,24A8987300,04/04/2025,Sale,-21.0,295.0,26,IVORY,Clam
Agrolatina,24A8987300,04/05/2025,Sale,-80.0,215.0,27,IVORY,Clam
Agrolatina,24A8987300,04/07/2025,Sale,-9.0,206.0,29,IVORY,Clam
Agrolatina,24A8997735,02/10/2025,Entry,1280.0,1280.0,0,SWEET FAVORS,Clam
Agrolatina,24A8997735,02/10/2025,Entry,320.0,1600.0,0,SWEET FAVORS,Clam
Agrolatina,24A8997735,03/17/2025,Sale,-320.0,1280.0,35,SWEET FAVORS,Clam
Agrolatina,24A8997735,03/21/2025,Sale,-880.0,400.0,39,SWEET FAVORS,Clam
Agrolatina,24A8997735,03/27/2025,Sale,-400.0,0.0,45,SWEET FAVORS,Clam
Agrolatina,24A9001013,03/10/2025,Entry,1360.0,1360.0,0,TIMCO,Clam
Agrolatina,24A9001013,03/10/2025,Entry,240.0,1600.0,0,TIMCO,Clam
Agrolatina,24A9001013,04/14/2025,Sale,-480.0,1120.0,35,TIMCO,Clam
Agrolatina,24A9001013,04/15/2025,Sale,-880.0,240.0,36,TIMCO,Clam
Agrolatina,24A9001013,04/18/2025,Sale,-197.0,43.0,39,TIMCO,Clam
Agrolatina,24A9001862,01/03/2025,Entry,1200.0,1200.0,0,SWEET GLOBE,Clam
Agrolatina,24A9001862,01/03/2025,Entry,400.0,1600.0,0,SWEET GLOBE,Clam
Agrolatina,24A9001862,01/29/2025,Sale,-80.0,1520.0,26,SWEET GLOBE,Clam
Agrolatina,24A9001862,01/29/2025,Sale,-320.0,1200.0,26,SWEET GLOBE,Clam
Agrolatina,24A9001862,01/29/2025,Sale,-160.0,1040.0,26,SWEET GLOBE,Clam
Agrolatina,24A9001862,01/30/2025,Sale,-640.0,400.0,27,SWEET GLOBE,Clam
Agrolatina,24A9001862,02/12/2025,Sale,-240.0,160.0,40,SWEET GLOBE,Clam
Agrolatina,24A9001862,02/13/2025,Sale,-160.0,0.0,41,SWEET GLOBE,Clam
Agrolatina,24A9005687,02/20/2025,Entry,720.0,720.0,0,SWEET GLOBE,Clam
Agrolatina,24A9005687,02/20/2025,Entry,880.0,1600.0,0,SWEET GLOBE,Clam
Agrolatina,24A9005687,03/01/2025,Sale,-80.0,1520.0,9,SWEET GLOBE,Clam
Agrolatina,24A9005687,03/03/2025,Sale,-560.0,960.0,11,SWEET GLOBE,Clam
Agrolatina,24A9005687,03/03/2025,Sale,-480.0,480.0,11,SWEET GLOBE,Clam
Agrolatina,24A9005687,03/06/2025,Sale,-60.0,420.0,14,SWEET GLOBE,Clam
Agrolatina,24A9005687,03/06/2025,Sale,-60.0,360.0,14,SWEET GLOBE,Clam
Agrolatina,24A9005687,03/10/2025,Sale,-120.0,240.0,18,SWEET GLOBE,Clam
Agrolatina,24A9005687,03/11/2025,Sale,-100.0,140.0,19,SWEET GLOBE,Clam
Agrolatina,24A9005687,03/12/2025,Sale,-10.0,130.0,20,SWEET GLOBE,Clam
Agrolatina,24A9006519,01/03/2025,Entry,1360.0,1360.0,0,CANDY SNAP,Clam
Agrolatina,24A9006519,01/03/2025,Entry,240.0,1600.0,0,CANDY SNAP,Clam
Agrolatina,24A9006519,01/17/2025,Sale,-400.0,1200.0,14,CANDY SNAP,Clam
Agrolatina,24A9006519,01/18/2025,Sale,-80.0,1120.0,15,CANDY SNAP,Clam
Agrolatina,24A9006519,01/18/2025,Sale,-320.0,800.0,15,CANDY SNAP,Clam
Agrolatina,24A9006519,01/18/2025,Sale,-560.0,240.0,15,CANDY SNAP,Clam
Agrolatina,24A9006519,01/18/2025,Sale,-160.0,80.0,15,CANDY SNAP,Clam
Agrolatina,24A9006519,01/21/2025,Sale,-80.0,0.0,18,CANDY SNAP,Clam
Agrolatina,24A9007776,03/10/2025,Entry,1600.0,1600.0,0,AUTUMN CRISP,Clam
Agrolatina,24A9008056,02/14/2025,Entry,400.0,400.0,0,AUTUMN CRISP,Clam
Agrolatina,24A9008056,02/14/2025,Entry,1200.0,1600.0,0,AUTUMN CRISP,Clam
Agrolatina,24A9008056,03/07/2025,Sale,-160.0,1440.0,21,AUTUMN CRISP,Clam
Agrolatina,24A9008056,03/08/2025,Sale,-240.0,1200.0,22,AUTUMN CRISP,Clam
Agrolatina,24A9008056,03/22/2025,Sale,-1200.0,0.0,36,AUTUMN CRISP,Clam
Agrolatina,24A9011055,02/17/2025,Entry,720.0,720.0,0,IVORY,Clam
Agrolatina,24A9011055,02/17/2025,Entry,880.0,1600.0,0,IVORY,Clam
Agrolatina,24A9011055,03/04/2025,Sale,-320.0,1280.0,15,IVORY,Clam
Agrolatina,24A9011055,03/04/2025,Sale,-160.0,1120.0,15,IVORY,Clam
Agrolatina,24A9011055,03/04/2025,Sale,-880.0,240.0,15,IVORY,Clam
Agrolatina,24A9011055,03/22/2025,Sale,-80.0,160.0,33,IVORY,Clam
Agrolatina,24A9013436,02/11/2025,Entry,1280.0,1280.0,0,TIMCO,Clam
Agrolatina,24A9013436,02/11/2025,Entry,320.0,1600.0,0,TIMCO,Clam
Agrolatina,24A9013436,03/10/2025,Sale,-560.0,1040.0,27,TIMCO,Clam
Agrolatina,24A9013436,03/11/2025,Sale,-720.0,320.0,28,TIMCO,Clam
Agrolatina,24A9013436,03/14/2025,Sale,-320.0,0.0,31,TIMCO,Clam
Agrolatina,24A9015491,01/03/2025,Entry,1120.0,1120.0,0,SWEET GLOBE,Clam
Agrolatina,24A9015491,01/03/2025,Entry,480.0,1600.0,0,SWEET GLOBE,Clam
Agrolatina,24A9015491,01/16/2025,Sale,-160.0,1440.0,13,SWEET GLOBE,Clam
Agrolatina,24A9015491,01/16/2025,Sale,-480.0,960.0,13,SWEET GLOBE,Clam
Agrolatina,24A9015491,01/16/2025,Sale,-320.0,640.0,13,SWEET GLOBE,Clam
Agrolatina,24A9015491,01/17/2025,Sale,-80.0,560.0,14,SWEET GLOBE,Clam
Agrolatina,24A9015491,01/21/2025,Sale,-160.0,400.0,18,SWEET GLOBE,Clam
Agrolatina,24A9015491,01/21/2025,Sale,-320.0,80.0,18,SWEET GLOBE,Clam
Agrolatina,24A9015491,01/30/2025,Sale,-80.0,0.0,27,SWEET GLOBE,Clam
Agrolatina,24A9018232,01/03/2025,Entry,1040.0,1040.0,0,SWEET GLOBE,Clam
Agrolatina,24A9018232,01/03/2025,Entry,560.0,1600.0,0,SWEET GLOBE,Clam
Agrolatina,24A9018232,01/17/2025,Sale,-400.0,1200.0,14,SWEET GLOBE,Clam
Agrolatina,24A9018232,01/20/2025,Sale,-400.0,800.0,17,SWEET GLOBE,Clam
Agrolatina,24A9018232,01/21/2025,Sale,-160.0,640.0,18,SWEET GLOBE,Clam
Agrolatina,24A9018232,01/21/2025,Sale,-320.0,320.0,18,SWEET GLOBE,Clam
Agrolatina,24A9018232,01/21/2025,Sale,-160.0,160.0,18,SWEET GLOBE,Clam
Agrolatina,24A9018232,01/21/2025,Sale,-80.0,80.0,18,SWEET GLOBE,Clam
Agrolatina,24A9018232,01/27/2025,Sale,-80.0,0.0,24,SWEET GLOBE,Clam
Agrolatina,24A9020950,01/03/2025,Entry,1280.0,1280.0,0,SWEET GLOBE,Clam
Agrolatina,24A9020950,01/03/2025,Entry,320.0,1600.0,0,SWEET GLOBE,Clam
Agrolatina,24A9020950,01/27/2025,Sale,-80.0,1520.0,24,SWEET GLOBE,Clam
Agrolatina,24A9020950,01/27/2025,Sale,-80.0,1440.0,24,SWEET GLOBE,Clam
Agrolatina,24A9020950,01/28/2025,Sale,-160.0,1280.0,25,SWEET GLOBE,Clam
Agrolatina,24A9020950,01/28/2025,Sale,-160.0,1120.0,25,SWEET GLOBE,Clam
Agrolatina,24A9020950,01/29/2025,Sale,-640.0,480.0,26,SWEET GLOBE,Clam
Agrolatina,24A9020950,01/29/2025,Sale,-80.0,400.0,26,SWEET GLOBE,Clam
Agrolatina,24A9020950,01/30/2025,Sale,-80.0,320.0,27,SWEET GLOBE,Clam
Agrolatina,24A9020950,01/30/2025,Sale,-320.0,0.0,27,SWEET GLOBE,Clam
Agrolatina,24A9021597,01/03/2025,Entry,1520.0,1520.0,0,ALLISON,Clam
Agrolatina,24A9021597,01/03/2025,Entry,80.0,1600.0,0,ALLISON,Clam
Agrolatina,24A9021597,01/15/2025,Sale,-800.0,800.0,12,ALLISON,Clam
Agrolatina,24A9021597,01/15/2025,Sale,-80.0,720.0,12,ALLISON,Clam
Agrolatina,24A9021597,01/16/2025,Sale,-240.0,480.0,13,ALLISON,Clam
Agrolatina,24A9021597,01/17/2025,Sale,-400.0,80.0,14,ALLISON,Clam
Agrolatina,24A9021597,01/17/2025,Sale,-80.0,0.0,14,ALLISON,Clam
Agrolatina,24A9022007,02/07/2025,Entry,960.0,960.0,0,SWEET GLOBE,Clam
Agrolatina,24A9022007,02/07/2025,Entry,640.0,1600.0,0,SWEET GLOBE,Clam
Agrolatina,24A9022007,02/19/2025,Sale,-960.0,640.0,12,SWEET GLOBE,Clam
Agrolatina,24A9022007,02/24/2025,Sale,-640.0,0.0,17,SWEET GLOBE,Clam
Agrolatina,24A9022095,01/03/2025,Entry,960.0,960.0,0,IVORY,Clam
Agrolatina,24A9022095,01/03/2025,Entry,160.0,1120.0,0,IVORY,Clam
Agrolatina,24A9022095,01/03/2025,Entry,80.0,1200.0,0,IVORY,Clam
Agrolatina,24A9022095,01/03/2025,Entry,400.0,1600.0,0,SWEET GLOBE,Clam
Agrolatina,24A9022095,01/13/2025,Sale,-240.0,1360.0,10,SWEET GLOBE,Clam
Agrolatina,24A9022095,01/14/2025,Sale,-160.0,1200.0,11,SWEET GLOBE,Clam
Agrolatina,24A9022095,01/15/2025,Sale,-960.0,240.0,12,IVORY,Clam
Agrolatina,24A9022095,01/15/2025,Sale,-160.0,80.0,12,IVORY,Clam
Agrolatina,24A9022095,01/15/2025,Sale,-80.0,0.0,12,IVORY,Clam
Agrolatina,24A9022886,01/03/2025,Entry,1200.0,1200.0,0,SWEET GLOBE,Clam
Agrolatina,24A9022886,01/03/2025,Entry,160.0,1360.0,0,SWEET GLOBE,Clam
Agrolatina,24A9022886,01/03/2025,Entry,240.0,1600.0,0,SWEET GLOBE,Clam
Agrolatina,24A9022886,01/16/2025,Sale,-880.0,720.0,13,SWEET GLOBE,Clam
Agrolatina,24A9022886,01/16/2025,Sale,-80.0,640.0,13,SWEET GLOBE,Clam
Agrolatina,24A9022886,01/16/2025,Sale,-240.0,400.0,13,SWEET GLOBE,Clam
Agrolatina,24A9022886,01/16/2025,Sale,-80.0,320.0,13,SWEET GLOBE,Clam
Agrolatina,24A9022886,01/21/2025,Sale,-160.0,160.0,18,SWEET GLOBE,Clam
Agrolatina,24A9022886,01/21/2025,Sale,-80.0,80.0,18,SWEET GLOBE,Clam
Agrolatina,24A9022886,01/29/2025,Sale,-80.0,0.0,26,SWEET GLOBE,Clam
Agrolatina,24A9022947,03/10/2025,Entry,480.0,480.0,0,COTTON CANDY,Clam
Agrolatina,24A9022947,03/10/2025,Entry,1120.0,1600.0,0,COTTON CANDY,Clam
Agrolatina,24A9022947,03/17/2025,Sale,-160.0,1440.0,7,COTTON CANDY,Clam
Agrolatina,24A9022947,03/19/2025,Sale,-80.0,1360.0,9,COTTON CANDY,Clam
Agrolatina,24A9022947,03/21/2025,Sale,-50.0,1310.0,11,COTTON CANDY,Clam
Agrolatina,24A9022947,03/24/2025,Sale,-240.0,1070.0,14,COTTON CANDY,Clam
Agrolatina,24A9022947,03/27/2025,Sale,-400.0,670.0,17,COTTON CANDY,Clam
Agrolatina,24A9022968,01/03/2025,Entry,1360.0,1360.0,0,ALLISON,Clam
Agrolatina,24A9022968,01/03/2025,Entry,240.0,1600.0,0,ALLISON,Clam
Agrolatina,24A9022968,01/27/2025,Sale,-560.0,1040.0,24,ALLISON,Clam
Agrolatina,24A9022968,02/01/2025,Sale,-80.0,960.0,29,ALLISON,Clam
Agrolatina,24A9022968,02/05/2025,Sale,-240.0,720.0,33,ALLISON,Clam
Agrolatina,24A9022968,02/06/2025,Sale,-240.0,480.0,34,ALLISON,Clam
Agrolatina,24A9022968,02/08/2025,Sale,-320.0,160.0,36,ALLISON,Clam
Agrolatina,24A9022968,02/10/2025,Sale,-80.0,80.0,38,ALLISON,Clam
Agrolatina,24A9022968,02/12/2025,Sale,-80.0,0.0,40,ALLISON,Clam
Agrolatina,24A9025515,02/14/2025,Entry,800.0,800.0,0,TIMCO,Clam
Agrolatina,24A9025515,02/14/2025,Entry,800.0,1600.0,0,TIMCO,Clam
Agrolatina,24A9025515,03/13/2025,Sale,-560.0,1040.0,27,TIMCO,Clam
Agrolatina,24A9025515,03/14/2025,Sale,-720.0,320.0,28,TIMCO,Clam
Agrolatina,24A9025515,03/17/2025,Sale,-240.0,80.0,31,TIMCO,Clam
Agrolatina,24A9025515,03/27/2025,Sale,-80.0,0.0,41,TIMCO,Clam
Agrolatina,24A9026928,01/10/2025,Entry,960.0,960.0,0,CANDY SNAP,Clam
Agrolatina,24A9026928,01/10/2025,Entry,640.0,1600.0,0,CANDY SNAP,Clam
Agrolatina,24A9026928,01/13/2025,Sale,-960.0,640.0,3,CANDY SNAP,Clam
Agrolatina,24A9026928,01/13/2025,Sale,-80.0,560.0,3,CANDY SNAP,Clam
Agrolatina,24A9026928,01/13/2025,Sale,-560.0,0.0,3,CANDY SNAP,Clam
Agrolatina,24A9027626,01/17/2025,Entry,1440.0,1440.0,0,CANDY DREAMS,Clam
Agrolatina,24A9027626,01/17/2025,Entry,160.0,1600.0,0,CANDY DREAMS,Clam
Agrolatina,24A9027626,01/25/2025,Sale,-160.0,1440.0,8,CANDY DREAMS,Clam
Agrolatina,24A9027626,01/28/2025,Sale,-640.0,800.0,11,CANDY DREAMS,Clam
Agrolatina,24A9027626,01/30/2025,Sale,-400.0,400.0,13,CANDY DREAMS,Clam
Agrolatina,24A9027626,02/01/2025,Sale,-80.0,320.0,15,CANDY DREAMS,Clam
Agrolatina,24A9027626,02/01/2025,Sale,-80.0,240.0,15,CANDY DREAMS,Clam
Agrolatina,24A9027626,02/25/2025,Sale,-222.0,18.0,39,CANDY DREAMS,Clam
Agrolatina,24A9027626,03/01/2025,Sale,-6.0,12.0,43,CANDY DREAMS,Clam
Agrolatina,24A9027821,03/04/2025,Entry,1120.0,1120.0,0,IVORY,Clam
Agrolatina,24A9027821,03/04/2025,Entry,480.0,1600.0,0,IVORY,Clam
Agrolatina,24A9027821,03/21/2025,Sale,-240.0,1360.0,17,IVORY,Clam
Agrolatina,24A9027821,03/22/2025,Sale,-80.0,1280.0,18,IVORY,Clam
Agrolatina,24A9027821,03/28/2025,Sale,-40.0,1240.0,24,IVORY,Clam
Agrolatina,24A9027821,03/29/2025,Sale,-240.0,1000.0,25,IVORY,Clam
Agrolatina,24A9027821,03/29/2025,Sale,-40.0,960.0,25,IVORY,Clam
Agrolatina,24A9027821,03/31/2025,Sale,-45.0,915.0,27,IVORY,Clam
Agrolatina,24A9027821,03/31/2025,Sale,-120.0,795.0,27,IVORY,Clam
Agrolatina,24A9027821,04/02/2025,Sale,-80.0,715.0,29,IVORY,Clam
Agrolatina,24A9027821,04/02/2025,Sale,-40.0,675.0,29,IVORY,Clam
Agrolatina,24A9027821,04/03/2025,Sale,-160.0,515.0,30,IVORY,Clam
Agrolatina,24A9027821,04/07/2025,Sale,-60.0,455.0,34,IVORY,Clam
Agrolatina,24A9028550,01/03/2025,Entry,1360.0,1360.0,0,ALLISON,Clam
Agrolatina,24A9028550,01/03/2025,Entry,240.0,1600.0,0,ALLISON,Clam
Agrolatina,24A9028550,01/15/2025,Sale,-240.0,1360.0,12,ALLISON,Clam
Agrolatina,24A9028550,01/15/2025,Sale,-160.0,1200.0,12,ALLISON,Clam
Agrolatina,24A9028550,01/15/2025,Sale,-160.0,1040.0,12,ALLISON,Clam
Agrolatina,24A9028550,01/16/2025,Sale,-560.0,480.0,13,ALLISON,Clam
Agrolatina,24A9028550,01/16/2025,Sale,-320.0,160.0,13,ALLISON,Clam
Agrolatina,24A9028550,01/17/2025,Sale,-80.0,80.0,14,ALLISON,Clam
Agrolatina,24A9028550,01/17/2025,Sale,-80.0,0.0,14,ALLISON,Clam
Agrolatina,24A9028825,01/09/2025,Entry,1360.0,1360.0,0,SWEET GLOBE,Clam
Agrolatina,24A9028825,01/09/2025,Entry,160.0,1520.0,0,SWEET GLOBE,Clam
Agrolatina,24A9028825,01/09/2025,Entry,80.0,1600.0,0,SWEET GLOBE,Clam
Agrolatina,24A9028825,01/21/2025,Sale,-160.0,1440.0,12,SWEET GLOBE,Clam
Agrolatina,24A9028825,01/21/2025,Sale,-80.0,1360.0,12,SWEET GLOBE,Clam
Agrolatina,24A9028825,01/23/2025,Sale,-1360.0,0.0,14,SWEET GLOBE,Clam
Agrolatina,24A9032204,12/27/2024,Entry,1280.0,1280.0,0,SWEET GLOBE,Clam
Agrolatina,24A9032204,12/27/2024,Entry,160.0,1440.0,0,SWEET GLOBE,Clam
Agrolatina,24A9032204,12/27/2024,Entry,160.0,1600.0,0,SWEET GLOBE,Clam
Agrolatina,24A9032204,01/06/2025,Sale,-800.0,800.0,10,SWEET GLOBE,Clam
Agrolatina,24A9032204,01/07/2025,Sale,-80.0,720.0,11,SWEET GLOBE,Clam
Agrolatina,24A9032204,01/08/2025,Sale,-320.0,400.0,12,SWEET GLOBE,Clam
Agrolatina,24A9032204,01/08/2025,Sale,-160.0,240.0,12,SWEET GLOBE,Clam
Agrolatina,24A9032204,01/08/2025,Sale,-80.0,160.0,12,SWEET GLOBE,Clam
Agrolatina,24A9032204,01/09/2025,Sale,-80.0,80.0,13,SWEET GLOBE,Clam
Agrolatina,24A9032204,01/09/2025,Sale,-80.0,0.0,13,SWEET GLOBE,Clam
Agrolatina,24A9033900,01/03/2025,Entry,1520.0,1520.0,0,CANDY SNAP,Clam
Agrolatina,24A9033900,01/03/2025,Entry,80.0,1600.0,0,CANDY SNAP,Clam
Agrolatina,24A9033900,01/18/2025,Sale,-880.0,720.0,15,CANDY SNAP,Clam
Agrolatina,24A9033900,01/18/2025,Sale,-400.0,320.0,15,CANDY SNAP,Clam
Agrolatina,24A9033900,01/18/2025,Sale,-240.0,80.0,15,CANDY SNAP,Clam
Agrolatina,24A9033900,01/21/2025,Sale,-80.0,0.0,18,CANDY SNAP,Clam
Agrolatina,24A9034070,01/03/2025,Entry,1520.0,1520.0,0,CANDY SNAP,Clam
Agrolatina,24A9034070,01/03/2025,Entry,80.0,1600.0,0,CANDY SNAP,Clam
Agrolatina,24A9034070,01/29/2025,Sale,-160.0,1440.0,26,CANDY SNAP,Clam
Agrolatina,24A9034070,01/29/2025,Sale,-240.0,1200.0,26,CANDY SNAP,Clam
Agrolatina,24A9034070,01/31/2025,Sale,-480.0,720.0,28,CANDY SNAP,Clam
Agrolatina,24A9034070,01/31/2025,Sale,-560.0,160.0,28,CANDY SNAP,Clam
Agrolatina,24A9034070,01/31/2025,Sale,-80.0,80.0,28,CANDY SNAP,Clam
Agrolatina,24A9034070,02/03/2025,Sale,-80.0,0.0,31,CANDY SNAP,Clam
Agrolatina,24A9035311,01/03/2025,Entry,1520.0,1520.0,0,ALLISON,Clam
Agrolatina,24A9035311,01/03/2025,Entry,80.0,1600.0,0,ALLISON,Clam
Agrolatina,24A9035311,01/27/2025,Sale,-1040.0,560.0,24,ALLISON,Clam
Agrolatina,24A9035311,02/05/2025,Sale,-240.0,320.0,33,ALLISON,Clam
Agrolatina,24A9035311,02/10/2025,Sale,-240.0,80.0,38,ALLISON,Clam
Agrolatina,24A9035311,02/13/2025,Sale,-80.0,0.0,41,ALLISON,Clam
Agrolatina,24A9035902,01/03/2025,Entry,1440.0,1440.0,0,CANDY SNAP,Clam
Agrolatina,24A9035902,01/03/2025,Entry,160.0,1600.0,0,CANDY SNAP,Clam
Agrolatina,24A9035902,01/18/2025,Sale,-80.0,1520.0,15,CANDY SNAP,Clam
Agrolatina,24A9035902,01/18/2025,Sale,-80.0,1440.0,15,CANDY SNAP,Clam
Agrolatina,24A9035902,01/18/2025,Sale,-80.0,1360.0,15,CANDY SNAP,Clam
Agrolatina,24A9035902,01/18/2025,Sale,-240.0,1120.0,15,CANDY SNAP,Clam
Agrolatina,24A9035902,01/21/2025,Sale,-960.0,160.0,18,CANDY SNAP,Clam
Agrolatina,24A9035902,01/21/2025,Sale,-160.0,0.0,18,CANDY SNAP,Clam
Agrolatina,24A9042840,01/03/2025,Entry,1440.0,1440.0,0,SWEET GLOBE,Clam
Agrolatina,24A9042840,01/03/2025,Entry,160.0,1600.0,0,SWEET GLOBE,Clam
Agrolatina,24A9042840,01/27/2025,Sale,-80.0,1520.0,24,SWEET GLOBE,Clam
Agrolatina,24A9042840,01/28/2025,Sale,-320.0,1200.0,25,SWEET GLOBE,Clam
Agrolatina,24A9042840,01/29/2025,Sale,-400.0,800.0,26,SWEET GLOBE,Clam
Agrolatina,24A9042840,01/29/2025,Sale,-480.0,320.0,26,SWEET GLOBE,Clam
Agrolatina,24A9042840,01/30/2025,Sale,-240.0,80.0,27,SWEET GLOBE,Clam
Agrolatina,24A9042840,02/12/2025,Sale,-80.0,0.0,40,SWEET GLOBE,Clam
Agrolatina,24A9045078,02/20/2025,Entry,1120.0,1120.0,0,TIMCO,Clam
Agrolatina,24A9045078,02/20/2025,Entry,480.0,1600.0,0,TIMCO,Clam
Agrolatina,24A9045078,03/21/2025,Sale,-480.0,1120.0,29,TIMCO,Clam
Agrolatina,24A9045078,03/22/2025,Sale,-1120.0,0.0,30,TIMCO,Clam
Agrolatina,24A9045578,01/03/2025,Entry,1360.0,1360.0,0,ALLISON,Clam
Agrolatina,24A9045578,01/03/2025,Entry,240.0,1600.0,0,ALLISON,Clam
Agrolatina,24A9045578,02/03/2025,Sale,-160.0,1440.0,31,ALLISON,Clam
Agrolatina,24A9045578,02/05/2025,Sale,-640.0,800.0,33,ALLISON,Clam
Agrolatina,24A9045578,02/05/2025,Sale,-80.0,720.0,33,ALLISON,Clam
Agrolatina,24A9045578,02/05/2025,Sale,-240.0,480.0,33,ALLISON,Clam
Agrolatina,24A9045578,02/10/2025,Sale,-480.0,0.0,38,ALLISON,Clam
Agrolatina,24A9046957,03/01/2025,Sale,-80.0,-80.0,0,SWEET GLOBE,Clam
Agrolatina,24A9046957,03/01/2025,Sale,-800.0,-880.0,0,SWEET GLOBE,Clam
Agrolatina,24A9046957,03/01/2025,Sale,-640.0,-1520.0,0,SWEET GLOBE,Clam
Agrolatina,24A9046957,03/03/2025,Sale,-80.0,-1600.0,2,SWEET GLOBE,Clam
Agrolatina,24A9046957,03/04/2025,Entry,880.0,-720.0,3,SWEET GLOBE,Clam
Agrolatina,24A9046957,03/04/2025,Entry,720.0,0.0,3,SWEET GLOBE,Clam
Agrolatina,24A9050858,02/17/2025,Entry,1200.0,1200.0,0,IVORY,Clam
Agrolatina,24A9050858,02/17/2025,Entry,320.0,1520.0,0,IVORY,Clam
Agrolatina,24A9050858,02/17/2025,Entry,80.0,1600.0,0,IVORY,Clam
Agrolatina,24A9050858,03/11/2025,Sale,-160.0,1440.0,22,IVORY,Clam
Agrolatina,24A9050858,03/12/2025,Sale,-80.0,1360.0,23,IVORY,Clam
Agrolatina,24A9050858,03/12/2025,Sale,-400.0,960.0,23,IVORY,Clam
Agrolatina,24A9050858,03/15/2025,Sale,-80.0,880.0,26,IVORY,Clam
Agrolatina,24A9050858,03/26/2025,Sale,-160.0,720.0,37,IVORY,Clam
Agrolatina,24A9050858,03/27/2025,Sale,-80.0,640.0,38,IVORY,Clam
Agrolatina,24A9050858,03/27/2025,Sale,-40.0,600.0,38,IVORY,Clam
Agrolatina,24A9050858,03/29/2025,Sale,-40.0,560.0,40,IVORY,Clam
Agrolatina,24A9050858,03/29/2025,Sale,-20.0,540.0,40,IVORY,Clam
Agrolatina,24A9050858,03/31/2025,Sale,-120.0,420.0,42,IVORY,Clam
Agrolatina,24A9050858,04/01/2025,Sale,-80.0,340.0,43,IVORY,Clam
Agrolatina,24A9050858,04/01/2025,Sale,-40.0,300.0,43,IVORY,Clam
Agrolatina,24A9050858,04/02/2025,Sale,-20.0,280.0,44,IVORY,Clam
Agrolatina,24A9050858,04/02/2025,Sale,-40.0,240.0,44,IVORY,Clam
Agrolatina,24A9051004,03/04/2025,Entry,1360.0,1360.0,0,IVORY,Clam
Agrolatina,24A9051004,03/04/2025,Entry,240.0,1600.0,0,IVORY,Clam
Agrolatina,24A9051004,03/12/2025,Sale,-80.0,1520.0,8,IVORY,Clam
Agrolatina,24A9051004,03/12/2025,Sale,-80.0,1440.0,8,IVORY,Clam
Agrolatina,24A9051004,03/12/2025,Sale,-80.0,1360.0,8,IVORY,Clam
Agrolatina,24A9051004,03/12/2025,Sale,-160.0,1200.0,8,IVORY,Clam
Agrolatina,24A9051004,03/15/2025,Sale,-80.0,1120.0,11,IVORY,Clam
Agrolatina,24A9051004,03/21/2025,Sale,-80.0,1040.0,17,IVORY,Clam
Agrolatina,24A9051004,03/22/2025,Sale,-80.0,960.0,18,IVORY,Clam
Agrolatina,24A9051004,03/22/2025,Sale,-160.0,800.0,18,IVORY,Clam
Agrolatina,24A9051004,03/22/2025,Sale,-60.0,740.0,18,IVORY,Clam
Agrolatina,24A9051004,03/22/2025,Sale,-20.0,720.0,18,IVORY,Clam
Agrolatina,24A9051004,03/24/2025,Sale,-160.0,560.0,20,IVORY,Clam
Agrolatina,24A9051004,03/25/2025,Sale,-40.0,520.0,21,IVORY,Clam
Agrolatina,24A9051004,03/25/2025,Sale,-40.0,480.0,21,IVORY,Clam
Agrolatina,24A9051004,03/29/2025,Sale,-40.0,440.0,25,IVORY,Clam
Agrolatina,24A9051004,04/02/2025,Sale,-40.0,400.0,29,IVORY,Clam
Agrolatina,24A9051004,04/05/2025,Sale,-80.0,320.0,32,IVORY,Clam
Agrolatina,24A9051399,01/19/2025,Entry,160.0,160.0,0,CANDY SNAP,Clam
Agrolatina,24A9051399,01/19/2025,Entry,1440.0,1600.0,0,CANDY SNAP,Clam
Agrolatina,24A9051399,02/12/2025,Sale,-80.0,1520.0,24,CANDY SNAP,Clam
Agrolatina,24A9051399,02/17/2025,Sale,-80.0,1440.0,29,CANDY SNAP,Clam
Agrolatina,24A9051399,02/17/2025,Sale,-640.0,800.0,29,CANDY SNAP,Clam
Agrolatina,24A9051399,03/06/2025,Sale,-160.0,640.0,46,CANDY SNAP,Clam
Agrolatina,24A9051399,03/27/2025,Sale,-80.0,560.0,67,CANDY SNAP,Clam
Agrolatina,24A9051399,03/31/2025,Sale,-320.0,240.0,71,CANDY SNAP,Clam
Agrolatina,24A9055230,02/27/2025,Entry,560.0,560.0,0,CANDY DREAMS,Clam
Agrolatina,24A9055230,02/27/2025,Entry,1040.0,1600.0,0,CANDY DREAMS,Clam
Agrolatina,24A9055230,03/05/2025,Sale,-720.0,880.0,6,CANDY DREAMS,Clam
Agrolatina,24A9055230,03/29/2025,Sale,-80.0,800.0,30,CANDY DREAMS,Clam
Agrolatina,24A9055230,03/31/2025,Sale,-160.0,640.0,32,CANDY DREAMS,Clam
Agrolatina,24A9055230,04/01/2025,Sale,-320.0,320.0,33,CANDY DREAMS,Clam
Agrolatina,24A9062243,02/06/2025,Entry,320.0,320.0,0,SWEET GLOBE,Clam
Agrolatina,24A9062243,02/06/2025,Entry,1280.0,1600.0,0,SWEET GLOBE,Clam
Agrolatina,24A9062243,02/14/2025,Sale,-80.0,1520.0,8,SWEET GLOBE,Clam
Agrolatina,24A9062243,02/18/2025,Sale,-86.0,1434.0,12,SWEET GLOBE,Clam
Agrolatina,24A9062243,02/22/2025,Sale,-74.0,1360.0,16,SWEET GLOBE,Clam
Agrolatina,24A9062243,02/28/2025,Sale,-60.0,1300.0,22,SWEET GLOBE,Clam
Agrolatina,24A9062243,02/28/2025,Sale,-80.0,1220.0,22,SWEET GLOBE,Clam
Agrolatina,24A9062243,02/28/2025,Sale,-50.0,1170.0,22,SWEET GLOBE,Clam
Agrolatina,24A9062243,03/01/2025,Sale,-100.0,1070.0,23,SWEET GLOBE,Clam
Agrolatina,24A9062243,03/05/2025,Sale,-366.0,704.0,27,SWEET GLOBE,Clam
Agrolatina,24A9062243,03/05/2025,Sale,-80.0,624.0,27,SWEET GLOBE,Clam
Agrolatina,24A9066927,01/16/2025,Entry,80.0,80.0,0,CANDY SNAP,Clam
Agrolatina,24A9066927,01/16/2025,Entry,1520.0,1600.0,0,CANDY SNAP,Clam
Agrolatina,24A9066927,02/17/2025,Sale,-80.0,1520.0,32,CANDY SNAP,Clam
Agrolatina,24A9066927,02/17/2025,Sale,-240.0,1280.0,32,CANDY SNAP,Clam
Agrolatina,24A9066927,02/17/2025,Sale,-239.0,1041.0,32,CANDY SNAP,Clam
Agrolatina,24A9066927,02/19/2025,Sale,-140.0,901.0,34,CANDY SNAP,Clam
Agrolatina,24A9066927,02/20/2025,Sale,-720.0,181.0,35,CANDY SNAP,Clam
Agrolatina,24A9066927,02/26/2025,Sale,-20.0,161.0,41,CANDY SNAP,Clam
Agrolatina,24A9067076,03/04/2025,Entry,960.0,960.0,0,IVORY,Clam
Agrolatina,24A9067076,03/04/2025,Entry,560.0,1520.0,0,IVORY,Clam
Agrolatina,24A9067076,03/04/2025,Entry,80.0,1600.0,0,IVORY,Clam
Agrolatina,24A9067076,03/11/2025,Sale,-320.0,1280.0,7,IVORY,Clam
Agrolatina,24A9067076,03/21/2025,Sale,-20.0,1260.0,17,IVORY,Clam
Agrolatina,24A9067076,03/22/2025,Sale,-240.0,1020.0,18,IVORY,Clam
Agrolatina,24A9067076,03/22/2025,Sale,-120.0,900.0,18,IVORY,Clam
Agrolatina,24A9067076,03/25/2025,Sale,-200.0,700.0,21,IVORY,Clam
Agrolatina,24A9067076,03/26/2025,Sale,-240.0,460.0,22,IVORY,Clam
Agrolatina,24A9067076,03/27/2025,Sale,-60.0,400.0,23,IVORY,Clam
Agrolatina,24A9067076,03/28/2025,Sale,-40.0,360.0,24,IVORY,Clam
Agrolatina,24A9067076,03/28/2025,Sale,-40.0,320.0,24,IVORY,Clam
Agrolatina,24A9067076,03/29/2025,Sale,-40.0,280.0,25,IVORY,Clam
Agrolatina,24A9069505,03/17/2025,Entry,1600.0,1600.0,0,TIMCO,Clam
Agrolatina,24A9069505,04/01/2025,Sale,-960.0,640.0,15,TIMCO,Clam
Agrolatina,24A9069505,04/01/2025,Sale,-80.0,560.0,15,TIMCO,Clam
Agrolatina,24A9069505,04/05/2025,Sale,-160.0,400.0,19,TIMCO,Clam
Agrolatina,24A9069505,04/07/2025,Sale,-80.0,320.0,21,TIMCO,Clam
Agrolatina,24A9069505,04/10/2025,Sale,-160.0,160.0,24,TIMCO,Clam
Agrolatina,24A9069505,04/14/2025,Sale,-160.0,0.0,28,TIMCO,Clam
Agrolatina,24A9080947,02/13/2025,Entry,1120.0,1120.0,0,ALLISON,Clam
Agrolatina,24A9080947,02/13/2025,Entry,480.0,1600.0,0,ALLISON,Clam
Agrolatina,24A9080947,02/25/2025,Sale,-320.0,1280.0,12,ALLISON,Clam
Agrolatina,24A9080947,03/11/2025,Sale,-1040.0,240.0,26,ALLISON,Clam
Agrolatina,24A9080947,03/13/2025,Sale,-80.0,160.0,28,ALLISON,Clam
Agrolatina,24A9080947,03/13/2025,Sale,-80.0,80.0,28,ALLISON,Clam
Agrolatina,24A9080947,03/27/2025,Sale,-38.0,42.0,42,ALLISON,Clam
Agrolatina,24A9085001,03/04/2025,Entry,1040.0,1040.0,0,TIMCO,Clam
Agrolatina,24A9085001,03/04/2025,Entry,560.0,1600.0,0,TIMCO,Clam
Agrolatina,24A9085030,01/03/2025,Entry,1440.0,1440.0,0,SWEET GLOBE,Clam
Agrolatina,24A9085030,01/03/2025,Entry,160.0,1600.0,0,SWEET GLOBE,Clam
Agrolatina,24A9085030,01/20/2025,Sale,-80.0,1520.0,17,SWEET GLOBE,Clam
Agrolatina,24A9085030,01/21/2025,Sale,-560.0,960.0,18,SWEET GLOBE,Clam
Agrolatina,24A9085030,01/21/2025,Sale,-80.0,880.0,18,SWEET GLOBE,Clam
Agrolatina,24A9085030,01/21/2025,Sale,-80.0,800.0,18,SWEET GLOBE,Clam
Agrolatina,24A9085030,01/30/2025,Sale,-720.0,80.0,27,SWEET GLOBE,Clam
Agrolatina,24A9085030,01/31/2025,Sale,-80.0,0.0,28,SWEET GLOBE,Clam
Agrolatina,24A9085278,12/27/2024,Entry,1200.0,1200.0,0,SWEET GLOBE,Clam
Agrolatina,24A9085278,12/27/2024,Entry,240.0,1440.0,0,SWEET GLOBE,Clam
Agrolatina,24A9085278,12/27/2024,Entry,160.0,1600.0,0,SWEET GLOBE,Clam
Agrolatina,24A9085278,01/07/2025,Sale,-1120.0,480.0,11,SWEET GLOBE,Clam
Agrolatina,24A9085278,01/08/2025,Sale,-80.0,400.0,12,SWEET GLOBE,Clam
Agrolatina,24A9085278,01/08/2025,Sale,-240.0,160.0,12,SWEET GLOBE,Clam
Agrolatina,24A9085278,01/08/2025,Sale,-80.0,80.0,12,SWEET GLOBE,Clam
Agrolatina,24A9085278,01/09/2025,Sale,-80.0,0.0,13,SWEET GLOBE,Clam
Agrolatina,24A9086538,03/10/2025,Entry,960.0,960.0,0,TIMCO,Clam
Agrolatina,24A9086538,03/10/2025,Entry,640.0,1600.0,0,TIMCO,Clam
Agrolatina,24A9086538,04/22/2025,Sale,-160.0,1440.0,43,TIMCO,Clam
Agrolatina,24A9086538,04/22/2025,Sale,-640.0,800.0,43,TIMCO,Clam
Agrolatina,24A9086538,05/12/2025,Sale,-800.0,0.0,63,TIMCO,Clam
Agrolatina,24A9087140,01/21/2025,Entry,1280.0,1280.0,0,ALLISON,Clam
Agrolatina,24A9087140,01/21/2025,Entry,320.0,1600.0,0,ALLISON,Clam
Agrolatina,24A9087140,01/30/2025,Sale,-160.0,1440.0,9,ALLISON,Clam
Agrolatina,24A9087140,02/01/2025,Sale,-158.0,1282.0,11,ALLISON,Clam
Agrolatina,24A9087140,02/03/2025,Sale,-80.0,1202.0,13,ALLISON,Clam
Agrolatina,24A9087140,02/04/2025,Sale,-80.0,1122.0,14,ALLISON,Clam
Agrolatina,24A9087140,02/04/2025,Sale,-80.0,1042.0,14,ALLISON,Clam
Agrolatina,24A9087140,02/05/2025,Sale,-80.0,962.0,15,ALLISON,Clam
Agrolatina,24A9087140,02/05/2025,Sale,-160.0,802.0,15,ALLISON,Clam
Agrolatina,24A9087140,02/05/2025,Sale,-80.0,722.0,15,ALLISON,Clam
Agrolatina,24A9087140,02/06/2025,Sale,-80.0,642.0,16,ALLISON,Clam
Agrolatina,24A9087140,02/10/2025,Sale,-160.0,482.0,20,ALLISON,Clam
Agrolatina,24A9087140,02/12/2025,Sale,-160.0,322.0,22,ALLISON,Clam
Agrolatina,24A9087140,02/13/2025,Sale,-80.0,242.0,23,ALLISON,Clam
Agrolatina,24A9087140,02/14/2025,Sale,-160.0,82.0,24,ALLISON,Clam
Agrolatina,24A9087140,02/17/2025,Sale,-80.0,2.0,27,ALLISON,Clam
Agrolatina,24A9092269,03/04/2025,Entry,1440.0,1440.0,0,TIMCO,Clam
Agrolatina,24A9092269,03/04/2025,Entry,160.0,1600.0,0,TIMCO,Clam
Agrolatina,24A9092269,04/09/2025,Sale,-160.0,1440.0,36,TIMCO,Clam
Agrolatina,24A9092269,04/24/2025,Sale,-1200.0,240.0,51,TIMCO,Clam
Agrolatina,24A9092269,05/12/2025,Sale,-240.0,0.0,69,TIMCO,Clam
Agrolatina,24A9096182,02/13/2025,Entry,880.0,880.0,0,SWEET GLOBE,Clam
Agrolatina,24A9096182,02/13/2025,Entry,720.0,1600.0,0,SWEET GLOBE,Clam
Agrolatina,24A9096182,02/21/2025,Sale,-720.0,880.0,8,SWEET GLOBE,Clam
Agrolatina,24A9096182,02/22/2025,Sale,-240.0,640.0,9,SWEET GLOBE,Clam
Agrolatina,24A9096182,02/22/2025,Sale,-70.0,570.0,9,SWEET GLOBE,Clam
Agrolatina,24A9096182,02/26/2025,Sale,-55.0,515.0,13,SWEET GLOBE,Clam
Agrolatina,24A9096182,02/26/2025,Sale,-80.0,435.0,13,SWEET GLOBE,Clam
Agrolatina,24A9096182,02/27/2025,Sale,-80.0,355.0,14,SWEET GLOBE,Clam
Agrolatina,24A9096182,02/27/2025,Sale,-90.0,265.0,14,SWEET GLOBE,Clam
Agrolatina,24A9096182,03/01/2025,Sale,-80.0,185.0,16,SWEET GLOBE,Clam
Agrolatina,24A9096182,03/03/2025,Sale,-80.0,105.0,18,SWEET GLOBE,Clam
Agrolatina,24A9096182,03/11/2025,Sale,-60.0,45.0,26,SWEET GLOBE,Clam
Agrolatina,24A9102346,02/17/2025,Entry,1440.0,1440.0,0,IVORY,Clam
Agrolatina,24A9102346,02/17/2025,Entry,80.0,1520.0,0,IVORY,Clam
Agrolatina,24A9102346,02/17/2025,Entry,80.0,1600.0,0,IVORY,Clam
Agrolatina,24A9102346,03/04/2025,Sale,-320.0,1280.0,15,IVORY,Clam
Agrolatina,24A9102346,03/12/2025,Sale,-80.0,1200.0,23,IVORY,Clam
Agrolatina,24A9102346,03/15/2025,Sale,-800.0,400.0,26,IVORY,Clam
Agrolatina,24A9102346,03/15/2025,Sale,-80.0,320.0,26,IVORY,Clam
Agrolatina,24A9102346,03/22/2025,Sale,-100.0,220.0,33,IVORY,Clam
Agrolatina,24A9102346,03/24/2025,Sale,-20.0,200.0,35,IVORY,Clam
Agrolatina,24A9102346,03/27/2025,Sale,-70.0,130.0,38,IVORY,Clam
Agrolatina,24A9102346,03/29/2025,Sale,-40.0,90.0,40,IVORY,Clam
Agrolatina,24A9105238,02/24/2025,Entry,1200.0,1200.0,0,TIMCO,Clam
Agrolatina,24A9105238,02/24/2025,Entry,80.0,1280.0,0,TIMCO,Clam
Agrolatina,24A9105238,02/24/2025,Entry,320.0,1600.0,0,TIMCO,Clam
Agrolatina,24A9105238,03/17/2025,Sale,-160.0,1440.0,21,TIMCO,Clam
Agrolatina,24A9105238,03/18/2025,Sale,-160.0,1280.0,22,TIMCO,Clam
Agrolatina,24A9105238,04/20/2025,Sale,-840.0,440.0,55,TIMCO,Clam
Agrolatina,24A9105238,04/24/2025,Sale,-60.0,380.0,59,TIMCO,Clam
Agrolatina,24A9105238,04/24/2025,Sale,-241.0,139.0,59,TIMCO,Clam
Agrolatina,24A9111380,02/04/2025,Entry,960.0,960.0,0,AUTUMN CRISP,Clam
Agrolatina,24A9111380,02/04/2025,Entry,640.0,1600.0,0,AUTUMN CRISP,Clam
Agrolatina,24A9111380,03/01/2025,Sale,-960.0,640.0,25,AUTUMN CRISP,Clam
Agrolatina,24A9111380,03/03/2025,Sale,-320.0,320.0,27,AUTUMN CRISP,Clam
Agrolatina,24A9111380,03/05/2025,Sale,-320.0,0.0,29,AUTUMN CRISP,Clam
Agrolatina,24A9112072,01/18/2025,Entry,1520.0,1520.0,0,SWEET GLOBE,Clam
Agrolatina,24A9112072,01/18/2025,Entry,80.0,1600.0,0,SWEET GLOBE,Clam
Agrolatina,24A9112072,01/21/2025,Sale,-80.0,1520.0,3,SWEET GLOBE,Clam
Agrolatina,24A9112072,01/23/2025,Sale,-480.0,1040.0,5,SWEET GLOBE,Clam
Agrolatina,24A9112072,01/23/2025,Sale,-1040.0,0.0,5,SWEET GLOBE,Clam
Agrolatina,24A9115724,01/30/2025,Entry,1120.0,1120.0,0,SWEET GLOBE,Clam
Agrolatina,24A9115724,01/30/2025,Entry,480.0,1600.0,0,SWEET GLOBE,Clam
Agrolatina,24A9115724,02/05/2025,Sale,-1120.0,480.0,6,SWEET GLOBE,Clam
Agrolatina,24A9115724,02/05/2025,Sale,-480.0,0.0,6,SWEET GLOBE,Clam
Agrolatina,24A9116144,03/04/2025,Entry,1440.0,1440.0,0,TIMCO,Clam
Agrolatina,24A9116144,03/04/2025,Entry,80.0,1520.0,0,TIMCO,Clam
Agrolatina,24A9116144,03/04/2025,Entry,80.0,1600.0,0,TIMCO,Clam
Agrolatina,24A9116144,04/09/2025,Sale,-80.0,1520.0,36,TIMCO,Clam
Agrolatina,24A9116144,04/16/2025,Sale,-320.0,1200.0,43,TIMCO,Clam
Agrolatina,24A9116144,04/17/2025,Sale,-320.0,880.0,44,TIMCO,Clam
Agrolatina,24A9116144,04/20/2025,Sale,-40.0,840.0,47,TIMCO,Clam
Agrolatina,24A9116144,04/22/2025,Sale,-80.0,760.0,49,TIMCO,Clam
Agrolatina,24A9116144,04/24/2025,Sale,-40.0,720.0,51,TIMCO,Clam
Agrolatina,24A9116144,04/24/2025,Sale,-720.0,0.0,51,TIMCO,Clam
Agrolatina,24A9116227,02/10/2025,Entry,880.0,880.0,0,TIMCO,Clam
Agrolatina,24A9116227,02/10/2025,Entry,720.0,1600.0,0,TIMCO,Clam
Agrolatina,24A9116227,03/10/2025,Sale,-880.0,720.0,28,TIMCO,Clam
Agrolatina,24A9116227,03/11/2025,Sale,-720.0,0.0,29,TIMCO,Clam
Agrolatina,24A9116525,02/03/2025,Entry,960.0,960.0,0,SWEET GLOBE,Clam
Agrolatina,24A9116525,02/03/2025,Entry,640.0,1600.0,0,SWEET GLOBE,Clam
Agrolatina,24A9116525,02/13/2025,Sale,-160.0,1440.0,10,SWEET GLOBE,Clam
Agrolatina,24A9116525,02/18/2025,Sale,-480.0,960.0,15,SWEET GLOBE,Clam
Agrolatina,24A9116525,02/18/2025,Sale,-480.0,480.0,15,SWEET GLOBE,Clam
Agrolatina,24A9116525,02/19/2025,Sale,-480.0,0.0,16,SWEET GLOBE,Clam
Agrolatina,24A9116931,03/03/2025,Entry,1120.0,1120.0,0,TIMCO,Clam
Agrolatina,24A9116931,03/03/2025,Entry,480.0,1600.0,0,TIMCO,Clam
Agrolatina,24A9116931,03/27/2025,Sale,-1120.0,480.0,24,TIMCO,Clam
Agrolatina,24A9116931,04/06/2025,Sale,-480.0,0.0,34,TIMCO,Clam
Agrolatina,24A9117136,02/24/2025,Entry,1040.0,1040.0,0,COTTON CANDY,Clam
Agrolatina,24A9117136,02/24/2025,Entry,560.0,1600.0,0,COTTON CANDY,Clam
Agrolatina,24A9117136,02/25/2025,Sale,-1040.0,560.0,1,COTTON CANDY,Clam
Agrolatina,24A9117136,02/25/2025,Sale,-560.0,0.0,1,COTTON CANDY,Clam
Agrolatina,24A9117795,03/03/2025,Entry,400.0,400.0,0,AUTUMN CRISP,Clam
Agrolatina,24A9117795,03/03/2025,Entry,1200.0,1600.0,0,AUTUMN CRISP,Clam
Agrolatina,24A9117795,03/21/2025,Sale,-1200.0,400.0,18,AUTUMN CRISP,Clam
Agrolatina,24A9117795,03/27/2025,Sale,-400.0,0.0,24,AUTUMN CRISP,Clam
Agrolatina,24A9118092,02/10/2025,Entry,1200.0,1200.0,0,TIMCO,Clam
Agrolatina,24A9118092,02/10/2025,Entry,160.0,1360.0,0,TIMCO,Clam
Agrolatina,24A9118092,02/10/2025,Entry,240.0,1600.0,0,TIMCO,Clam
Agrolatina,24A9118092,02/22/2025,Sale,-320.0,1280.0,12,TIMCO,Clam
Agrolatina,24A9118092,03/04/2025,Sale,-80.0,1200.0,22,TIMCO,Clam
Agrolatina,24A9118092,03/04/2025,Sale,-160.0,1040.0,22,TIMCO,Clam
Agrolatina,24A9118092,03/06/2025,Sale,-80.0,960.0,24,TIMCO,Clam
Agrolatina,24A9118092,03/06/2025,Sale,-80.0,880.0,24,TIMCO,Clam
Agrolatina,24A9118092,03/06/2025,Sale,-240.0,640.0,24,TIMCO,Clam
Agrolatina,24A9118092,03/07/2025,Sale,-80.0,560.0,25,TIMCO,Clam
Agrolatina,24A9118092,03/10/2025,Sale,-80.0,480.0,28,TIMCO,Clam
Agrolatina,24A9118092,03/11/2025,Sale,-80.0,400.0,29,TIMCO,Clam
Agrolatina,24A9118092,03/12/2025,Sale,-80.0,320.0,30,TIMCO,Clam
Agrolatina,24A9118092,03/13/2025,Sale,-80.0,240.0,31,TIMCO,Clam
Agrolatina,24A9118092,03/15/2025,Sale,-80.0,160.0,33,TIMCO,Clam
Agrolatina,24A9118092,03/18/2025,Sale,-80.0,80.0,36,TIMCO,Clam
Agrolatina,24A9118092,03/20/2025,Sale,-80.0,0.0,38,TIMCO,Clam
Agrolatina,24A9118260,02/17/2025,Entry,960.0,960.0,0,SWEET GLOBE,Clam
Agrolatina,24A9118260,02/17/2025,Entry,640.0,1600.0,0,SWEET GLOBE,Clam
Agrolatina,24A9118260,03/06/2025,Sale,-80.0,1520.0,17,SWEET GLOBE,Clam
Agrolatina,24A9118260,03/08/2025,Sale,-160.0,1360.0,19,SWEET GLOBE,Clam
Agrolatina,24A9118260,03/08/2025,Sale,-720.0,640.0,19,SWEET GLOBE,Clam
Agrolatina,24A9118260,03/14/2025,Sale,-79.0,561.0,25,SWEET GLOBE,Clam
Agrolatina,24A9118260,03/15/2025,Sale,-230.0,331.0,26,SWEET GLOBE,Clam
Agrolatina,24A9118260,03/15/2025,Sale,-160.0,171.0,26,SWEET GLOBE,Clam
Agrolatina,24A9118657,02/24/2025,Entry,1440.0,1440.0,0,TIMCO,Clam
Agrolatina,24A9118657,02/24/2025,Entry,160.0,1600.0,0,TIMCO,Clam
Agrolatina,24A9118657,03/18/2025,Sale,-1440.0,160.0,22,TIMCO,Clam
Agrolatina,24A9118657,03/27/2025,Sale,-160.0,0.0,31,TIMCO,Clam
Agrolatina,24A9119099,01/28/2025,Entry,480.0,480.0,0,CANDY SNAP,Clam
Agrolatina,24A9119099,01/28/2025,Entry,1120.0,1600.0,0,CANDY SNAP,Clam
Agrolatina,24A9119099,01/30/2025,Sale,-80.0,1520.0,2,CANDY SNAP,Clam
Agrolatina,24A9119099,02/12/2025,Sale,-80.0,1440.0,15,CANDY SNAP,Clam
Agrolatina,24A9119099,02/13/2025,Sale,-80.0,1360.0,16,CANDY SNAP,Clam
Agrolatina,24A9119099,02/17/2025,Sale,-298.0,1062.0,20,CANDY SNAP,Clam
Agrolatina,24A9119099,02/17/2025,Sale,-800.0,262.0,20,CANDY SNAP,Clam
Agrolatina,24A9119099,02/17/2025,Sale,-80.0,182.0,20,CANDY SNAP,Clam
Agrolatina,24A9119099,02/17/2025,Sale,-21.0,161.0,20,CANDY SNAP,Clam
Agrolatina,24A9119592,03/10/2025,Entry,1200.0,1200.0,0,TIMCO,Clam
Agrolatina,24A9119592,03/10/2025,Entry,400.0,1600.0,0,TIMCO,Clam
Agrolatina,24A9119592,04/23/2025,Sale,-80.0,1520.0,44,TIMCO,Clam
Agrolatina,24A9119592,04/24/2025,Sale,-240.0,1280.0,45,TIMCO,Clam
Agrolatina,24A9119592,04/25/2025,Sale,-160.0,1120.0,46,TIMCO,Clam
Agrolatina,24A9120361,03/03/2025,Entry,560.0,560.0,0,AUTUMN CRISP,Clam
Agrolatina,24A9120361,03/03/2025,Entry,1040.0,1600.0,0,AUTUMN CRISP,Clam
Agrolatina,24A9120361,03/27/2025,Sale,-400.0,1200.0,24,AUTUMN CRISP,Clam
Agrolatina,24A9120361,03/27/2025,Sale,-1040.0,160.0,24,AUTUMN CRISP,Clam
Agrolatina,24A9120361,03/29/2025,Sale,-160.0,0.0,26,AUTUMN CRISP,Clam
Agrolatina,24A9122143,02/17/2025,Entry,1120.0,1120.0,0,SWEET GLOBE,Clam
Agrolatina,24A9122143,02/17/2025,Entry,480.0,1600.0,0,SWEET GLOBE,Clam
Agrolatina,24A9122143,03/08/2025,Sale,-80.0,1520.0,19,SWEET GLOBE,Clam
Agrolatina,24A9122143,03/08/2025,Sale,-400.0,1120.0,19,SWEET GLOBE,Clam
Agrolatina,24A9122143,03/10/2025,Sale,-60.0,1060.0,21,SWEET GLOBE,Clam
Agrolatina,24A9122143,03/11/2025,Sale,-80.0,980.0,22,SWEET GLOBE,Clam
Agrolatina,24A9122143,03/11/2025,Sale,-420.0,560.0,22,SWEET GLOBE,Clam
Agrolatina,24A9122143,03/11/2025,Sale,-260.0,300.0,22,SWEET GLOBE,Clam
Agrolatina,24A9122143,03/14/2025,Sale,-20.0,280.0,25,SWEET GLOBE,Clam
Agrolatina,24A9122143,03/14/2025,Sale,-40.0,240.0,25,SWEET GLOBE,Clam
Agrolatina,24A9122786,02/24/2025,Entry,240.0,240.0,0,AUTUMN CRISP,Clam
Agrolatina,24A9122786,02/24/2025,Entry,1360.0,1600.0,0,AUTUMN CRISP,Clam
Agrolatina,24A9122786,03/18/2025,Sale,-240.0,1360.0,22,AUTUMN CRISP,Clam
Agrolatina,24A9122786,03/24/2025,Sale,-1360.0,0.0,28,AUTUMN CRISP,Clam
Agrolatina,24A9124685,03/07/2025,Entry,1520.0,1520.0,0,TIMCO,Clam
Agrolatina,24A9124685,03/07/2025,Entry,80.0,1600.0,0,TIMCO,Clam
Agrolatina,24A9124936,01/19/2025,Entry,1200.0,1200.0,0,IVORY,Clam
Agrolatina,24A9124936,01/19/2025,Entry,160.0,1360.0,0,IVORY,Clam
Agrolatina,24A9124936,01/19/2025,Entry,240.0,1600.0,0,IVORY,Clam
Agrolatina,24A9124936,02/12/2025,Sale,-400.0,1200.0,24,IVORY,Clam
Agrolatina,24A9124936,02/12/2025,Sale,-80.0,1120.0,24,IVORY,Clam
Agrolatina,24A9124936,02/13/2025,Sale,-560.0,560.0,25,IVORY,Clam
Agrolatina,24A9124936,02/15/2025,Sale,-80.0,480.0,27,IVORY,Clam
Agrolatina,24A9124936,02/15/2025,Sale,-160.0,320.0,27,IVORY,Clam
Agrolatina,24A9124958,02/27/2025,Entry,640.0,640.0,0,SWEET GLOBE,Clam
Agrolatina,24A9124958,02/27/2025,Entry,960.0,1600.0,0,SWEET GLOBE,Clam
Agrolatina,24A9124958,03/11/2025,Sale,-40.0,1560.0,12,SWEET GLOBE,Clam
Agrolatina,24A9124958,03/11/2025,Sale,-180.0,1380.0,12,SWEET GLOBE,Clam
Agrolatina,24A9124958,03/11/2025,Sale,-120.0,1260.0,12,SWEET GLOBE,Clam
Agrolatina,24A9124958,03/11/2025,Sale,-40.0,1220.0,12,SWEET GLOBE,Clam
Agrolatina,24A9124958,03/13/2025,Sale,-60.0,1160.0,14,SWEET GLOBE,Clam
Agrolatina,24A9124958,03/14/2025,Sale,-180.0,980.0,15,SWEET GLOBE,Clam
Agrolatina,24A9124958,03/14/2025,Sale,-120.0,860.0,15,SWEET GLOBE,Clam
Agrolatina,24A9124958,03/15/2025,Sale,-80.0,780.0,16,SWEET GLOBE,Clam
Agrolatina,24A9124958,03/15/2025,Sale,-160.0,620.0,16,SWEET GLOBE,Clam
Agrolatina,24A9124958,03/15/2025,Sale,-120.0,500.0,16,SWEET GLOBE,Clam
Agrolatina,24A9124978,02/06/2025,Entry,1280.0,1280.0,0,CANDY DREAMS,Clam
Agrolatina,24A9124978,02/06/2025,Entry,320.0,1600.0,0,CANDY DREAMS,Clam
Agrolatina,24A9124978,02/10/2025,Sale,-480.0,1120.0,4,CANDY DREAMS,Clam
Agrolatina,24A9124978,02/10/2025,Sale,-80.0,1040.0,4,CANDY DREAMS,Clam
Agrolatina,24A9124978,02/11/2025,Sale,-80.0,960.0,5,CANDY DREAMS,Clam
Agrolatina,24A9124978,02/12/2025,Sale,-80.0,880.0,6,CANDY DREAMS,Clam
Agrolatina,24A9124978,02/13/2025,Sale,-560.0,320.0,7,CANDY DREAMS,Clam
Agrolatina,24A9124978,02/25/2025,Sale,-72.0,248.0,19,CANDY DREAMS,Clam
Agrolatina,24A9124978,02/25/2025,Sale,-80.0,168.0,19,CANDY DREAMS,Clam
Agrolatina,24A9124978,02/25/2025,Sale,-50.0,118.0,19,CANDY DREAMS,Clam
Agrolatina,24A9124978,02/25/2025,Sale,-50.0,68.0,19,CANDY DREAMS,Clam
Agrolatina,24A9124978,02/27/2025,Sale,-30.0,38.0,21,CANDY DREAMS,Clam
Agrolatina,24A9125043,02/04/2025,Entry,1280.0,1280.0,0,ALLISON,Clam
Agrolatina,24A9125043,02/04/2025,Entry,320.0,1600.0,0,ALLISON,Clam
Agrolatina,24A9125043,02/14/2025,Sale,-80.0,1520.0,10,ALLISON,Clam
Agrolatina,24A9125043,02/18/2025,Sale,-160.0,1360.0,14,ALLISON,Clam
Agrolatina,24A9125043,02/18/2025,Sale,-240.0,1120.0,14,ALLISON,Clam
Agrolatina,24A9125043,02/26/2025,Sale,-720.0,400.0,22,ALLISON,Clam
Agrolatina,24A9125043,03/04/2025,Sale,-400.0,0.0,28,ALLISON,Clam
Agrolatina,24A9133732,02/06/2025,Entry,1440.0,1440.0,0,ALLISON,Clam
Agrolatina,24A9133732,02/06/2025,Entry,160.0,1600.0,0,ALLISON,Clam
Agrolatina,24A9133732,02/27/2025,Sale,-80.0,1520.0,21,ALLISON,Clam
Agrolatina,24A9133732,03/04/2025,Sale,-80.0,1440.0,26,ALLISON,Clam
Agrolatina,24A9133732,03/05/2025,Sale,-80.0,1360.0,27,ALLISON,Clam
Agrolatina,24A9133732,03/08/2025,Sale,-80.0,1280.0,30,ALLISON,Clam
Agrolatina,24A9133732,03/10/2025,Sale,-1280.0,0.0,32,ALLISON,Clam
Agrolatina,24A9138800,02/04/2025,Entry,1200.0,1200.0,0,ALLISON,Clam
Agrolatina,24A9138800,02/04/2025,Entry,400.0,1600.0,0,ALLISON,Clam
Agrolatina,24A9138800,02/21/2025,Sale,-1200.0,400.0,17,ALLISON,Clam
Agrolatina,24A9138800,02/21/2025,Sale,-400.0,0.0,17,ALLISON,Clam
Agrolatina,24A9139878,02/04/2025,Entry,1280.0,1280.0,0,SWEET GLOBE,Clam
Agrolatina,24A9139878,02/04/2025,Entry,320.0,1600.0,0,SWEET GLOBE,Clam
Agrolatina,24A9139878,02/19/2025,Sale,-160.0,1440.0,15,SWEET GLOBE,Clam
Agrolatina,24A9139878,02/20/2025,Sale,-1040.0,400.0,16,SWEET GLOBE,Clam
Agrolatina,24A9139878,02/21/2025,Sale,-240.0,160.0,17,SWEET GLOBE,Clam
Agrolatina,24A9139878,02/25/2025,Sale,-160.0,0.0,21,SWEET GLOBE,Clam
Agrolatina,24A9140460,02/24/2025,Entry,400.0,400.0,0,SWEET GLOBE,Clam
Agrolatina,24A9140460,02/24/2025,Entry,1200.0,1600.0,0,SWEET GLOBE,Clam
Agrolatina,24A9140460,03/05/2025,Sale,-160.0,1440.0,9,SWEET GLOBE,Clam
Agrolatina,24A9140460,03/07/2025,Sale,-80.0,1360.0,11,SWEET GLOBE,Clam
Agrolatina,24A9140460,03/08/2025,Sale,-80.0,1280.0,12,SWEET GLOBE,Clam
Agrolatina,24A9140460,03/08/2025,Sale,-160.0,1120.0,12,SWEET GLOBE,Clam
Agrolatina,24A9140460,03/10/2025,Sale,-80.0,1040.0,14,SWEET GLOBE,Clam
Agrolatina,24A9140460,03/10/2025,Sale,-160.0,880.0,14,SWEET GLOBE,Clam
Agrolatina,24A9140460,03/13/2025,Sale,-60.0,820.0,17,SWEET GLOBE,Clam
Agrolatina,24A9140460,03/14/2025,Sale,-60.0,760.0,18,SWEET GLOBE,Clam
Agrolatina,24A9140460,03/15/2025,Sale,-280.0,480.0,19,SWEET GLOBE,Clam
Agrolatina,24A9140460,03/17/2025,Sale,-160.0,320.0,21,SWEET GLOBE,Clam
Agrolatina,24A9146520,12/30/2024,Entry,640.0,640.0,0,ALLISON,Clam
Agrolatina,24A9146520,12/30/2024,Entry,960.0,1600.0,0,ALLISON,Clam
Agrolatina,24A9146520,01/21/2025,Sale,-400.0,1200.0,22,ALLISON,Clam
Agrolatina,24A9146520,01/21/2025,Sale,-80.0,1120.0,22,ALLISON,Clam
Agrolatina,24A9146520,01/23/2025,Sale,-160.0,960.0,24,ALLISON,Clam
Agrolatina,24A9146520,01/23/2025,Sale,-960.0,0.0,24,ALLISON,Clam
Agrolatina,24A9150431,02/10/2025,Entry,1280.0,1280.0,0,SWEET FAVORS,Clam
Agrolatina,24A9150431,02/10/2025,Entry,320.0,1600.0,0,SWEET FAVORS,Clam
Agrolatina,24A9150431,03/17/2025,Sale,-320.0,1280.0,35,SWEET FAVORS,Clam
Agrolatina,24A9150431,03/19/2025,Sale,-240.0,1040.0,37,SWEET FAVORS,Clam
Agrolatina,24A9150431,03/19/2025,Sale,-960.0,80.0,37,SWEET FAVORS,Clam
Agrolatina,24A9150431,03/21/2025,Sale,-80.0,0.0,39,SWEET FAVORS,Clam
Agrolatina,24A9150998,01/19/2025,Entry,1200.0,1200.0,0,SWEET GLOBE,Clam
Agrolatina,24A9150998,01/19/2025,Entry,400.0,1600.0,0,SWEET GLOBE,Clam
Agrolatina,24A9150998,02/06/2025,Sale,-160.0,1440.0,18,SWEET GLOBE,Clam
Agrolatina,24A9150998,02/06/2025,Sale,-240.0,1200.0,18,SWEET GLOBE,Clam
Agrolatina,24A9150998,02/08/2025,Sale,-80.0,1120.0,20,SWEET GLOBE,Clam
Agrolatina,24A9150998,02/10/2025,Sale,-240.0,880.0,22,SWEET GLOBE,Clam
Agrolatina,24A9150998,02/15/2025,Sale,-80.0,800.0,27,SWEET GLOBE,Clam
Agrolatina,24A9150998,02/15/2025,Sale,-80.0,720.0,27,SWEET GLOBE,Clam
Agrolatina,24A9150998,02/15/2025,Sale,-80.0,640.0,27,SWEET GLOBE,Clam
Agrolatina,24A9150998,02/15/2025,Sale,-240.0,400.0,27,SWEET GLOBE,Clam
Agrolatina,24A9150998,02/17/2025,Sale,-240.0,160.0,29,SWEET GLOBE,Clam
Agrolatina,24A9150998,02/22/2025,Sale,-27.0,133.0,34,SWEET GLOBE,Clam
Agrolatina,24A9150998,03/01/2025,Sale,-60.0,73.0,41,SWEET GLOBE,Clam
Agrolatina,24A9151510,02/11/2025,Entry,1040.0,1040.0,0,SWEET GLOBE,Clam
Agrolatina,24A9151510,02/11/2025,Entry,560.0,1600.0,0,SWEET GLOBE,Clam
Agrolatina,24A9151510,02/21/2025,Sale,-80.0,1520.0,10,SWEET GLOBE,Clam
Agrolatina,24A9151510,02/22/2025,Sale,-240.0,1280.0,11,SWEET GLOBE,Clam
Agrolatina,24A9151510,02/22/2025,Sale,-640.0,640.0,11,SWEET GLOBE,Clam
Agrolatina,24A9151510,02/24/2025,Sale,-80.0,560.0,13,SWEET GLOBE,Clam
Agrolatina,24A9151510,02/26/2025,Sale,-140.0,420.0,15,SWEET GLOBE,Clam
Agrolatina,24A9151510,02/26/2025,Sale,-80.0,340.0,15,SWEET GLOBE,Clam
Agrolatina,24A9151510,02/27/2025,Sale,-5.0,335.0,16,SWEET GLOBE,Clam
Agrolatina,24A9153067,02/20/2025,Entry,665.0,665.0,0,IVORY,Bag
Agrolatina,24A9153067,02/20/2025,Entry,1140.0,1805.0,0,IVORY,Bag
Agrolatina,24A9153067,02/20/2025,Entry,95.0,1900.0,0,IVORY,Bag
Agrolatina,24A9153067,02/28/2025,Sale,-285.0,1615.0,8,IVORY,Bag
Agrolatina,24A9153067,02/28/2025,Sale,-475.0,1140.0,8,IVORY,Bag
Agrolatina,24A9153067,03/01/2025,Sale,-380.0,760.0,9,IVORY,Bag
Agrolatina,24A9153067,03/01/2025,Sale,-95.0,665.0,9,IVORY,Bag
Agrolatina,24A9153067,03/12/2025,Sale,-209.0,456.0,20,IVORY,Bag
Agrolatina,24A9153067,03/12/2025,Sale,-75.0,381.0,20,IVORY,Bag
Agrolatina,24A9153067,03/12/2025,Sale,-95.0,286.0,20,IVORY,Bag
Agrolatina,24A9153067,03/12/2025,Sale,-45.0,241.0,20,IVORY,Bag
Agrolatina,24A9153169,02/11/2025,Entry,1045.0,1045.0,0,IVORY,Bag
Agrolatina,24A9153169,02/11/2025,Entry,760.0,1805.0,0,IVORY,Bag
Agrolatina,24A9153169,02/11/2025,Entry,95.0,1900.0,0,IVORY,Bag
Agrolatina,24A9153169,02/28/2025,Sale,-95.0,1805.0,17,IVORY,Bag
Agrolatina,24A9153169,03/05/2025,Sale,-190.0,1615.0,22,IVORY,Bag
Agrolatina,24A9153169,03/05/2025,Sale,-285.0,1330.0,22,IVORY,Bag
Agrolatina,24A9153169,03/06/2025,Sale,-190.0,1140.0,23,IVORY,Bag
Agrolatina,24A9153169,03/12/2025,Sale,-930.0,210.0,29,IVORY,Bag
Agrolatina,24A9153169,03/12/2025,Sale,-75.0,135.0,29,IVORY,Bag
Agrolatina,24A9155481,02/24/2025,Entry,320.0,320.0,0,AUTUMN CRISP,Clam
Agrolatina,24A9155481,02/24/2025,Entry,1280.0,1600.0,0,AUTUMN CRISP,Clam
Agrolatina,24A9160701,03/04/2025,Entry,1360.0,1360.0,0,IVORY,Clam
Agrolatina,24A9160701,03/04/2025,Entry,160.0,1520.0,0,IVORY,Clam
Agrolatina,24A9160701,03/04/2025,Entry,80.0,1600.0,0,IVORY,Clam
Agrolatina,24A9160701,03/12/2025,Sale,-240.0,1360.0,8,IVORY,Clam
Agrolatina,24A9160701,03/22/2025,Sale,-80.0,1280.0,18,IVORY,Clam
Agrolatina,24A9160701,03/22/2025,Sale,-240.0,1040.0,18,IVORY,Clam
Agrolatina,24A9160701,03/24/2025,Sale,-80.0,960.0,20,IVORY,Clam
Agrolatina,24A9160701,03/28/2025,Sale,-60.0,900.0,24,IVORY,Clam
Agrolatina,24A9160701,03/29/2025,Sale,-40.0,860.0,25,IVORY,Clam
Agrolatina,24A9160701,04/01/2025,Sale,-160.0,700.0,28,IVORY,Clam
Agrolatina,24A9160701,04/03/2025,Sale,-200.0,500.0,30,IVORY,Clam
Agrolatina,24A9160701,04/08/2025,Sale,-40.0,460.0,35,IVORY,Clam
Agrolatina,24A9161606,02/07/2025,Entry,800.0,800.0,0,ALLISON,Clam
Agrolatina,24A9161606,02/07/2025,Entry,800.0,1600.0,0,ALLISON,Clam
Agrolatina,24A9161606,02/18/2025,Sale,-320.0,1280.0,11,ALLISON,Clam
Agrolatina,24A9161606,02/18/2025,Sale,-80.0,1200.0,11,ALLISON,Clam
Agrolatina,24A9161606,02/28/2025,Sale,-80.0,1120.0,21,ALLISON,Clam
Agrolatina,24A9161606,02/28/2025,Sale,-80.0,1040.0,21,ALLISON,Clam
Agrolatina,24A9161606,02/28/2025,Sale,-80.0,960.0,21,ALLISON,Clam
Agrolatina,24A9161606,03/07/2025,Sale,-400.0,560.0,28,ALLISON,Clam
Agrolatina,24A9161606,03/07/2025,Sale,-400.0,160.0,28,ALLISON,Clam
Agrolatina,24A9161606,03/14/2025,Sale,-160.0,0.0,35,ALLISON,Clam
Agrolatina,24A9162601,03/04/2025,Entry,880.0,880.0,0,IVORY,Clam
Agrolatina,24A9162601,03/04/2025,Entry,560.0,1440.0,0,IVORY,Clam
Agrolatina,24A9162601,03/04/2025,Entry,160.0,1600.0,0,IVORY,Clam
Agrolatina,24A9162601,03/12/2025,Sale,-400.0,1200.0,8,IVORY,Clam
Agrolatina,24A9162601,03/22/2025,Sale,-40.0,1160.0,18,IVORY,Clam
Agrolatina,24A9162601,03/24/2025,Sale,-20.0,1140.0,20,IVORY,Clam
Agrolatina,24A9162601,03/25/2025,Sale,-3.0,1137.0,21,IVORY,Clam
Agrolatina,24A9162601,03/25/2025,Sale,-80.0,1057.0,21,IVORY,Clam
Agrolatina,24A9162601,03/27/2025,Sale,-310.0,747.0,23,IVORY,Clam
Agrolatina,24A9162601,03/28/2025,Sale,-20.0,727.0,24,IVORY,Clam
Agrolatina,24A9162601,03/28/2025,Sale,-140.0,587.0,24,IVORY,Clam
Agrolatina,24A9162601,03/29/2025,Sale,-80.0,507.0,25,IVORY,Clam
Agrolatina,24A9162601,03/29/2025,Sale,-60.0,447.0,25,IVORY,Clam
Agrolatina,24A9162601,04/02/2025,Sale,-58.0,389.0,29,IVORY,Clam
Agrolatina,24A9162601,04/03/2025,Sale,-80.0,309.0,30,IVORY,Clam
Agrolatina,24A9162601,04/05/2025,Sale,-8.0,301.0,32,IVORY,Clam
Agrolatina,24A9163193,12/27/2024,Entry,1280.0,1280.0,0,SWEET GLOBE,Clam
Agrolatina,24A9163193,12/27/2024,Entry,320.0,1600.0,0,SWEET GLOBE,Clam
Agrolatina,24A9163193,01/06/2025,Sale,-800.0,800.0,10,SWEET GLOBE,Clam
Agrolatina,24A9163193,01/07/2025,Sale,-400.0,400.0,11,SWEET GLOBE,Clam
Agrolatina,24A9163193,01/08/2025,Sale,-80.0,320.0,12,SWEET GLOBE,Clam
Agrolatina,24A9163193,01/08/2025,Sale,-240.0,80.0,12,SWEET GLOBE,Clam
Agrolatina,24A9163193,01/09/2025,Sale,-80.0,0.0,13,SWEET GLOBE,Clam
Agrolatina,24A9164121,03/04/2025,Entry,1360.0,1360.0,0,TIMCO,Clam
Agrolatina,24A9164121,03/04/2025,Entry,240.0,1600.0,0,TIMCO,Clam
Agrolatina,24A9167533,01/30/2025,Entry,560.0,560.0,0,CANDY DREAMS,Clam
Agrolatina,24A9167533,01/30/2025,Entry,1040.0,1600.0,0,CANDY DREAMS,Clam
Agrolatina,24A9167533,02/13/2025,Sale,-240.0,1360.0,14,CANDY DREAMS,Clam
Agrolatina,24A9167533,02/15/2025,Sale,-320.0,1040.0,16,CANDY DREAMS,Clam
Agrolatina,24A9167533,02/15/2025,Sale,-80.0,960.0,16,CANDY DREAMS,Clam
Agrolatina,24A9167533,02/17/2025,Sale,-160.0,800.0,18,CANDY DREAMS,Clam
Agrolatina,24A9167533,02/17/2025,Sale,-160.0,640.0,18,CANDY DREAMS,Clam
Agrolatina,24A9167533,02/17/2025,Sale,-240.0,400.0,18,CANDY DREAMS,Clam
Agrolatina,24A9167533,02/17/2025,Sale,-240.0,160.0,18,CANDY DREAMS,Clam
Agrolatina,24A9167533,02/18/2025,Sale,-80.0,80.0,19,CANDY DREAMS,Clam
Agrolatina,24A9167533,02/18/2025,Sale,-58.0,22.0,19,CANDY DREAMS,Clam
Agrolatina,24A9167533,02/25/2025,Sale,-10.0,12.0,26,CANDY DREAMS,Clam
Agrolatina,24A9169027,01/19/2025,Entry,1280.0,1280.0,0,SWEET GLOBE,Clam
Agrolatina,24A9169027,01/19/2025,Entry,320.0,1600.0,0,SWEET GLOBE,Clam
Agrolatina,24A9169027,02/08/2025,Sale,-80.0,1520.0,20,SWEET GLOBE,Clam
Agrolatina,24A9169027,02/11/2025,Sale,-80.0,1440.0,23,SWEET GLOBE,Clam
Agrolatina,24A9169027,02/11/2025,Sale,-80.0,1360.0,23,SWEET GLOBE,Clam
Agrolatina,24A9169027,02/14/2025,Sale,-160.0,1200.0,26,SWEET GLOBE,Clam
Agrolatina,24A9169027,02/15/2025,Sale,-240.0,960.0,27,SWEET GLOBE,Clam
Agrolatina,24A9169027,02/17/2025,Sale,-80.0,880.0,29,SWEET GLOBE,Clam
Agrolatina,24A9169027,02/17/2025,Sale,-160.0,720.0,29,SWEET GLOBE,Clam
Agrolatina,24A9169027,02/18/2025,Sale,-160.0,560.0,30,SWEET GLOBE,Clam
Agrolatina,24A9169027,02/18/2025,Sale,-80.0,480.0,30,SWEET GLOBE,Clam
Agrolatina,24A9169027,02/24/2025,Sale,-55.0,425.0,36,SWEET GLOBE,Clam
Agrolatina,24A9169027,02/25/2025,Sale,-97.0,328.0,37,SWEET GLOBE,Clam
Agrolatina,24A9169027,02/28/2025,Sale,-80.0,248.0,40,SWEET GLOBE,Clam
Agrolatina,24A9169027,02/28/2025,Sale,-60.0,188.0,40,SWEET GLOBE,Clam
Agrolatina,24A9169027,03/04/2025,Sale,-38.0,150.0,44,SWEET GLOBE,Clam
Agrolatina,24A9179055,02/05/2025,Entry,1120.0,1120.0,0,SWEET GLOBE,Clam
Agrolatina,24A9179055,02/05/2025,Entry,480.0,1600.0,0,SWEET GLOBE,Clam
Agrolatina,24A9179055,02/15/2025,Sale,-80.0,1520.0,10,SWEET GLOBE,Clam
Agrolatina,24A9179055,02/19/2025,Sale,-160.0,1360.0,14,SWEET GLOBE,Clam
Agrolatina,24A9179055,02/20/2025,Sale,-80.0,1280.0,15,SWEET GLOBE,Clam
Agrolatina,24A9179055,02/20/2025,Sale,-160.0,1120.0,15,SWEET GLOBE,Clam
Agrolatina,24A9179055,02/20/2025,Sale,-160.0,960.0,15,SWEET GLOBE,Clam
Agrolatina,24A9179055,02/21/2025,Sale,-160.0,800.0,16,SWEET GLOBE,Clam
Agrolatina,24A9179055,02/22/2025,Sale,-80.0,720.0,17,SWEET GLOBE,Clam
Agrolatina,24A9179055,02/22/2025,Sale,-40.0,680.0,17,SWEET GLOBE,Clam
Agrolatina,24A9179055,02/22/2025,Sale,-70.0,610.0,17,SWEET GLOBE,Clam
Agrolatina,24A9179055,02/24/2025,Sale,-45.0,565.0,19,SWEET GLOBE,Clam
Agrolatina,24A9179055,02/26/2025,Sale,-40.0,525.0,21,SWEET GLOBE,Clam
Agrolatina,24A9179055,02/27/2025,Sale,-10.0,515.0,22,SWEET GLOBE,Clam
Agrolatina,24A9179055,02/27/2025,Sale,-5.0,510.0,22,SWEET GLOBE,Clam
Agrolatina,24A9179055,03/01/2025,Sale,-240.0,270.0,24,SWEET GLOBE,Clam
Agrolatina,24A9179055,03/11/2025,Sale,-60.0,210.0,34,SWEET GLOBE,Clam
Agrolatina,24A9179055,03/12/2025,Sale,-60.0,150.0,35,SWEET GLOBE,Clam
Agrolatina,24A9181230,02/11/2025,Entry,1445.0,1445.0,0,COTTON CANDY,Bag
Agrolatina,24A9181230,02/11/2025,Entry,255.0,1700.0,0,COTTON CANDY,Bag
Agrolatina,24A9181230,02/20/2025,Sale,-425.0,1275.0,9,COTTON CANDY,Bag
Agrolatina,24A9181230,02/28/2025,Sale,-140.0,1135.0,17,COTTON CANDY,Bag
Agrolatina,24A9181230,03/04/2025,Sale,-75.0,1060.0,21,COTTON CANDY,Bag
Agrolatina,24A9181230,03/05/2025,Sale,-75.0,985.0,22,COTTON CANDY,Bag
Agrolatina,24A9181230,03/05/2025,Sale,-60.0,925.0,22,SWEET GLOBE,Clam
Agrolatina,24A9181230,04/08/2025,Sale,-23.0,902.0,56,COTTON CANDY,Bag
Agrolatina,24A9181230,04/18/2025,Sale,-350.0,552.0,66,COTTON CANDY,Bag
Agrolatina,24A9181230,04/25/2025,Sale,-85.0,467.0,73,COTTON CANDY,Bag
Agrolatina,24A9181230,04/30/2025,Sale,-85.0,382.0,78,COTTON CANDY,Bag
Agrolatina,24A9181962,02/05/2025,Entry,960.0,960.0,0,SWEET GLOBE,Clam
Agrolatina,24A9181962,02/05/2025,Entry,960.0,1920.0,0,SWEET GLOBE,Clam
Agrolatina,24A9181962,02/05/2025,Entry,640.0,2560.0,0,SWEET GLOBE,Clam
Agrolatina,24A9181962,02/05/2025,Entry,640.0,3200.0,0,SWEET GLOBE,Clam
Agrolatina,24A9181962,02/12/2025,Sale,-240.0,2960.0,7,SWEET GLOBE,Clam
Agrolatina,24A9181962,02/19/2025,Sale,-80.0,2880.0,14,SWEET GLOBE,Clam
Agrolatina,24A9181962,02/19/2025,Sale,-560.0,2320.0,14,SWEET GLOBE,Clam
Agrolatina,24A9181962,02/20/2025,Sale,-80.0,2240.0,15,SWEET GLOBE,Clam
Agrolatina,24A9181962,02/22/2025,Sale,-160.0,2080.0,17,SWEET GLOBE,Clam
Agrolatina,24A9181962,02/24/2025,Sale,-80.0,2000.0,19,SWEET GLOBE,Clam
Agrolatina,24A9181962,03/01/2025,Sale,-160.0,1840.0,24,SWEET GLOBE,Clam
Agrolatina,24A9181962,03/01/2025,Sale,-160.0,1680.0,24,SWEET GLOBE,Clam
Agrolatina,24A9181962,03/10/2025,Sale,-50.0,1630.0,33,SWEET GLOBE,Clam
Agrolatina,24A9182146,01/13/2025,Entry,1520.0,1520.0,0,SWEET GLOBE,Clam
Agrolatina,24A9182146,01/13/2025,Entry,80.0,1600.0,0,SWEET GLOBE,Clam
Agrolatina,24A9182146,01/27/2025,Sale,-80.0,1520.0,14,SWEET GLOBE,Clam
Agrolatina,24A9182146,01/31/2025,Sale,-160.0,1360.0,18,SWEET GLOBE,Clam
Agrolatina,24A9182146,01/31/2025,Sale,-160.0,1200.0,18,SWEET GLOBE,Clam
Agrolatina,24A9182146,02/01/2025,Sale,-160.0,1040.0,19,SWEET GLOBE,Clam
Agrolatina,24A9182146,02/03/2025,Sale,-80.0,960.0,21,SWEET GLOBE,Clam
Agrolatina,24A9182146,02/03/2025,Sale,-160.0,800.0,21,SWEET GLOBE,Clam
Agrolatina,24A9182146,02/03/2025,Sale,-160.0,640.0,21,SWEET GLOBE,Clam
Agrolatina,24A9182146,02/03/2025,Sale,-80.0,560.0,21,SWEET GLOBE,Clam
Agrolatina,24A9182146,02/03/2025,Sale,-80.0,480.0,21,SWEET GLOBE,Clam
Agrolatina,24A9182146,02/04/2025,Sale,-480.0,0.0,22,SWEET GLOBE,Clam
Agrolatina,24A9184979,03/04/2025,Entry,960.0,960.0,0,SWEET GLOBE,Clam
Agrolatina,24A9184979,03/04/2025,Entry,640.0,1600.0,0,SWEET GLOBE,Clam
Agrolatina,24A9184979,03/13/2025,Sale,-240.0,1360.0,9,SWEET GLOBE,Clam
Agrolatina,24A9184979,03/13/2025,Sale,-220.0,1140.0,9,SWEET GLOBE,Clam
Agrolatina,24A9184979,03/14/2025,Sale,-160.0,980.0,10,SWEET GLOBE,Clam
Agrolatina,24A9184979,03/15/2025,Sale,-80.0,900.0,11,SWEET GLOBE,Clam
Agrolatina,24A9184979,03/15/2025,Sale,-240.0,660.0,11,SWEET GLOBE,Clam
Agrolatina,24A9184979,03/18/2025,Sale,-120.0,540.0,14,SWEET GLOBE,Clam
Agrolatina,24A9185715,01/18/2025,Entry,1520.0,1520.0,0,SWEET GLOBE,Clam
Agrolatina,24A9185715,01/18/2025,Entry,80.0,1600.0,0,SWEET GLOBE,Clam
Agrolatina,24A9185715,01/21/2025,Sale,-80.0,1520.0,3,SWEET GLOBE,Clam
Agrolatina,24A9185715,01/22/2025,Sale,-800.0,720.0,4,SWEET GLOBE,Clam
Agrolatina,24A9185715,01/23/2025,Sale,-480.0,240.0,5,SWEET GLOBE,Clam
Agrolatina,24A9185715,01/23/2025,Sale,-160.0,80.0,5,SWEET GLOBE,Clam
Agrolatina,24A9185715,01/24/2025,Sale,-80.0,0.0,6,SWEET GLOBE,Clam
Agrolatina,24A9189407,03/10/2025,Entry,1440.0,1440.0,0,TIMCO,Clam
Agrolatina,24A9189407,03/10/2025,Entry,160.0,1600.0,0,TIMCO,Clam
Agrolatina,24A9189407,03/21/2025,Sale,-80.0,1520.0,11,TIMCO,Clam
Agrolatina,24A9189407,04/14/2025,Sale,-1440.0,80.0,35,TIMCO,Clam
Agrolatina,24A9189407,04/18/2025,Sale,-68.0,12.0,39,TIMCO,Clam
Agrolatina,24A9195821,03/04/2025,Entry,255.0,255.0,0,ALLISON,Bag
Agrolatina,24A9195821,03/04/2025,Entry,1445.0,1700.0,0,ALLISON,Bag
Agrolatina,24A9195821,04/04/2025,Sale,-180.0,1520.0,31,ALLISON,Bag
Agrolatina,24A9195821,04/05/2025,Sale,-360.0,1160.0,32,ALLISON,Bag
Agrolatina,24A9195821,04/08/2025,Sale,-180.0,980.0,35,ALLISON,Bag
Agrolatina,24A9195821,04/08/2025,Sale,-180.0,800.0,35,ALLISON,Bag
Agrolatina,24A9195821,04/12/2025,Sale,-124.0,676.0,39,ALLISON,Bag
Agrolatina,24A9195821,04/12/2025,Sale,-90.0,586.0,39,ALLISON,Bag
Agrolatina,24A9197060,02/04/2025,Entry,1040.0,1040.0,0,SWEET GLOBE,Clam
Agrolatina,24A9197060,02/04/2025,Entry,560.0,1600.0,0,SWEET GLOBE,Clam
Agrolatina,24A9197060,02/21/2025,Sale,-1040.0,560.0,17,SWEET GLOBE,Clam
Agrolatina,24A9197060,02/25/2025,Sale,-560.0,0.0,21,SWEET GLOBE,Clam
Agrolatina,24A9201903,02/13/2025,Entry,880.0,880.0,0,SWEET GLOBE,Clam
Agrolatina,24A9201903,02/13/2025,Entry,720.0,1600.0,0,SWEET GLOBE,Clam
Agrolatina,24A9201903,02/28/2025,Sale,-240.0,1360.0,15,SWEET GLOBE,Clam
Agrolatina,24A9201903,03/01/2025,Sale,-320.0,1040.0,16,SWEET GLOBE,Clam
Agrolatina,24A9201903,03/01/2025,Sale,-240.0,800.0,16,SWEET GLOBE,Clam
Agrolatina,24A9201903,03/03/2025,Sale,-80.0,720.0,18,SWEET GLOBE,Clam
Agrolatina,24A9201903,03/03/2025,Sale,-80.0,640.0,18,SWEET GLOBE,Clam
Agrolatina,24A9201903,03/03/2025,Sale,-320.0,320.0,18,SWEET GLOBE,Clam
Agrolatina,24A9201903,03/06/2025,Sale,-60.0,260.0,21,SWEET GLOBE,Clam
Agrolatina,24A9201903,03/06/2025,Sale,-60.0,200.0,21,SWEET GLOBE,Clam
Agrolatina,24A9201903,03/10/2025,Sale,-50.0,150.0,25,SWEET GLOBE,Clam
Agrolatina,24A9201903,03/11/2025,Sale,-60.0,90.0,26,SWEET GLOBE,Clam
Agrolatina,24A9209140,02/11/2025,Entry,960.0,960.0,0,COTTON CANDY,Clam
Agrolatina,24A9209140,02/11/2025,Entry,640.0,1600.0,0,COTTON CANDY,Clam
Agrolatina,24A9209140,02/18/2025,Sale,-960.0,640.0,7,COTTON CANDY,Clam
Agrolatina,24A9209140,02/18/2025,Sale,-640.0,0.0,7,COTTON CANDY,Clam
Agrolatina,24A9212041,02/17/2025,Entry,880.0,880.0,0,IVORY,Clam
Agrolatina,24A9212041,02/17/2025,Entry,640.0,1520.0,0,IVORY,Clam
Agrolatina,24A9212041,02/17/2025,Entry,80.0,1600.0,0,IVORY,Clam
Agrolatina,24A9212041,03/04/2025,Sale,-240.0,1360.0,15,IVORY,Clam
Agrolatina,24A9212041,03/06/2025,Sale,-80.0,1280.0,17,IVORY,Clam
Agrolatina,24A9212041,03/19/2025,Sale,-176.0,1104.0,30,IVORY,Clam
Agrolatina,24A9212041,03/19/2025,Sale,-130.0,974.0,30,IVORY,Clam
Agrolatina,24A9212041,03/22/2025,Sale,-60.0,914.0,33,IVORY,Clam
Agrolatina,24A9212041,03/27/2025,Sale,-80.0,834.0,38,IVORY,Clam
Agrolatina,24A9212041,03/28/2025,Sale,-480.0,354.0,39,IVORY,Clam
Agrolatina,24A9212041,03/29/2025,Sale,-80.0,274.0,40,IVORY,Clam
Agrolatina,24A9213310,02/04/2025,Entry,720.0,720.0,0,SWEET GLOBE,Clam
Agrolatina,24A9213310,02/04/2025,Entry,880.0,1600.0,0,SWEET GLOBE,Clam
Agrolatina,24A9213310,02/21/2025,Sale,-400.0,1200.0,17,SWEET GLOBE,Clam
Agrolatina,24A9213310,02/25/2025,Sale,-320.0,880.0,21,SWEET GLOBE,Clam
Agrolatina,24A9213310,02/25/2025,Sale,-880.0,0.0,21,SWEET GLOBE,Clam
Agrolatina,24A9214677,02/11/2025,Entry,880.0,880.0,0,SWEET GLOBE,Clam
Agrolatina,24A9214677,02/11/2025,Entry,720.0,1600.0,0,SWEET GLOBE,Clam
Agrolatina,24A9214677,02/20/2025,Sale,-240.0,1360.0,9,SWEET GLOBE,Clam
Agrolatina,24A9214677,02/21/2025,Sale,-80.0,1280.0,10,SWEET GLOBE,Clam
Agrolatina,24A9214677,02/22/2025,Sale,-320.0,960.0,11,SWEET GLOBE,Clam
Agrolatina,24A9214677,02/22/2025,Sale,-160.0,800.0,11,SWEET GLOBE,Clam
Agrolatina,24A9214677,02/22/2025,Sale,-10.0,790.0,11,SWEET GLOBE,Clam
Agrolatina,24A9214677,02/27/2025,Sale,-50.0,740.0,16,SWEET GLOBE,Clam
Agrolatina,24A9214677,03/01/2025,Sale,-60.0,680.0,18,SWEET GLOBE,Clam
Agrolatina,24A9214677,03/03/2025,Sale,-160.0,520.0,20,SWEET GLOBE,Clam
Agrolatina,24A9214677,03/03/2025,Sale,-160.0,360.0,20,SWEET GLOBE,Clam
Agrolatina,24A9214677,03/05/2025,Sale,-240.0,120.0,22,SWEET GLOBE,Clam
Agrolatina,24A9219314,01/19/2025,Entry,320.0,320.0,0,IVORY,Clam
Agrolatina,24A9219314,01/19/2025,Entry,1200.0,1520.0,0,SWEET GLOBE,Clam
Agrolatina,24A9219314,01/19/2025,Entry,80.0,1600.0,0,SWEET GLOBE,Clam
Agrolatina,24A9219314,02/07/2025,Sale,-80.0,1520.0,19,SWEET GLOBE,Clam
Agrolatina,24A9219314,02/07/2025,Sale,-560.0,960.0,19,SWEET GLOBE,Clam
Agrolatina,24A9219314,02/08/2025,Sale,-80.0,880.0,20,SWEET GLOBE,Clam
Agrolatina,24A9219314,02/08/2025,Sale,-80.0,800.0,20,SWEET GLOBE,Clam
Agrolatina,24A9219314,02/10/2025,Sale,-80.0,720.0,22,SWEET GLOBE,Clam
Agrolatina,24A9219314,02/10/2025,Sale,-80.0,640.0,22,SWEET GLOBE,Clam
Agrolatina,24A9219314,02/10/2025,Sale,-80.0,560.0,22,SWEET GLOBE,Clam
Agrolatina,24A9219314,02/11/2025,Sale,-80.0,480.0,23,SWEET GLOBE,Clam
Agrolatina,24A9219314,02/12/2025,Sale,-80.0,400.0,24,IVORY,Clam
Agrolatina,24A9219314,02/12/2025,Sale,-80.0,320.0,24,IVORY,Clam
Agrolatina,24A9219314,02/13/2025,Sale,-80.0,240.0,25,IVORY,Clam
Agrolatina,24A9219314,02/17/2025,Sale,-80.0,160.0,29,SWEET GLOBE,Clam
Agrolatina,24A9219314,02/18/2025,Sale,-80.0,80.0,30,SWEET GLOBE,Clam
Agrolatina,24A9233082,02/04/2025,Entry,640.0,640.0,0,SWEET GLOBE,Clam
Agrolatina,24A9233082,02/04/2025,Entry,960.0,1600.0,0,SWEET GLOBE,Clam
Agrolatina,24A9233082,02/25/2025,Sale,-640.0,960.0,21,SWEET GLOBE,Clam
Agrolatina,24A9233082,02/25/2025,Sale,-320.0,640.0,21,SWEET GLOBE,Clam
Agrolatina,24A9233082,02/26/2025,Sale,-640.0,0.0,22,SWEET GLOBE,Clam
Agrolatina,24A9249390,02/06/2025,Entry,1140.0,1140.0,0,SWEET GLOBE,Bag
Agrolatina,24A9249390,02/06/2025,Entry,760.0,1900.0,0,SWEET GLOBE,Bag
Agrolatina,24A9249390,02/08/2025,Sale,-285.0,1615.0,2,SWEET GLOBE,Bag
Agrolatina,24A9249390,02/15/2025,Sale,-90.0,1525.0,9,SWEET GLOBE,Bag
Agrolatina,24A9249390,02/17/2025,Sale,-95.0,1430.0,11,SWEET GLOBE,Bag
Agrolatina,24A9249390,02/21/2025,Sale,-123.0,1307.0,15,SWEET GLOBE,Bag
Agrolatina,24A9249390,02/22/2025,Sale,-269.0,1038.0,16,SWEET GLOBE,Bag
Agrolatina,24A9249390,02/22/2025,Sale,-10.0,1028.0,16,SWEET GLOBE,Bag
Agrolatina,24A9249390,02/24/2025,Sale,-145.0,883.0,18,SWEET GLOBE,Bag
Agrolatina,24A9249390,02/27/2025,Sale,-110.0,773.0,21,SWEET GLOBE,Bag
Agrolatina,24A9249390,02/28/2025,Sale,-90.0,683.0,22,SWEET GLOBE,Bag
Agrolatina,24A9249390,03/10/2025,Sale,-58.0,625.0,32,SWEET GLOBE,Bag
Agrolatina,24A9249390,03/11/2025,Sale,-70.0,555.0,33,SWEET GLOBE,Bag
Agrolatina,24A9249893,02/17/2025,Entry,1040.0,1040.0,0,SWEET GLOBE,Clam
Agrolatina,24A9249893,02/17/2025,Entry,560.0,1600.0,0,SWEET GLOBE,Clam
Agrolatina,24A9249893,03/05/2025,Sale,-720.0,880.0,16,SWEET GLOBE,Clam
Agrolatina,24A9249893,03/08/2025,Sale,-240.0,640.0,19,SWEET GLOBE,Clam
Agrolatina,24A9249893,03/08/2025,Sale,-80.0,560.0,19,SWEET GLOBE,Clam
Agrolatina,24A9249893,03/10/2025,Sale,-20.0,540.0,21,SWEET GLOBE,Clam
Agrolatina,24A9249893,03/11/2025,Sale,-80.0,460.0,22,SWEET GLOBE,Clam
Agrolatina,24A9249893,03/11/2025,Sale,-209.0,251.0,22,SWEET GLOBE,Clam
Agrolatina,24A9249893,03/12/2025,Sale,-80.0,171.0,23,SWEET GLOBE,Clam
Agrolatina,24A9249893,03/14/2025,Sale,-40.0,131.0,25,SWEET GLOBE,Clam
Agrolatina,24A9252006,01/03/2025,Entry,1520.0,1520.0,0,SWEET GLOBE,Clam
Agrolatina,24A9252006,01/03/2025,Entry,80.0,1600.0,0,SWEET GLOBE,Clam
Agrolatina,24A9252006,01/16/2025,Sale,-80.0,1520.0,13,SWEET GLOBE,Clam
Agrolatina,24A9252006,01/16/2025,Sale,-240.0,1280.0,13,SWEET GLOBE,Clam
Agrolatina,24A9252006,01/16/2025,Sale,-80.0,1200.0,13,SWEET GLOBE,Clam
Agrolatina,24A9252006,01/16/2025,Sale,-560.0,640.0,13,SWEET GLOBE,Clam
Agrolatina,24A9252006,01/17/2025,Sale,-480.0,160.0,14,SWEET GLOBE,Clam
Agrolatina,24A9252006,01/17/2025,Sale,-80.0,80.0,14,SWEET GLOBE,Clam
Agrolatina,24A9252006,01/21/2025,Sale,-80.0,0.0,18,SWEET GLOBE,Clam
Agrolatina,24A9260151,02/04/2025,Entry,640.0,640.0,0,SWEET GLOBE,Clam
Agrolatina,24A9260151,02/04/2025,Entry,960.0,1600.0,0,SWEET GLOBE,Clam
Agrolatina,24A9260151,02/18/2025,Sale,-160.0,1440.0,14,SWEET GLOBE,Clam
Agrolatina,24A9260151,02/25/2025,Sale,-480.0,960.0,21,SWEET GLOBE,Clam
Agrolatina,24A9260151,02/26/2025,Sale,-960.0,0.0,22,SWEET GLOBE,Clam
Agrolatina,24A9265831,02/04/2025,Entry,320.0,320.0,0,ALLISON,Clam
Agrolatina,24A9265831,02/04/2025,Entry,560.0,880.0,0,ALLISON,Clam
Agrolatina,24A9265831,02/04/2025,Entry,720.0,1600.0,0,TIMCO,Clam
Agrolatina,24A9265831,02/27/2025,Sale,-160.0,1440.0,23,ALLISON,Clam
Agrolatina,24A9265831,03/01/2025,Sale,-80.0,1360.0,25,ALLISON,Clam
Agrolatina,24A9265831,03/01/2025,Sale,-720.0,640.0,25,TIMCO,Clam
Agrolatina,24A9265831,03/03/2025,Sale,-160.0,480.0,27,ALLISON,Clam
Agrolatina,24A9265831,03/04/2025,Sale,-320.0,160.0,28,ALLISON,Clam
Agrolatina,24A9265831,03/04/2025,Sale,-160.0,0.0,28,ALLISON,Clam
Agrolatina,24A9266490,02/11/2025,Entry,480.0,480.0,0,ALLISON,Clam
Agrolatina,24A9266490,02/11/2025,Entry,1120.0,1600.0,0,ALLISON,Clam
Agrolatina,24A9266490,03/04/2025,Sale,-160.0,1440.0,21,ALLISON,Clam
Agrolatina,24A9266490,03/06/2025,Sale,-800.0,640.0,23,ALLISON,Clam
Agrolatina,24A9266490,03/06/2025,Sale,-160.0,480.0,23,ALLISON,Clam
Agrolatina,24A9266490,03/09/2025,Sale,-480.0,0.0,26,ALLISON,Clam
Agrolatina,24A9269077,03/10/2025,Entry,1280.0,1280.0,0,TIMCO,Clam
Agrolatina,24A9269077,03/10/2025,Entry,160.0,1440.0,0,TIMCO,Clam
Agrolatina,24A9269077,03/10/2025,Entry,160.0,1600.0,0,TIMCO,Clam
Agrolatina,24A9269077,04/09/2025,Sale,-160.0,1440.0,30,TIMCO,Clam
Agrolatina,24A9269077,04/17/2025,Sale,-1280.0,160.0,38,TIMCO,Clam
Agrolatina,24A9269077,04/22/2025,Sale,-160.0,0.0,43,TIMCO,Clam
Agrolatina,24A9272929,02/24/2025,Entry,80.0,80.0,0,AUTUMN CRISP,Clam
Agrolatina,24A9272929,02/24/2025,Entry,1520.0,1600.0,0,AUTUMN CRISP,Clam
Agrolatina,24A9272929,03/22/2025,Sale,-80.0,1520.0,26,AUTUMN CRISP,Clam
Agrolatina,24A9272929,03/24/2025,Sale,-80.0,1440.0,28,AUTUMN CRISP,Clam
Agrolatina,24A9272929,03/27/2025,Sale,-1440.0,0.0,31,AUTUMN CRISP,Clam
Agrolatina,24A9274896,02/06/2025,Entry,800.0,800.0,0,SWEET GLOBE,Clam
Agrolatina,24A9274896,02/06/2025,Entry,800.0,1600.0,0,SWEET GLOBE,Clam
Agrolatina,24A9274896,02/06/2025,Sale,-80.0,1520.0,0,SWEET GLOBE,Clam
Agrolatina,24A9274896,02/07/2025,Sale,-160.0,1360.0,1,SWEET GLOBE,Clam
Agrolatina,24A9274896,02/10/2025,Sale,-80.0,1280.0,4,SWEET GLOBE,Clam
Agrolatina,24A9274896,02/10/2025,Sale,-80.0,1200.0,4,SWEET GLOBE,Clam
Agrolatina,24A9274896,02/10/2025,Sale,-160.0,1040.0,4,SWEET GLOBE,Clam
Agrolatina,24A9274896,02/11/2025,Sale,-160.0,880.0,5,SWEET GLOBE,Clam
Agrolatina,24A9274896,02/15/2025,Sale,-80.0,800.0,9,SWEET GLOBE,Clam
Agrolatina,24A9274896,02/18/2025,Sale,-160.0,640.0,12,SWEET GLOBE,Clam
Agrolatina,24A9274896,02/28/2025,Sale,-40.0,600.0,22,SWEET GLOBE,Clam
Agrolatina,24A9274896,03/03/2025,Sale,-40.0,560.0,25,SWEET GLOBE,Clam
Agrolatina,24A9274896,03/05/2025,Sale,-297.0,263.0,27,SWEET GLOBE,Clam
Agrolatina,24A9274896,03/05/2025,Sale,-50.0,213.0,27,SWEET GLOBE,Clam
Agrolatina,24A9275104,03/10/2025,Entry,1520.0,1520.0,0,TIMCO,Clam
Agrolatina,24A9275104,03/10/2025,Entry,80.0,1600.0,0,TIMCO,Clam
Agrolatina,24A9275104,03/25/2025,Sale,-80.0,1520.0,15,TIMCO,Clam
Agrolatina,24A9275104,04/02/2025,Sale,-80.0,1440.0,23,TIMCO,Clam
Agrolatina,24A9275104,04/04/2025,Sale,-80.0,1360.0,25,TIMCO,Clam
Agrolatina,24A9275104,04/07/2025,Sale,-160.0,1200.0,28,TIMCO,Clam
Agrolatina,24A9275104,04/07/2025,Sale,-80.0,1120.0,28,TIMCO,Clam
Agrolatina,24A9275104,04/09/2025,Sale,-160.0,960.0,30,TIMCO,Clam
Agrolatina,24A9275104,04/10/2025,Sale,-400.0,560.0,31,TIMCO,Clam
Agrolatina,24A9275104,04/11/2025,Sale,-320.0,240.0,32,TIMCO,Clam
Agrolatina,24A9275104,04/14/2025,Sale,-240.0,0.0,35,TIMCO,Clam
Agrolatina,24A9279096,12/29/2024,Entry,1600.0,1600.0,0,ALLISON,Clam
Agrolatina,24A9279096,01/09/2025,Sale,-80.0,1520.0,11,ALLISON,Clam
Agrolatina,24A9279096,01/09/2025,Sale,-80.0,1440.0,11,ALLISON,Clam
Agrolatina,24A9279096,01/09/2025,Sale,-1440.0,0.0,11,ALLISON,Clam
Agrolatina,24A9283521,02/17/2025,Entry,960.0,960.0,0,IVORY,Clam
Agrolatina,24A9283521,02/17/2025,Entry,560.0,1520.0,0,IVORY,Clam
Agrolatina,24A9283521,02/17/2025,Entry,80.0,1600.0,0,IVORY,Clam
Agrolatina,24A9283521,03/04/2025,Sale,-80.0,1520.0,15,IVORY,Clam
Agrolatina,24A9283521,03/06/2025,Sale,-400.0,1120.0,17,IVORY,Clam
Agrolatina,24A9283521,03/12/2025,Sale,-320.0,800.0,23,IVORY,Clam
Agrolatina,24A9283521,03/22/2025,Sale,-40.0,760.0,33,IVORY,Clam
Agrolatina,24A9283521,03/22/2025,Sale,-80.0,680.0,33,IVORY,Clam
Agrolatina,24A9283521,03/28/2025,Sale,-320.0,360.0,39,IVORY,Clam
Agrolatina,24A9283521,03/29/2025,Sale,-120.0,240.0,40,IVORY,Clam
Agrolatina,24A9283521,03/29/2025,Sale,-40.0,200.0,40,IVORY,Clam
Agrolatina,24A9283521,04/08/2025,Sale,-40.0,160.0,50,IVORY,Clam
Agrolatina,24A9285340,02/04/2025,Entry,720.0,720.0,0,SWEET GLOBE,Clam
Agrolatina,24A9285340,02/04/2025,Entry,880.0,1600.0,0,SWEET GLOBE,Clam
Agrolatina,24A9285340,03/03/2025,Sale,-480.0,1120.0,27,SWEET GLOBE,Clam
Agrolatina,24A9285340,03/04/2025,Sale,-240.0,880.0,28,SWEET GLOBE,Clam
Agrolatina,24A9285340,03/04/2025,Sale,-880.0,0.0,28,SWEET GLOBE,Clam
Agrolatina,24A9290553,02/04/2025,Entry,1120.0,1120.0,0,SWEET GLOBE,Clam
Agrolatina,24A9290553,02/04/2025,Entry,480.0,1600.0,0,SWEET GLOBE,Clam
Agrolatina,24A9290553,03/03/2025,Sale,-1120.0,480.0,27,SWEET GLOBE,Clam
Agrolatina,24A9290553,03/04/2025,Sale,-480.0,0.0,28,SWEET GLOBE,Clam
Agrolatina,24A9292751,01/19/2025,Entry,400.0,400.0,0,CANDY SNAP,Clam
Agrolatina,24A9292751,01/19/2025,Entry,1200.0,1600.0,0,CANDY SNAP,Clam
Agrolatina,24A9292751,02/10/2025,Sale,-80.0,1520.0,22,CANDY SNAP,Clam
Agrolatina,24A9292751,02/12/2025,Sale,-240.0,1280.0,24,CANDY SNAP,Clam
Agrolatina,24A9292751,02/17/2025,Sale,-80.0,1200.0,29,CANDY SNAP,Clam
Agrolatina,24A9292751,02/17/2025,Sale,-80.0,1120.0,29,CANDY SNAP,Clam
Agrolatina,24A9292751,02/20/2025,Sale,-480.0,640.0,32,CANDY SNAP,Clam
Agrolatina,24A9292751,02/26/2025,Sale,-140.0,500.0,38,CANDY SNAP,Clam
Agrolatina,24A9292751,02/27/2025,Sale,-20.0,480.0,39,CANDY SNAP,Clam
Agrolatina,24A9292751,03/06/2025,Sale,-60.0,420.0,46,CANDY SNAP,Clam
Agrolatina,24A9292751,03/27/2025,Sale,-80.0,340.0,67,CANDY SNAP,Clam
Agrolatina,24A9292751,03/31/2025,Sale,-240.0,100.0,71,CANDY SNAP,Clam
Agrolatina,24A9296464,03/04/2025,Entry,1200.0,1200.0,0,IVORY,Clam
Agrolatina,24A9296464,03/04/2025,Entry,400.0,1600.0,0,IVORY,Clam
Agrolatina,24A9296464,03/12/2025,Sale,-80.0,1520.0,8,IVORY,Clam
Agrolatina,24A9296464,03/15/2025,Sale,-400.0,1120.0,11,IVORY,Clam
Agrolatina,24A9296464,03/21/2025,Sale,-81.0,1039.0,17,IVORY,Clam
Agrolatina,24A9296464,03/22/2025,Sale,-81.0,958.0,18,IVORY,Clam
Agrolatina,24A9296464,03/22/2025,Sale,-100.0,858.0,18,IVORY,Clam
Agrolatina,24A9296464,03/22/2025,Sale,-80.0,778.0,18,IVORY,Clam
Agrolatina,24A9296464,03/25/2025,Sale,-40.0,738.0,21,IVORY,Clam
Agrolatina,24A9296464,03/26/2025,Sale,-60.0,678.0,22,IVORY,Clam
Agrolatina,24A9296464,03/28/2025,Sale,-80.0,598.0,24,IVORY,Clam
Agrolatina,24A9296464,03/29/2025,Sale,-40.0,558.0,25,IVORY,Clam
Agrolatina,24A9296464,03/31/2025,Sale,-80.0,478.0,27,IVORY,Clam
Agrolatina,24A9296464,04/08/2025,Sale,-40.0,438.0,35,IVORY,Clam
Agrolatina,24A9299109,02/04/2025,Entry,1040.0,1040.0,0,SWEET GLOBE,Clam
Agrolatina,24A9299109,02/04/2025,Entry,560.0,1600.0,0,SWEET GLOBE,Clam
Agrolatina,24A9299109,02/19/2025,Sale,-560.0,1040.0,15,SWEET GLOBE,Clam
Agrolatina,24A9299109,03/04/2025,Sale,-800.0,240.0,28,SWEET GLOBE,Clam
Agrolatina,24A9299109,03/06/2025,Sale,-240.0,0.0,30,SWEET GLOBE,Clam
Agrolatina,24A9311713,02/11/2025,Entry,960.0,960.0,0,SWEET GLOBE,Clam
Agrolatina,24A9311713,02/11/2025,Entry,640.0,1600.0,0,SWEET GLOBE,Clam
Agrolatina,24A9311713,02/21/2025,Sale,-240.0,1360.0,10,SWEET GLOBE,Clam
Agrolatina,24A9311713,02/22/2025,Sale,-80.0,1280.0,11,SWEET GLOBE,Clam
Agrolatina,24A9311713,02/22/2025,Sale,-240.0,1040.0,11,SWEET GLOBE,Clam
Agrolatina,24A9311713,02/22/2025,Sale,-320.0,720.0,11,SWEET GLOBE,Clam
Agrolatina,24A9311713,02/26/2025,Sale,-100.0,620.0,15,SWEET GLOBE,Clam
Agrolatina,24A9311713,02/26/2025,Sale,-20.0,600.0,15,SWEET GLOBE,Clam
Agrolatina,24A9311713,02/27/2025,Sale,-80.0,520.0,16,SWEET GLOBE,Clam
Agrolatina,24A9311713,03/01/2025,Sale,-240.0,280.0,18,SWEET GLOBE,Clam
Agrolatina,24A9314875,02/10/2025,Entry,1600.0,1600.0,0,SWEET FAVORS,Clam
Agrolatina,24A9314875,03/01/2025,Sale,-320.0,1280.0,19,SWEET FAVORS,Clam
Agrolatina,24A9314875,03/04/2025,Sale,-560.0,720.0,22,SWEET FAVORS,Clam
Agrolatina,24A9314875,03/19/2025,Sale,-720.0,0.0,37,SWEET FAVORS,Clam
Agrolatina,24A9316158,01/19/2025,Entry,1200.0,1200.0,0,ALLISON,Clam
Agrolatina,24A9316158,01/19/2025,Entry,400.0,1600.0,0,ALLISON,Clam
Agrolatina,24A9316158,02/19/2025,Sale,-160.0,1440.0,31,ALLISON,Clam
Agrolatina,24A9316158,02/19/2025,Sale,-80.0,1360.0,31,ALLISON,Clam
Agrolatina,24A9316158,02/20/2025,Sale,-291.0,1069.0,32,ALLISON,Clam
Agrolatina,24A9316158,02/20/2025,Sale,-80.0,989.0,32,ALLISON,Clam
Agrolatina,24A9316158,02/22/2025,Sale,-240.0,749.0,34,ALLISON,Clam
Agrolatina,24A9316158,02/24/2025,Sale,-160.0,589.0,36,ALLISON,Clam
Agrolatina,24A9316158,02/25/2025,Sale,-80.0,509.0,37,ALLISON,Clam
Agrolatina,24A9316158,02/27/2025,Sale,-80.0,429.0,39,ALLISON,Clam
Agrolatina,24A9316158,03/04/2025,Sale,-160.0,269.0,44,ALLISON,Clam
Agrolatina,24A9316158,03/04/2025,Sale,-80.0,189.0,44,ALLISON,Clam
Agrolatina,24A9316158,03/14/2025,Sale,-240.0,-51.0,54,ALLISON,Clam
Agrolatina,24A9319858,01/30/2025,Entry,1360.0,1360.0,0,SWEET GLOBE,Clam
Agrolatina,24A9319858,01/30/2025,Entry,240.0,1600.0,0,SWEET GLOBE,Clam
Agrolatina,24A9319858,02/11/2025,Sale,-80.0,1520.0,12,SWEET GLOBE,Clam
Agrolatina,24A9319858,02/11/2025,Sale,-80.0,1440.0,12,SWEET GLOBE,Clam
Agrolatina,24A9319858,02/15/2025,Sale,-80.0,1360.0,16,SWEET GLOBE,Clam
Agrolatina,24A9319858,02/15/2025,Sale,-640.0,720.0,16,SWEET GLOBE,Clam
Agrolatina,24A9319858,02/15/2025,Sale,-320.0,400.0,16,SWEET GLOBE,Clam
Agrolatina,24A9319858,02/18/2025,Sale,-80.0,320.0,19,SWEET GLOBE,Clam
Agrolatina,24A9319858,02/18/2025,Sale,-80.0,240.0,19,SWEET GLOBE,Clam
Agrolatina,24A9319858,02/21/2025,Sale,-80.0,160.0,22,SWEET GLOBE,Clam
Agrolatina,24A9319858,02/22/2025,Sale,-80.0,80.0,23,SWEET GLOBE,Clam
Agrolatina,24A9319858,02/22/2025,Sale,-80.0,0.0,23,SWEET GLOBE,Clam
Agrolatina,24A9322649,02/06/2025,Entry,1045.0,1045.0,0,SWEET GLOBE,Bag
Agrolatina,24A9322649,02/06/2025,Entry,855.0,1900.0,0,SWEET GLOBE,Bag
Agrolatina,24A9322649,02/08/2025,Sale,-665.0,1235.0,2,SWEET GLOBE,Bag
Agrolatina,24A9322649,02/11/2025,Sale,-95.0,1140.0,5,SWEET GLOBE,Bag
Agrolatina,24A9322649,02/12/2025,Sale,-90.0,1050.0,6,SWEET GLOBE,Bag
Agrolatina,24A9322649,02/13/2025,Sale,-180.0,870.0,7,SWEET GLOBE,Bag
Agrolatina,24A9322649,02/22/2025,Sale,-3.0,867.0,16,SWEET GLOBE,Bag
Agrolatina,24A9322649,02/24/2025,Sale,-145.0,722.0,18,SWEET GLOBE,Bag
Agrolatina,24A9322649,02/27/2025,Sale,-90.0,632.0,21,SWEET GLOBE,Bag
Agrolatina,24A9322649,02/27/2025,Sale,-110.0,522.0,21,SWEET GLOBE,Bag
Agrolatina,24A9322649,02/28/2025,Sale,-90.0,432.0,22,SWEET GLOBE,Bag
Agrolatina,24A9322649,03/11/2025,Sale,-94.0,338.0,33,SWEET GLOBE,Bag
Agrolatina,24A9322649,03/12/2025,Sale,-1.0,337.0,34,SWEET GLOBE,Bag
Agrolatina,24A9331002,02/11/2025,Entry,720.0,720.0,0,SWEET GLOBE,Clam
Agrolatina,24A9331002,02/11/2025,Entry,880.0,1600.0,0,SWEET GLOBE,Clam
Agrolatina,24A9331002,02/19/2025,Sale,-80.0,1520.0,8,SWEET GLOBE,Clam
Agrolatina,24A9331002,02/22/2025,Sale,-640.0,880.0,11,SWEET GLOBE,Clam
Agrolatina,24A9331002,02/22/2025,Sale,-80.0,800.0,11,SWEET GLOBE,Clam
Agrolatina,24A9331002,03/03/2025,Sale,-800.0,0.0,20,SWEET GLOBE,Clam
Agrolatina,24A9332631,03/04/2025,Entry,720.0,720.0,0,AUTUMN CRISP,Clam
Agrolatina,24A9332631,03/04/2025,Entry,880.0,1600.0,0,AUTUMN CRISP,Clam
Agrolatina,24A9337127,02/05/2025,Entry,880.0,880.0,0,SWEET GLOBE,Clam
Agrolatina,24A9337127,02/05/2025,Entry,720.0,1600.0,0,SWEET GLOBE,Clam
Agrolatina,24A9337127,02/18/2025,Sale,-320.0,1280.0,13,SWEET GLOBE,Clam
Agrolatina,24A9337127,02/19/2025,Sale,-160.0,1120.0,14,SWEET GLOBE,Clam
Agrolatina,24A9337127,02/19/2025,Sale,-320.0,800.0,14,SWEET GLOBE,Clam
Agrolatina,24A9337127,02/20/2025,Sale,-80.0,720.0,15,SWEET GLOBE,Clam
Agrolatina,24A9337127,02/20/2025,Sale,-160.0,560.0,15,SWEET GLOBE,Clam
Agrolatina,24A9337127,02/22/2025,Sale,-80.0,480.0,17,SWEET GLOBE,Clam
Agrolatina,24A9337127,02/22/2025,Sale,-80.0,400.0,17,SWEET GLOBE,Clam
Agrolatina,24A9337127,02/22/2025,Sale,-27.0,373.0,17,SWEET GLOBE,Clam
Agrolatina,24A9337127,02/26/2025,Sale,-55.0,318.0,21,SWEET GLOBE,Clam
Agrolatina,24A9337127,02/26/2025,Sale,-60.0,258.0,21,SWEET GLOBE,Clam
Agrolatina,24A9337127,03/05/2025,Sale,-80.0,178.0,28,SWEET GLOBE,Clam
Agrolatina,24A9342776,01/21/2025,Entry,1440.0,1440.0,0,SWEET GLOBE,Clam
Agrolatina,24A9342776,01/21/2025,Entry,80.0,1520.0,0,SWEET GLOBE,Clam
Agrolatina,24A9342776,01/21/2025,Entry,80.0,1600.0,0,SWEET GLOBE,Clam
Agrolatina,24A9342776,01/28/2025,Sale,-800.0,800.0,7,SWEET GLOBE,Clam
Agrolatina,24A9342776,01/29/2025,Sale,-80.0,720.0,8,SWEET GLOBE,Clam
Agrolatina,24A9342776,02/03/2025,Sale,-80.0,640.0,13,SWEET GLOBE,Clam
Agrolatina,24A9342776,02/03/2025,Sale,-480.0,160.0,13,SWEET GLOBE,Clam
Agrolatina,24A9342776,02/04/2025,Sale,-80.0,80.0,14,SWEET GLOBE,Clam
Agrolatina,24A9342776,02/11/2025,Sale,-80.0,0.0,21,SWEET GLOBE,Clam
Agrolatina,24A9346701,03/10/2025,Entry,1280.0,1280.0,0,IVORY,Clam
Agrolatina,24A9346701,03/10/2025,Entry,80.0,1360.0,0,IVORY,Clam
Agrolatina,24A9346701,03/10/2025,Entry,80.0,1440.0,0,SWEET GLOBE,Clam
Agrolatina,24A9346701,03/10/2025,Entry,160.0,1600.0,0,SWEET GLOBE,Clam
Agrolatina,24A9346701,03/15/2025,Sale,-160.0,1440.0,5,IVORY,Clam
Agrolatina,24A9346701,03/15/2025,Sale,-80.0,1360.0,5,IVORY,Clam
Agrolatina,24A9346701,03/15/2025,Sale,-80.0,1280.0,5,SWEET GLOBE,Clam
Agrolatina,24A9346701,03/17/2025,Sale,-80.0,1200.0,7,SWEET GLOBE,Clam
Agrolatina,24A9346701,03/21/2025,Sale,-60.0,1140.0,11,IVORY,Clam
Agrolatina,24A9346701,03/22/2025,Sale,-80.0,1060.0,12,IVORY,Clam
Agrolatina,24A9346701,03/22/2025,Sale,-80.0,980.0,12,IVORY,Clam
Agrolatina,24A9346701,03/22/2025,Sale,-40.0,940.0,12,IVORY,Clam
Agrolatina,24A9346701,03/22/2025,Sale,-80.0,860.0,12,IVORY,Clam
Agrolatina,24A9346701,03/22/2025,Sale,-80.0,780.0,12,IVORY,Clam
Agrolatina,24A9346701,03/25/2025,Sale,-440.0,340.0,15,IVORY,Clam
Agrolatina,24A9346701,03/25/2025,Sale,-160.0,180.0,15,IVORY,Clam
Agrolatina,24A9346701,03/28/2025,Sale,-40.0,140.0,18,IVORY,Clam
Agrolatina,24A9356309,01/13/2025,Entry,1440.0,1440.0,0,ALLISON,Clam
Agrolatina,24A9356309,01/13/2025,Entry,160.0,1600.0,0,ALLISON,Clam
Agrolatina,24A9356309,01/28/2025,Sale,-80.0,1520.0,15,ALLISON,Clam
Agrolatina,24A9356309,01/29/2025,Sale,-880.0,640.0,16,ALLISON,Clam
Agrolatina,24A9356309,01/31/2025,Sale,-80.0,560.0,18,ALLISON,Clam
Agrolatina,24A9356309,02/04/2025,Sale,-320.0,240.0,22,ALLISON,Clam
Agrolatina,24A9356309,02/05/2025,Sale,-80.0,160.0,23,ALLISON,Clam
Agrolatina,24A9356309,02/05/2025,Sale,-80.0,80.0,23,ALLISON,Clam
Agrolatina,24A9356309,02/05/2025,Sale,-80.0,0.0,23,ALLISON,Clam
Agrolatina,24A9357239,03/09/2025,Entry,1440.0,1440.0,0,TIMCO,Clam
Agrolatina,24A9357239,03/09/2025,Entry,160.0,1600.0,0,TIMCO,Clam
Agrolatina,24A9357239,03/28/2025,Sale,-80.0,1520.0,19,TIMCO,Clam
Agrolatina,24A9357239,03/29/2025,Sale,-80.0,1440.0,20,TIMCO,Clam
Agrolatina,24A9357239,04/04/2025,Sale,-160.0,1280.0,26,TIMCO,Clam
Agrolatina,24A9357239,04/05/2025,Sale,-160.0,1120.0,27,TIMCO,Clam
Agrolatina,24A9357239,04/05/2025,Sale,-400.0,720.0,27,TIMCO,Clam
Agrolatina,24A9357239,04/07/2025,Sale,-320.0,400.0,29,TIMCO,Clam
Agrolatina,24A9357239,04/09/2025,Sale,-240.0,160.0,31,TIMCO,Clam
Agrolatina,24A9357239,04/10/2025,Sale,-160.0,0.0,32,TIMCO,Clam
Agrolatina,24A9375913,03/09/2025,Entry,1615.0,1615.0,0,IVORY,Bag
Agrolatina,24A9375913,03/09/2025,Entry,85.0,1700.0,0,IVORY,Bag
Agrolatina,24A9375913,04/08/2025,Sale,-18.0,1682.0,30,IVORY,Bag
Agrolatina,24A9375913,04/08/2025,Sale,-180.0,1502.0,30,IVORY,Bag
Agrolatina,24A9375913,04/08/2025,Sale,-162.0,1340.0,30,IVORY,Bag
Agrolatina,24A9375913,04/08/2025,Sale,-540.0,800.0,30,IVORY,Bag
Agrolatina,24A9375913,04/08/2025,Sale,-90.0,710.0,30,IVORY,Bag
Agrolatina,24A9383384,04/07/2025,Entry,1520.0,1520.0,0,JACK SALUTE,Clam
Agrolatina,24A9383384,04/07/2025,Entry,80.0,1600.0,0,JACK SALUTE,Clam
Agrolatina,24A9383384,04/14/2025,Sale,-1360.0,240.0,7,JACK SALUTE,Clam
Agrolatina,24A9383384,04/15/2025,Sale,-160.0,80.0,8,JACK SALUTE,Clam
Agrolatina,24A9383384,04/26/2025,Sale,-80.0,0.0,19,JACK SALUTE,Clam
Agrolatina,24A9384962,02/04/2025,Entry,1120.0,1120.0,0,SWEET GLOBE,Clam
Agrolatina,24A9384962,02/04/2025,Entry,480.0,1600.0,0,SWEET GLOBE,Clam
Agrolatina,24A9384962,03/04/2025,Sale,-480.0,1120.0,28,SWEET GLOBE,Clam
Agrolatina,24A9384962,03/06/2025,Sale,-640.0,480.0,30,SWEET GLOBE,Clam
Agrolatina,24A9384962,03/06/2025,Sale,-480.0,0.0,30,SWEET GLOBE,Clam
Agrolatina,24A9392079,02/11/2025,Entry,1360.0,1360.0,0,CANDY DREAMS,Clam
Agrolatina,24A9392079,02/11/2025,Entry,240.0,1600.0,0,CANDY DREAMS,Clam
Agrolatina,24A9392079,02/24/2025,Sale,-400.0,1200.0,13,CANDY DREAMS,Clam
Agrolatina,24A9392079,02/24/2025,Sale,-160.0,1040.0,13,CANDY DREAMS,Clam
Agrolatina,24A9392079,02/27/2025,Sale,-720.0,320.0,16,CANDY DREAMS,Clam
Agrolatina,24A9392079,03/03/2025,Sale,-80.0,240.0,20,CANDY DREAMS,Clam
Agrolatina,24A9392079,03/04/2025,Sale,-60.0,180.0,21,CANDY DREAMS,Clam
Agrolatina,24A9394989,02/17/2025,Entry,960.0,960.0,0,SWEET GLOBE,Clam
Agrolatina,24A9394989,02/17/2025,Entry,640.0,1600.0,0,SWEET GLOBE,Clam
Agrolatina,24A9394989,03/01/2025,Sale,-640.0,960.0,12,SWEET GLOBE,Clam
Agrolatina,24A9394989,03/01/2025,Sale,-160.0,800.0,12,SWEET GLOBE,Clam
Agrolatina,24A9394989,03/03/2025,Sale,-80.0,720.0,14,SWEET GLOBE,Clam
Agrolatina,24A9394989,03/03/2025,Sale,-160.0,560.0,14,SWEET GLOBE,Clam
Agrolatina,24A9394989,03/03/2025,Sale,-80.0,480.0,14,SWEET GLOBE,Clam
Agrolatina,24A9394989,03/08/2025,Sale,-80.0,400.0,19,SWEET GLOBE,Clam
Agrolatina,24A9394989,03/08/2025,Sale,-160.0,240.0,19,SWEET GLOBE,Clam
Agrolatina,24A9394989,03/11/2025,Sale,-10.0,230.0,22,SWEET GLOBE,Clam
Agrolatina,24A9394989,03/11/2025,Sale,-80.0,150.0,22,SWEET GLOBE,Clam
Agrolatina,24A9394989,03/12/2025,Sale,-60.0,90.0,23,SWEET GLOBE,Clam
Agrolatina,24A9399896,02/17/2025,Entry,1280.0,1280.0,0,SWEET GLOBE,Clam
Agrolatina,24A9399896,02/17/2025,Entry,320.0,1600.0,0,SWEET GLOBE,Clam
Agrolatina,24A9399896,03/05/2025,Sale,-1120.0,480.0,16,SWEET GLOBE,Clam
Agrolatina,24A9399896,03/08/2025,Sale,-80.0,400.0,19,SWEET GLOBE,Clam
Agrolatina,24A9399896,03/10/2025,Sale,-80.0,320.0,21,SWEET GLOBE,Clam
Agrolatina,24A9399896,03/11/2025,Sale,-65.0,255.0,22,SWEET GLOBE,Clam
Agrolatina,24A9399896,03/11/2025,Sale,-100.0,155.0,22,SWEET GLOBE,Clam
Agrolatina,24A9399896,03/17/2025,Sale,-40.0,115.0,28,SWEET GLOBE,Clam
Agrolatina,24A9402897,01/13/2025,Entry,1520.0,1520.0,0,SWEET GLOBE,Clam
Agrolatina,24A9402897,01/13/2025,Entry,80.0,1600.0,0,SWEET GLOBE,Clam
Agrolatina,24A9402897,01/27/2025,Sale,-240.0,1360.0,14,SWEET GLOBE,Clam
Agrolatina,24A9402897,01/28/2025,Sale,-80.0,1280.0,15,SWEET GLOBE,Clam
Agrolatina,24A9402897,01/28/2025,Sale,-80.0,1200.0,15,SWEET GLOBE,Clam
Agrolatina,24A9402897,01/30/2025,Sale,-320.0,880.0,17,SWEET GLOBE,Clam
Agrolatina,24A9402897,01/31/2025,Sale,-160.0,720.0,18,SWEET GLOBE,Clam
Agrolatina,24A9402897,02/03/2025,Sale,-240.0,480.0,21,SWEET GLOBE,Clam
Agrolatina,24A9402897,02/03/2025,Sale,-160.0,320.0,21,SWEET GLOBE,Clam
Agrolatina,24A9402897,02/03/2025,Sale,-80.0,240.0,21,SWEET GLOBE,Clam
Agrolatina,24A9402897,02/04/2025,Sale,-240.0,0.0,22,SWEET GLOBE,Clam
Agrolatina,24A9441270,03/11/2025,Entry,1040.0,1040.0,0,TIMCO,Clam
Agrolatina,24A9441270,03/11/2025,Entry,560.0,1600.0,0,TIMCO,Clam
Agrolatina,24A9441270,04/02/2025,Sale,-160.0,1440.0,22,TIMCO,Clam
Agrolatina,24A9441270,04/03/2025,Sale,-160.0,1280.0,23,TIMCO,Clam
Agrolatina,24A9441270,04/04/2025,Sale,-80.0,1200.0,24,TIMCO,Clam
Agrolatina,24A9441270,04/16/2025,Sale,-80.0,1120.0,36,TIMCO,Clam
Agrolatina,24A9441270,04/18/2025,Sale,-400.0,720.0,38,TIMCO,Clam
Agrolatina,24A9441270,04/21/2025,Sale,-240.0,480.0,41,TIMCO,Clam
Agrolatina,24A9441270,04/26/2025,Sale,-80.0,400.0,46,TIMCO,Clam
Agrolatina,24A9442506,01/19/2025,Entry,1600.0,1600.0,0,ALLISON,Clam
Agrolatina,24A9442506,02/19/2025,Sale,-80.0,1520.0,31,ALLISON,Clam
Agrolatina,24A9442506,02/20/2025,Sale,-320.0,1200.0,32,ALLISON,Clam
Agrolatina,24A9442506,02/27/2025,Sale,-240.0,960.0,39,ALLISON,Clam
Agrolatina,24A9442506,03/03/2025,Sale,-640.0,320.0,43,ALLISON,Clam
Agrolatina,24A9442506,03/08/2025,Sale,-160.0,160.0,48,ALLISON,Clam
Agrolatina,24A9442506,03/10/2025,Sale,-160.0,0.0,50,ALLISON,Clam
Agrolatina,24A9458977,02/01/2025,Entry,1200.0,1200.0,0,CANDY DREAMS,Clam
Agrolatina,24A9458977,02/01/2025,Entry,400.0,1600.0,0,CANDY DREAMS,Clam
Agrolatina,24A9458977,02/01/2025,Sale,-160.0,1440.0,0,CANDY DREAMS,Clam
Agrolatina,24A9458977,02/01/2025,Sale,-240.0,1200.0,0,CANDY DREAMS,Clam
Agrolatina,24A9458977,02/03/2025,Sale,-480.0,720.0,2,CANDY DREAMS,Clam
Agrolatina,24A9458977,02/03/2025,Sale,-480.0,240.0,2,CANDY DREAMS,Clam
Agrolatina,24A9458977,03/01/2025,Sale,-151.0,89.0,28,CANDY DREAMS,Clam
Agrolatina,24A9458977,03/04/2025,Sale,-75.0,14.0,31,CANDY DREAMS,Clam
Agrolatina,24A9460618,01/03/2025,Entry,1360.0,1360.0,0,ALLISON,Clam
Agrolatina,24A9460618,01/03/2025,Entry,240.0,1600.0,0,ALLISON,Clam
Agrolatina,24A9460618,01/28/2025,Sale,-320.0,1280.0,25,ALLISON,Clam
Agrolatina,24A9460618,01/30/2025,Sale,-160.0,1120.0,27,ALLISON,Clam
Agrolatina,24A9460618,01/30/2025,Sale,-80.0,1040.0,27,ALLISON,Clam
Agrolatina,24A9460618,01/31/2025,Sale,-80.0,960.0,28,ALLISON,Clam
Agrolatina,24A9460618,02/03/2025,Sale,-320.0,640.0,31,ALLISON,Clam
Agrolatina,24A9460618,02/05/2025,Sale,-320.0,320.0,33,ALLISON,Clam
Agrolatina,24A9460618,02/05/2025,Sale,-80.0,240.0,33,ALLISON,Clam
Agrolatina,24A9460618,02/06/2025,Sale,-160.0,80.0,34,ALLISON,Clam
Agrolatina,24A9460618,02/13/2025,Sale,-80.0,0.0,41,ALLISON,Clam
Agrolatina,24A9466646,03/04/2025,Entry,320.0,320.0,0,AUTUMN CRISP,Clam
Agrolatina,24A9466646,03/04/2025,Entry,1280.0,1600.0,0,AUTUMN CRISP,Clam
Agrolatina,24A9466862,01/19/2025,Entry,1600.0,1600.0,0,CANDY SNAP,Clam
Agrolatina,24A9466862,02/17/2025,Sale,-240.0,1360.0,29,CANDY SNAP,Clam
Agrolatina,24A9466862,03/03/2025,Sale,-75.0,1285.0,43,CANDY SNAP,Clam
Agrolatina,24A9466862,03/05/2025,Sale,-240.0,1045.0,45,CANDY SNAP,Clam
Agrolatina,24A9466862,03/06/2025,Sale,-490.0,555.0,46,CANDY SNAP,Clam
Agrolatina,24A9466862,03/31/2025,Sale,-317.0,238.0,71,CANDY SNAP,Clam
Agrolatina,24A9467691,03/07/2025,Entry,1280.0,1280.0,0,COTTON CANDY,Clam
Agrolatina,24A9467691,03/07/2025,Entry,320.0,1600.0,0,COTTON CANDY,Clam
Agrolatina,24A9467691,03/31/2025,Sale,-880.0,720.0,24,COTTON CANDY,Clam
Agrolatina,24A9467691,03/31/2025,Sale,-160.0,560.0,24,COTTON CANDY,Clam
Agrolatina,24A9467691,04/01/2025,Sale,-160.0,400.0,25,COTTON CANDY,Clam
Agrolatina,24A9467691,04/03/2025,Sale,-240.0,160.0,27,COTTON CANDY,Clam
Agrolatina,24A9467691,04/03/2025,Sale,-160.0,0.0,27,COTTON CANDY,Clam
Agrolatina,24A9468722,02/11/2025,Entry,480.0,480.0,0,ALLISON,Clam
Agrolatina,24A9468722,02/11/2025,Entry,1120.0,1600.0,0,ALLISON,Clam
Agrolatina,24A9468722,02/22/2025,Sale,-480.0,1120.0,11,ALLISON,Clam
Agrolatina,24A9468722,02/22/2025,Sale,-640.0,480.0,11,ALLISON,Clam
Agrolatina,24A9468722,03/06/2025,Sale,-480.0,0.0,23,ALLISON,Clam
Agrolatina,24A9469322,01/03/2025,Entry,1440.0,1440.0,0,SWEET GLOBE,Clam
Agrolatina,24A9469322,01/03/2025,Entry,160.0,1600.0,0,SWEET GLOBE,Clam
Agrolatina,24A9469322,01/28/2025,Sale,-960.0,640.0,25,SWEET GLOBE,Clam
Agrolatina,24A9469322,01/28/2025,Sale,-240.0,400.0,25,SWEET GLOBE,Clam
Agrolatina,24A9469322,01/28/2025,Sale,-240.0,160.0,25,SWEET GLOBE,Clam
Agrolatina,24A9469322,01/28/2025,Sale,-80.0,80.0,25,SWEET GLOBE,Clam
Agrolatina,24A9469322,01/30/2025,Sale,-80.0,0.0,27,SWEET GLOBE,Clam
Agrolatina,24A9469901,01/18/2025,Entry,1520.0,1520.0,0,SWEET GLOBE,Clam
Agrolatina,24A9469901,01/18/2025,Entry,80.0,1600.0,0,SWEET GLOBE,Clam
Agrolatina,24A9469901,01/21/2025,Sale,-80.0,1520.0,3,SWEET GLOBE,Clam
Agrolatina,24A9469901,01/22/2025,Sale,-800.0,720.0,4,SWEET GLOBE,Clam
Agrolatina,24A9469901,01/23/2025,Sale,-720.0,0.0,5,SWEET GLOBE,Clam
Agrolatina,24A9476496,02/05/2025,Entry,240.0,240.0,0,CANDY DREAMS,Clam
Agrolatina,24A9476496,02/05/2025,Entry,1360.0,1600.0,0,CANDY DREAMS,Clam
Agrolatina,24A9476496,02/13/2025,Sale,-80.0,1520.0,8,CANDY DREAMS,Clam
Agrolatina,24A9476496,02/17/2025,Sale,-240.0,1280.0,12,CANDY DREAMS,Clam
Agrolatina,24A9476496,02/17/2025,Sale,-240.0,1040.0,12,CANDY DREAMS,Clam
Agrolatina,24A9476496,02/18/2025,Sale,-80.0,960.0,13,CANDY DREAMS,Clam
Agrolatina,24A9476496,02/18/2025,Sale,-160.0,800.0,13,CANDY DREAMS,Clam
Agrolatina,24A9476496,02/19/2025,Sale,-160.0,640.0,14,CANDY DREAMS,Clam
Agrolatina,24A9476496,02/20/2025,Sale,-240.0,400.0,15,CANDY DREAMS,Clam
Agrolatina,24A9476496,02/24/2025,Sale,-80.0,320.0,19,CANDY DREAMS,Clam
Agrolatina,24A9476496,02/25/2025,Sale,-50.0,270.0,20,CANDY DREAMS,Clam
Agrolatina,24A9476496,02/25/2025,Sale,-20.0,250.0,20,CANDY DREAMS,Clam
Agrolatina,24A9476496,03/01/2025,Sale,-80.0,170.0,24,CANDY DREAMS,Clam
Agrolatina,24A9476496,03/04/2025,Sale,-80.0,90.0,27,CANDY DREAMS,Clam
Agrolatina,24A9476496,03/11/2025,Sale,-48.0,42.0,34,CANDY DREAMS,Clam
Agrolatina,24A9476496,04/21/2025,Sale,-20.0,22.0,75,CANDY DREAMS,Clam
Agrolatina,24A9482077,02/04/2025,Entry,560.0,560.0,0,ALLISON,Clam
Agrolatina,24A9482077,02/04/2025,Entry,240.0,800.0,0,ALLISON,Clam
Agrolatina,24A9482077,02/04/2025,Entry,640.0,1440.0,0,CANDY DREAMS,Clam
Agrolatina,24A9482077,02/04/2025,Entry,160.0,1600.0,0,CANDY DREAMS,Clam
Agrolatina,24A9482077,02/18/2025,Sale,-240.0,1360.0,14,ALLISON,Clam
Agrolatina,24A9482077,03/03/2025,Sale,-80.0,1280.0,27,CANDY DREAMS,Clam
Agrolatina,24A9482077,03/06/2025,Sale,-560.0,720.0,30,ALLISON,Clam
Agrolatina,24A9482077,03/17/2025,Sale,-73.0,647.0,41,CANDY DREAMS,Clam
Agrolatina,24A9482077,03/25/2025,Sale,-166.0,481.0,49,CANDY DREAMS,Clam
Agrolatina,24A9482077,03/26/2025,Sale,-290.0,191.0,50,CANDY DREAMS,Clam
Agrolatina,24A9482077,03/26/2025,Sale,-5.0,186.0,50,CANDY DREAMS,Clam
Agrolatina,24A9482077,03/28/2025,Sale,-98.0,88.0,52,CANDY DREAMS,Clam
Agrolatina,24A9482502,03/04/2025,Entry,560.0,560.0,0,SWEET GLOBE,Clam
Agrolatina,24A9482502,03/04/2025,Entry,1040.0,1600.0,0,SWEET GLOBE,Clam
Agrolatina,24A9482502,05/02/2025,Sale,-160.0,1440.0,59,SWEET GLOBE,Clam
Agrolatina,24A9482502,05/03/2025,Sale,-153.0,1287.0,60,SWEET GLOBE,Clam
Agrolatina,24A9482502,05/03/2025,Sale,-400.0,887.0,60,SWEET GLOBE,Clam
Agrolatina,24A9482502,05/11/2025,Sale,-80.0,807.0,68,SWEET GLOBE,Clam
Agrolatina,24A9483068,12/27/2024,Entry,1120.0,1120.0,0,IVORY,Clam
Agrolatina,24A9483068,12/27/2024,Entry,480.0,1600.0,0,IVORY,Clam
Agrolatina,24A9483068,01/06/2025,Sale,-1120.0,480.0,10,IVORY,Clam
Agrolatina,24A9483068,01/06/2025,Sale,-480.0,0.0,10,IVORY,Clam
Agrolatina,24A9484278,03/07/2025,Entry,320.0,320.0,0,AUTUMN CRISP,Clam
Agrolatina,24A9484278,03/07/2025,Entry,1280.0,1600.0,0,AUTUMN CRISP,Clam
Agrolatina,24A9484278,03/31/2025,Sale,-320.0,1280.0,24,AUTUMN CRISP,Clam
Agrolatina,24A9484278,04/04/2025,Sale,-160.0,1120.0,28,AUTUMN CRISP,Clam
Agrolatina,24A9484278,04/11/2025,Sale,-720.0,400.0,35,AUTUMN CRISP,Clam
Agrolatina,24A9484278,04/15/2025,Sale,-400.0,0.0,39,AUTUMN CRISP,Clam
Agrolatina,24A9508588,02/04/2025,Entry,400.0,400.0,0,AUTUMN CRISP,Clam
Agrolatina,24A9508588,02/04/2025,Entry,1200.0,1600.0,0,AUTUMN CRISP,Clam
Agrolatina,24A9508588,03/01/2025,Sale,-400.0,1200.0,25,AUTUMN CRISP,Clam
Agrolatina,24A9508588,03/05/2025,Sale,-1200.0,0.0,29,AUTUMN CRISP,Clam
Agrolatina,24A9514045,02/11/2025,Entry,800.0,800.0,0,AUTUMN CRISP,Clam
Agrolatina,24A9514045,02/11/2025,Entry,800.0,1600.0,0,AUTUMN CRISP,Clam
Agrolatina,24A9514045,03/07/2025,Sale,-800.0,800.0,24,AUTUMN CRISP,Clam
Agrolatina,24A9514045,03/08/2025,Sale,-160.0,640.0,25,AUTUMN CRISP,Clam
Agrolatina,24A9514045,03/22/2025,Sale,-640.0,0.0,39,AUTUMN CRISP,Clam
Agrolatina,24A9516921,01/18/2025,Entry,1200.0,1200.0,0,IVORY,Clam
Agrolatina,24A9516921,01/18/2025,Entry,160.0,1360.0,0,IVORY,Clam
Agrolatina,24A9516921,01/18/2025,Entry,240.0,1600.0,0,IVORY,Clam
Agrolatina,24A9516921,01/21/2025,Sale,-800.0,800.0,3,IVORY,Clam
Agrolatina,24A9516921,01/21/2025,Sale,-160.0,640.0,3,IVORY,Clam
Agrolatina,24A9516921,01/21/2025,Sale,-80.0,560.0,3,IVORY,Clam
Agrolatina,24A9516921,01/21/2025,Sale,-160.0,400.0,3,IVORY,Clam
Agrolatina,24A9516921,01/21/2025,Sale,-240.0,160.0,3,IVORY,Clam
Agrolatina,24A9516921,01/31/2025,Sale,-160.0,0.0,13,IVORY,Clam
Agrolatina,24A9519688,02/04/2025,Entry,800.0,800.0,0,SWEET GLOBE,Clam
Agrolatina,24A9519688,02/04/2025,Entry,800.0,1600.0,0,SWEET GLOBE,Clam
Agrolatina,24A9519688,03/06/2025,Sale,-400.0,1200.0,30,SWEET GLOBE,Clam
Agrolatina,24A9519688,03/06/2025,Sale,-800.0,400.0,30,SWEET GLOBE,Clam
Agrolatina,24A9519688,03/07/2025,Sale,-320.0,80.0,31,SWEET GLOBE,Clam
Agrolatina,24A9519688,03/10/2025,Sale,-80.0,0.0,34,SWEET GLOBE,Clam
Agrolatina,24A9532674,01/27/2025,Entry,1600.0,1600.0,0,SWEET GLOBE,Clam
Agrolatina,24A9532674,02/01/2025,Sale,-1280.0,320.0,5,SWEET GLOBE,Clam
Agrolatina,24A9532674,02/03/2025,Sale,-320.0,0.0,7,SWEET GLOBE,Clam
Agrolatina,24A9533788,01/21/2025,Entry,1520.0,1520.0,0,SWEET GLOBE,Clam
Agrolatina,24A9533788,01/21/2025,Entry,80.0,1600.0,0,SWEET GLOBE,Clam
Agrolatina,24A9533788,01/29/2025,Sale,-320.0,1280.0,8,SWEET GLOBE,Clam
Agrolatina,24A9533788,01/29/2025,Sale,-80.0,1200.0,8,SWEET GLOBE,Clam
Agrolatina,24A9533788,01/29/2025,Sale,-80.0,1120.0,8,SWEET GLOBE,Clam
Agrolatina,24A9533788,02/01/2025,Sale,-160.0,960.0,11,SWEET GLOBE,Clam
Agrolatina,24A9533788,02/03/2025,Sale,-80.0,880.0,13,SWEET GLOBE,Clam
Agrolatina,24A9533788,02/03/2025,Sale,-80.0,800.0,13,SWEET GLOBE,Clam
Agrolatina,24A9533788,02/03/2025,Sale,-560.0,240.0,13,SWEET GLOBE,Clam
Agrolatina,24A9533788,02/03/2025,Sale,-16.0,224.0,13,SWEET GLOBE,Clam
Agrolatina,24A9533788,02/04/2025,Sale,-80.0,144.0,14,SWEET GLOBE,Clam
Agrolatina,24A9533788,02/05/2025,Sale,-80.0,64.0,15,SWEET GLOBE,Clam
Agrolatina,24A9533788,02/11/2025,Sale,-64.0,0.0,21,SWEET GLOBE,Clam
Agrolatina,24A9539235,03/04/2025,Entry,1360.0,1360.0,0,IVORY,Clam
Agrolatina,24A9539235,03/04/2025,Entry,240.0,1600.0,0,IVORY,Clam
Agrolatina,24A9539235,03/12/2025,Sale,-160.0,1440.0,8,IVORY,Clam
Agrolatina,24A9539235,03/24/2025,Sale,-5.0,1435.0,20,IVORY,Clam
Agrolatina,24A9539235,03/26/2025,Sale,-40.0,1395.0,22,IVORY,Clam
Agrolatina,24A9539235,03/28/2025,Sale,-40.0,1355.0,24,IVORY,Clam
Agrolatina,24A9539235,04/01/2025,Sale,-560.0,795.0,28,IVORY,Clam
Agrolatina,24A9539235,04/03/2025,Sale,-160.0,635.0,30,IVORY,Clam
Agrolatina,24A9539235,04/07/2025,Sale,-140.0,495.0,34,IVORY,Clam
Agrolatina,24A9558261,01/07/2025,Entry,1360.0,1360.0,0,SWEET GLOBE,Clam
Agrolatina,24A9558261,01/07/2025,Entry,80.0,1440.0,0,SWEET GLOBE,Clam
Agrolatina,24A9558261,01/07/2025,Entry,160.0,1600.0,0,SWEET GLOBE,Clam
Agrolatina,24A9558261,01/17/2025,Sale,-880.0,720.0,10,SWEET GLOBE,Clam
Agrolatina,24A9558261,01/17/2025,Sale,-240.0,480.0,10,SWEET GLOBE,Clam
Agrolatina,24A9558261,01/17/2025,Sale,-240.0,240.0,10,SWEET GLOBE,Clam
Agrolatina,24A9558261,01/17/2025,Sale,-80.0,160.0,10,SWEET GLOBE,Clam
Agrolatina,24A9558261,01/21/2025,Sale,-80.0,80.0,14,SWEET GLOBE,Clam
Agrolatina,24A9558261,01/29/2025,Sale,-80.0,0.0,22,SWEET GLOBE,Clam
Agrolatina,24A9566082,03/04/2025,Entry,720.0,720.0,0,CANDY DREAMS,Clam
Agrolatina,24A9566082,03/04/2025,Entry,880.0,1600.0,0,CANDY DREAMS,Clam
Agrolatina,24A9566082,03/25/2025,Sale,-800.0,800.0,21,CANDY DREAMS,Clam
Agrolatina,24A9566082,04/10/2025,Sale,-560.0,240.0,37,CANDY DREAMS,Clam
Agrolatina,24A9566082,04/11/2025,Sale,-80.0,160.0,38,CANDY DREAMS,Clam
Agrolatina,24A9580303,02/11/2025,Entry,800.0,800.0,0,SWEET GLOBE,Clam
Agrolatina,24A9580303,02/11/2025,Entry,800.0,1600.0,0,SWEET GLOBE,Clam
Agrolatina,24A9580303,03/06/2025,Sale,-800.0,800.0,23,SWEET GLOBE,Clam
Agrolatina,24A9580303,03/07/2025,Sale,-800.0,0.0,24,SWEET GLOBE,Clam
Agrolatina,24A9588201,01/03/2025,Entry,1280.0,1280.0,0,SWEET GLOBE,Clam
Agrolatina,24A9588201,01/03/2025,Entry,80.0,1360.0,0,SWEET GLOBE,Clam
Agrolatina,24A9588201,01/03/2025,Entry,240.0,1600.0,0,SWEET GLOBE,Clam
Agrolatina,24A9588201,01/27/2025,Sale,-80.0,1520.0,24,SWEET GLOBE,Clam
Agrolatina,24A9588201,01/27/2025,Sale,-80.0,1440.0,24,SWEET GLOBE,Clam
Agrolatina,24A9588201,01/29/2025,Sale,-80.0,1360.0,26,SWEET GLOBE,Clam
Agrolatina,24A9588201,01/30/2025,Sale,-1120.0,240.0,27,SWEET GLOBE,Clam
Agrolatina,24A9588201,01/30/2025,Sale,-80.0,160.0,27,SWEET GLOBE,Clam
Agrolatina,24A9588201,01/30/2025,Sale,-80.0,80.0,27,SWEET GLOBE,Clam
Agrolatina,24A9588201,02/05/2025,Sale,-80.0,0.0,33,SWEET GLOBE,Clam
Agrolatina,24A9593126,02/04/2025,Entry,800.0,800.0,0,SWEET GLOBE,Clam
Agrolatina,24A9593126,02/04/2025,Entry,800.0,1600.0,0,SWEET GLOBE,Clam
Agrolatina,24A9593126,02/19/2025,Sale,-400.0,1200.0,15,SWEET GLOBE,Clam
Agrolatina,24A9593126,03/06/2025,Sale,-800.0,400.0,30,SWEET GLOBE,Clam
Agrolatina,24A9593126,03/07/2025,Sale,-400.0,0.0,31,SWEET GLOBE,Clam
Agrolatina,24A9611322,02/04/2025,Entry,640.0,640.0,0,SWEET GLOBE,Clam
Agrolatina,24A9611322,02/04/2025,Entry,960.0,1600.0,0,SWEET GLOBE,Clam
Agrolatina,24A9611322,03/06/2025,Sale,-160.0,1440.0,30,SWEET GLOBE,Clam
Agrolatina,24A9611322,03/13/2025,Sale,-800.0,640.0,37,SWEET GLOBE,Clam
Agrolatina,24A9611322,03/19/2025,Sale,-640.0,0.0,43,SWEET GLOBE,Clam
Agrolatina,24A9617233,02/01/2025,Entry,1440.0,1440.0,0,ALLISON,Clam
Agrolatina,24A9617233,02/01/2025,Entry,160.0,1600.0,0,ALLISON,Clam
Agrolatina,24A9617233,02/12/2025,Sale,-80.0,1520.0,11,ALLISON,Clam
Agrolatina,24A9617233,02/18/2025,Sale,-80.0,1440.0,17,ALLISON,Clam
Agrolatina,24A9617233,02/19/2025,Sale,-640.0,800.0,18,ALLISON,Clam
Agrolatina,24A9617233,03/01/2025,Sale,-160.0,640.0,28,ALLISON,Clam
Agrolatina,24A9617233,03/05/2025,Sale,-240.0,400.0,32,ALLISON,Clam
Agrolatina,24A9617233,03/06/2025,Sale,-320.0,80.0,33,ALLISON,Clam
Agrolatina,24A9617233,03/06/2025,Sale,-80.0,0.0,33,ALLISON,Clam
Agrolatina,24A9618461,02/01/2025,Entry,1120.0,1120.0,0,ALLISON,Clam
Agrolatina,24A9618461,02/01/2025,Entry,480.0,1600.0,0,ALLISON,Clam
Agrolatina,24A9618461,02/25/2025,Sale,-480.0,1120.0,24,ALLISON,Clam
Agrolatina,24A9618461,03/01/2025,Sale,-80.0,1040.0,28,ALLISON,Clam
Agrolatina,24A9618461,03/03/2025,Sale,-80.0,960.0,30,ALLISON,Clam
Agrolatina,24A9618461,03/04/2025,Sale,-320.0,640.0,31,ALLISON,Clam
Agrolatina,24A9618461,03/05/2025,Sale,-160.0,480.0,32,ALLISON,Clam
Agrolatina,24A9618461,03/06/2025,Sale,-480.0,0.0,33,ALLISON,Clam
Agrolatina,24A9620800,04/23/2025,Entry,1280.0,1280.0,0,SWEET GLOBE,Clam
Agrolatina,24A9620800,04/23/2025,Entry,320.0,1600.0,0,SWEET GLOBE,Clam
Agrolatina,24A9620800,05/08/2025,Sale,-320.0,1280.0,15,SWEET GLOBE,Clam
Agrolatina,24A9620800,05/08/2025,Sale,-960.0,320.0,15,SWEET GLOBE,Clam
Agrolatina,24A9620800,05/08/2025,Sale,-320.0,0.0,15,SWEET GLOBE,Clam
Agrolatina,24A9620902,02/24/2025,Entry,400.0,400.0,0,AUTUMN CRISP,Clam
Agrolatina,24A9620902,02/24/2025,Entry,1200.0,1600.0,0,AUTUMN CRISP,Clam
Agrolatina,24A9621180,01/13/2025,Entry,1520.0,1520.0,0,IVORY,Clam
Agrolatina,24A9621180,01/13/2025,Entry,80.0,1600.0,0,IVORY,Clam
Agrolatina,24A9621180,01/20/2025,Sale,-1120.0,480.0,7,IVORY,Clam
Agrolatina,24A9621180,01/20/2025,Sale,-80.0,400.0,7,IVORY,Clam
Agrolatina,24A9621180,01/22/2025,Sale,-400.0,0.0,9,IVORY,Clam
Agrolatina,24A9621452,03/03/2025,Entry,160.0,160.0,0,AUTUMN CRISP,Clam
Agrolatina,24A9621452,03/03/2025,Entry,1440.0,1600.0,0,AUTUMN CRISP,Clam
Agrolatina,24A9621452,03/20/2025,Sale,-320.0,1280.0,17,AUTUMN CRISP,Clam
Agrolatina,24A9621452,03/25/2025,Sale,-720.0,560.0,22,AUTUMN CRISP,Clam
Agrolatina,24A9621452,03/27/2025,Sale,-160.0,400.0,24,AUTUMN CRISP,Clam
Agrolatina,24A9621452,03/27/2025,Sale,-400.0,0.0,24,AUTUMN CRISP,Clam
Agrolatina,24A9621555,02/12/2025,Entry,1600.0,1600.0,0,TIMCO,Clam
Agrolatina,24A9621555,03/15/2025,Sale,-1200.0,400.0,31,TIMCO,Clam
Agrolatina,24A9621555,03/17/2025,Sale,-400.0,0.0,33,TIMCO,Clam
Agrolatina,24A9621684,12/23/2024,Entry,1600.0,1600.0,0,ALLISON,Clam
Agrolatina,24A9621684,01/11/2025,Sale,-480.0,1120.0,19,ALLISON,Clam
Agrolatina,24A9621684,01/11/2025,Sale,-1120.0,0.0,19,ALLISON,Clam
Agrolatina,24A9622145,12/29/2024,Entry,1440.0,1440.0,0,SWEET GLOBE,Clam
Agrolatina,24A9622145,12/29/2024,Entry,160.0,1600.0,0,SWEET GLOBE,Clam
Agrolatina,24A9622145,01/16/2025,Sale,-1440.0,160.0,18,SWEET GLOBE,Clam
Agrolatina,24A9622145,01/18/2025,Sale,-160.0,0.0,20,SWEET GLOBE,Clam
Agrolatina,24A9622443,03/10/2025,Entry,1360.0,1360.0,0,TIMCO,Clam
Agrolatina,24A9622443,03/10/2025,Entry,240.0,1600.0,0,TIMCO,Clam
Agrolatina,24A9622443,03/26/2025,Sale,-320.0,1280.0,16,TIMCO,Clam
Agrolatina,24A9622443,04/06/2025,Sale,-80.0,1200.0,27,TIMCO,Clam
Agrolatina,24A9622443,04/06/2025,Sale,-240.0,960.0,27,TIMCO,Clam
Agrolatina,24A9622443,04/09/2025,Sale,-160.0,800.0,30,TIMCO,Clam
Agrolatina,24A9622443,04/12/2025,Sale,-480.0,320.0,33,TIMCO,Clam
Agrolatina,24A9622443,04/15/2025,Sale,-320.0,0.0,36,TIMCO,Clam
Agrolatina,24A9623012,12/29/2024,Entry,1280.0,1280.0,0,ALLISON,Clam
Agrolatina,24A9623012,12/29/2024,Entry,320.0,1600.0,0,ALLISON,Clam
Agrolatina,24A9623012,01/13/2025,Sale,-320.0,1280.0,15,ALLISON,Clam
Agrolatina,24A9623012,01/14/2025,Sale,-1200.0,80.0,16,ALLISON,Clam
Agrolatina,24A9623012,01/15/2025,Sale,-80.0,0.0,17,ALLISON,Clam
Agrolatina,24A9623100,02/24/2025,Entry,240.0,240.0,0,AUTUMN CRISP,Clam
Agrolatina,24A9623100,02/24/2025,Entry,1360.0,1600.0,0,AUTUMN CRISP,Clam
Agrolatina,24A9623157,02/24/2025,Entry,1120.0,1120.0,0,TIMCO,Clam
Agrolatina,24A9623157,02/24/2025,Entry,480.0,1600.0,0,TIMCO,Clam
Agrolatina,24A9623157,03/14/2025,Sale,-160.0,1440.0,18,TIMCO,Clam
Agrolatina,24A9623157,03/24/2025,Sale,-960.0,480.0,28,TIMCO,Clam
Agrolatina,24A9623157,04/06/2025,Sale,-480.0,0.0,41,TIMCO,Clam
Agrolatina,24A9623162,04/14/2025,Entry,1440.0,1440.0,0,SWEET GLOBE,Clam
Agrolatina,24A9623162,04/14/2025,Entry,160.0,1600.0,0,SWEET GLOBE,Clam
Agrolatina,24A9623162,04/26/2025,Sale,-560.0,1040.0,12,SWEET GLOBE,Clam
Agrolatina,24A9623162,04/28/2025,Sale,-160.0,880.0,14,SWEET GLOBE,Clam
Agrolatina,24A9623162,04/29/2025,Sale,-880.0,0.0,15,SWEET GLOBE,Clam
Agrolatina,24A9623368,02/24/2025,Entry,1440.0,1440.0,0,IVORY,Clam
Agrolatina,24A9623368,02/24/2025,Entry,80.0,1520.0,0,IVORY,Clam
Agrolatina,24A9623368,02/24/2025,Entry,80.0,1600.0,0,IVORY,Clam
Agrolatina,24A9623368,02/27/2025,Sale,-1440.0,160.0,3,IVORY,Clam
Agrolatina,24A9623368,02/27/2025,Sale,-80.0,80.0,3,IVORY,Clam
Agrolatina,24A9623368,03/06/2025,Sale,-80.0,0.0,10,IVORY,Clam
Agrolatina,24A9623753,03/03/2025,Entry,320.0,320.0,0,AUTUMN CRISP,Clam
Agrolatina,24A9623753,03/03/2025,Entry,1280.0,1600.0,0,AUTUMN CRISP,Clam
Agrolatina,24A9623820,02/03/2025,Entry,480.0,480.0,0,ALLISON,Clam
Agrolatina,24A9623820,02/03/2025,Entry,1040.0,1520.0,0,ALLISON,Clam
Agrolatina,24A9623820,02/03/2025,Entry,80.0,1600.0,0,TIMCO,Clam
Agrolatina,24A9623820,02/25/2025,Sale,-480.0,1120.0,22,ALLISON,Clam
Agrolatina,24A9623820,03/01/2025,Sale,-80.0,1040.0,26,TIMCO,Clam
Agrolatina,24A9623820,03/04/2025,Sale,-640.0,400.0,29,ALLISON,Clam
Agrolatina,24A9623820,03/05/2025,Sale,-400.0,0.0,30,ALLISON,Clam
Agrolatina,24A9630410,02/17/2025,Entry,880.0,880.0,0,SWEET GLOBE,Clam
Agrolatina,24A9630410,02/17/2025,Entry,720.0,1600.0,0,SWEET GLOBE,Clam
Agrolatina,24A9630410,03/01/2025,Sale,-320.0,1280.0,12,SWEET GLOBE,Clam
Agrolatina,24A9630410,03/01/2025,Sale,-240.0,1040.0,12,SWEET GLOBE,Clam
Agrolatina,24A9630410,03/03/2025,Sale,-80.0,960.0,14,SWEET GLOBE,Clam
Agrolatina,24A9630410,03/03/2025,Sale,-160.0,800.0,14,SWEET GLOBE,Clam
Agrolatina,24A9630410,03/03/2025,Sale,-320.0,480.0,14,SWEET GLOBE,Clam
Agrolatina,24A9630410,03/03/2025,Sale,-80.0,400.0,14,SWEET GLOBE,Clam
Agrolatina,24A9630410,03/04/2025,Sale,-80.0,320.0,15,SWEET GLOBE,Clam
Agrolatina,24A9630410,03/08/2025,Sale,-80.0,240.0,19,SWEET GLOBE,Clam
Agrolatina,24A9630410,03/10/2025,Sale,-50.0,190.0,21,SWEET GLOBE,Clam
Agrolatina,24A9630410,03/11/2025,Sale,-60.0,130.0,22,SWEET GLOBE,Clam
Agrolatina,24A9630410,03/11/2025,Sale,-60.0,70.0,22,SWEET GLOBE,Clam
Agrolatina,24A9647970,03/04/2025,Entry,80.0,80.0,0,ALLISON,Clam
Agrolatina,24A9647970,03/04/2025,Entry,320.0,400.0,0,COTTON CANDY,Clam
Agrolatina,24A9647970,03/04/2025,Entry,320.0,720.0,0,IVORY,Clam
Agrolatina,24A9647970,03/04/2025,Entry,160.0,880.0,0,IVORY,Clam
Agrolatina,24A9647970,03/04/2025,Entry,640.0,1520.0,0,SWEET GLOBE,Clam
Agrolatina,24A9647970,03/04/2025,Entry,80.0,1600.0,0,SWEET GLOBE,Clam
Agrolatina,24A9647970,03/13/2025,Sale,-240.0,1360.0,9,SWEET GLOBE,Clam
Agrolatina,24A9647970,03/13/2025,Sale,-200.0,1160.0,9,SWEET GLOBE,Clam
Agrolatina,24A9647970,03/14/2025,Sale,-40.0,1120.0,10,SWEET GLOBE,Clam
Agrolatina,24A9647970,03/17/2025,Sale,-39.0,1081.0,13,COTTON CANDY,Clam
Agrolatina,24A9647970,03/17/2025,Sale,-20.0,1061.0,13,SWEET GLOBE,Clam
Agrolatina,24A9647970,03/20/2025,Sale,-80.0,981.0,16,ALLISON,Clam
Agrolatina,24A9647970,03/25/2025,Sale,-20.0,961.0,21,IVORY,Clam
Agrolatina,24A9647970,03/25/2025,Sale,-40.0,921.0,21,IVORY,Clam
Agrolatina,24A9647970,03/25/2025,Sale,-40.0,881.0,21,IVORY,Clam
Agrolatina,24A9647970,03/27/2025,Sale,-160.0,721.0,23,IVORY,Clam
Agrolatina,24A9647970,03/27/2025,Sale,-20.0,701.0,23,IVORY,Clam
Agrolatina,24A9647970,03/29/2025,Sale,-60.0,641.0,25,IVORY,Clam
Agrolatina,24A9647970,04/11/2025,Sale,-160.0,481.0,38,COTTON CANDY,Clam
Agrolatina,24A9648730,03/04/2025,Entry,1200.0,1200.0,0,TIMCO,Clam
Agrolatina,24A9648730,03/04/2025,Entry,400.0,1600.0,0,TIMCO,Clam
Agrolatina,24A9648730,03/21/2025,Sale,-240.0,1360.0,17,TIMCO,Clam
Agrolatina,24A9648730,03/28/2025,Sale,-960.0,400.0,24,TIMCO,Clam
Agrolatina,24A9648730,03/31/2025,Sale,-400.0,0.0,27,TIMCO,Clam
Agrolatina,24A9657299,02/01/2025,Entry,1440.0,1440.0,0,CANDY DREAMS,Clam
Agrolatina,24A9657299,02/01/2025,Entry,160.0,1600.0,0,CANDY DREAMS,Clam
Agrolatina,24A9657299,02/21/2025,Sale,-480.0,1120.0,20,CANDY DREAMS,Clam
Agrolatina,24A9657299,02/25/2025,Sale,-480.0,640.0,24,CANDY DREAMS,Clam
Agrolatina,24A9657299,02/25/2025,Sale,-320.0,320.0,24,CANDY DREAMS,Clam
Agrolatina,24A9657299,02/25/2025,Sale,-160.0,160.0,24,CANDY DREAMS,Clam
Agrolatina,24A9657299,03/01/2025,Sale,-3.0,157.0,28,CANDY DREAMS,Clam
Agrolatina,24A9657299,03/06/2025,Sale,-9.0,148.0,33,CANDY DREAMS,Clam
Agrolatina,24A9659202,02/17/2025,Entry,1040.0,1040.0,0,SWEET GLOBE,Clam
Agrolatina,24A9659202,02/17/2025,Entry,560.0,1600.0,0,SWEET GLOBE,Clam
Agrolatina,24A9659202,03/08/2025,Sale,-160.0,1440.0,19,SWEET GLOBE,Clam
Agrolatina,24A9659202,03/10/2025,Sale,-40.0,1400.0,21,SWEET GLOBE,Clam
Agrolatina,24A9659202,03/11/2025,Sale,-40.0,1360.0,22,SWEET GLOBE,Clam
Agrolatina,24A9659202,03/11/2025,Sale,-220.0,1140.0,22,SWEET GLOBE,Clam
Agrolatina,24A9659202,03/11/2025,Sale,-467.0,673.0,22,SWEET GLOBE,Clam
Agrolatina,24A9659202,03/11/2025,Sale,-260.0,413.0,22,SWEET GLOBE,Clam
Agrolatina,24A9659202,03/14/2025,Sale,-80.0,333.0,25,SWEET GLOBE,Clam
Agrolatina,24A9659202,03/15/2025,Sale,-30.0,303.0,26,SWEET GLOBE,Clam
Agrolatina,24A9659202,03/15/2025,Sale,-30.0,273.0,26,SWEET GLOBE,Clam
Agrolatina,24A9660688,02/17/2025,Entry,800.0,800.0,0,SWEET GLOBE,Clam
Agrolatina,24A9660688,02/17/2025,Entry,800.0,1600.0,0,SWEET GLOBE,Clam
Agrolatina,24A9660688,03/11/2025,Sale,-215.0,1385.0,22,SWEET GLOBE,Clam
Agrolatina,24A9660688,03/13/2025,Sale,-123.0,1262.0,24,SWEET GLOBE,Clam
Agrolatina,24A9660688,03/13/2025,Sale,-40.0,1222.0,24,SWEET GLOBE,Clam
Agrolatina,24A9660688,03/13/2025,Sale,-240.0,982.0,24,SWEET GLOBE,Clam
Agrolatina,24A9660688,03/14/2025,Sale,-51.0,931.0,25,SWEET GLOBE,Clam
Agrolatina,24A9660688,03/15/2025,Sale,-80.0,851.0,26,SWEET GLOBE,Clam
Agrolatina,24A9660688,03/15/2025,Sale,-240.0,611.0,26,SWEET GLOBE,Clam
Agrolatina,24A9660688,03/15/2025,Sale,-60.0,551.0,26,SWEET GLOBE,Clam
Agrolatina,24A9660688,03/17/2025,Sale,-40.0,511.0,28,SWEET GLOBE,Clam
Agrolatina,24A9661736,02/17/2025,Entry,1440.0,1440.0,0,IVORY,Clam
Agrolatina,24A9661736,02/17/2025,Entry,160.0,1600.0,0,IVORY,Clam
Agrolatina,24A9661736,03/06/2025,Sale,-960.0,640.0,17,IVORY,Clam
Agrolatina,24A9661736,03/22/2025,Sale,-40.0,600.0,33,IVORY,Clam
Agrolatina,24A9661736,03/22/2025,Sale,-160.0,440.0,33,IVORY,Clam
Agrolatina,24A9661736,03/24/2025,Sale,-80.0,360.0,35,IVORY,Clam
Agrolatina,24A9661736,03/27/2025,Sale,-130.0,230.0,38,IVORY,Clam
Agrolatina,24A9663967,02/17/2025,Entry,960.0,960.0,0,SWEET GLOBE,Clam
Agrolatina,24A9663967,02/17/2025,Entry,640.0,1600.0,0,SWEET GLOBE,Clam
Agrolatina,24A9663967,03/07/2025,Sale,-80.0,1520.0,18,SWEET GLOBE,Clam
Agrolatina,24A9663967,03/08/2025,Sale,-320.0,1200.0,19,SWEET GLOBE,Clam
Agrolatina,24A9663967,03/08/2025,Sale,-240.0,960.0,19,SWEET GLOBE,Clam
Agrolatina,24A9663967,03/10/2025,Sale,-100.0,860.0,21,SWEET GLOBE,Clam
Agrolatina,24A9663967,03/10/2025,Sale,-240.0,620.0,21,SWEET GLOBE,Clam
Agrolatina,24A9663967,03/11/2025,Sale,-220.0,400.0,22,SWEET GLOBE,Clam
Agrolatina,24A9663967,03/11/2025,Sale,-60.0,340.0,22,SWEET GLOBE,Clam
Agrolatina,24A9663967,03/11/2025,Sale,-54.0,286.0,22,SWEET GLOBE,Clam
Agrolatina,24A9663967,03/15/2025,Sale,-40.0,246.0,26,SWEET GLOBE,Clam
Agrolatina,24A9668890,02/17/2025,Entry,1120.0,1120.0,0,IVORY,Clam
Agrolatina,24A9668890,02/17/2025,Entry,400.0,1520.0,0,IVORY,Clam
Agrolatina,24A9668890,02/17/2025,Entry,80.0,1600.0,0,IVORY,Clam
Agrolatina,24A9668890,03/11/2025,Sale,-240.0,1360.0,22,IVORY,Clam
Agrolatina,24A9668890,03/21/2025,Sale,-279.0,1081.0,32,IVORY,Clam
Agrolatina,24A9668890,03/22/2025,Sale,-240.0,841.0,33,IVORY,Clam
Agrolatina,24A9668890,03/22/2025,Sale,-80.0,761.0,33,IVORY,Clam
Agrolatina,24A9668890,03/22/2025,Sale,-120.0,641.0,33,IVORY,Clam
Agrolatina,24A9668890,03/24/2025,Sale,-182.0,459.0,35,IVORY,Clam
Agrolatina,24A9668890,03/26/2025,Sale,-80.0,379.0,37,IVORY,Clam
Agrolatina,24A9668890,03/29/2025,Sale,-40.0,339.0,40,IVORY,Clam
Agrolatina,24A9668890,03/29/2025,Sale,-120.0,219.0,40,IVORY,Clam
Agrolatina,24A9670825,01/18/2025,Entry,1520.0,1520.0,0,SWEET GLOBE,Clam
Agrolatina,24A9670825,01/18/2025,Entry,80.0,1600.0,0,SWEET GLOBE,Clam
Agrolatina,24A9670825,02/05/2025,Sale,-160.0,1440.0,18,SWEET GLOBE,Clam
Agrolatina,24A9670825,02/05/2025,Sale,-240.0,1200.0,18,SWEET GLOBE,Clam
Agrolatina,24A9670825,02/05/2025,Sale,-80.0,1120.0,18,SWEET GLOBE,Clam
Agrolatina,24A9670825,02/06/2025,Sale,-480.0,640.0,19,SWEET GLOBE,Clam
Agrolatina,24A9670825,02/06/2025,Sale,-160.0,480.0,19,SWEET GLOBE,Clam
Agrolatina,24A9670825,02/06/2025,Sale,-80.0,400.0,19,SWEET GLOBE,Clam
Agrolatina,24A9670825,02/06/2025,Sale,-240.0,160.0,19,SWEET GLOBE,Clam
Agrolatina,24A9670825,02/07/2025,Sale,-80.0,80.0,20,SWEET GLOBE,Clam
Agrolatina,24A9670825,02/12/2025,Sale,-80.0,0.0,25,SWEET GLOBE,Clam
Agrolatina,24A9671068,12/22/2024,Entry,1280.0,1280.0,0,CANDY SNAP,Clam
Agrolatina,24A9671068,12/22/2024,Entry,320.0,1600.0,0,CANDY SNAP,Clam
Agrolatina,24A9671068,01/02/2025,Sale,-160.0,1440.0,11,CANDY SNAP,Clam
Agrolatina,24A9671068,01/02/2025,Sale,-1120.0,320.0,11,CANDY SNAP,Clam
Agrolatina,24A9671068,01/02/2025,Sale,-320.0,0.0,11,CANDY SNAP,Clam
Agrolatina,24A9673151,02/11/2025,Entry,720.0,720.0,0,SWEET GLOBE,Clam
Agrolatina,24A9673151,02/11/2025,Entry,880.0,1600.0,0,SWEET GLOBE,Clam
Agrolatina,24A9673151,02/21/2025,Sale,-160.0,1440.0,10,SWEET GLOBE,Clam
Agrolatina,24A9673151,02/22/2025,Sale,-160.0,1280.0,11,SWEET GLOBE,Clam
Agrolatina,24A9673151,02/22/2025,Sale,-240.0,1040.0,11,SWEET GLOBE,Clam
Agrolatina,24A9673151,02/24/2025,Sale,-254.0,786.0,13,SWEET GLOBE,Clam
Agrolatina,24A9673151,02/27/2025,Sale,-400.0,386.0,16,SWEET GLOBE,Clam
Agrolatina,24A9673151,03/03/2025,Sale,-80.0,306.0,20,SWEET GLOBE,Clam
Agrolatina,24A9673151,03/05/2025,Sale,-160.0,146.0,22,SWEET GLOBE,Clam
Agrolatina,24A9673151,03/17/2025,Sale,-40.0,106.0,34,SWEET GLOBE,Clam
Agrolatina,24A9688005,02/01/2025,Entry,480.0,480.0,0,CANDY DREAMS,Clam
Agrolatina,24A9688005,02/01/2025,Entry,1120.0,1600.0,0,CANDY DREAMS,Clam
Agrolatina,24A9688005,02/25/2025,Sale,-560.0,1040.0,24,CANDY DREAMS,Clam
Agrolatina,24A9688005,02/25/2025,Sale,-480.0,560.0,24,CANDY DREAMS,Clam
Agrolatina,24A9688005,03/01/2025,Sale,-157.0,403.0,28,CANDY DREAMS,Clam
Agrolatina,24A9688005,03/01/2025,Sale,-13.0,390.0,28,CANDY DREAMS,Clam
Agrolatina,24A9688005,03/04/2025,Sale,-255.0,135.0,31,CANDY DREAMS,Clam
Agrolatina,24A9688005,03/06/2025,Sale,-52.0,83.0,33,CANDY DREAMS,Clam
Agrolatina,24A9688860,02/17/2025,Entry,880.0,880.0,0,SWEET GLOBE,Clam
Agrolatina,24A9688860,02/17/2025,Entry,720.0,1600.0,0,SWEET GLOBE,Clam
Agrolatina,24A9688860,03/06/2025,Sale,-80.0,1520.0,17,SWEET GLOBE,Clam
Agrolatina,24A9688860,03/06/2025,Sale,-50.0,1470.0,17,SWEET GLOBE,Clam
Agrolatina,24A9688860,03/07/2025,Sale,-480.0,990.0,18,SWEET GLOBE,Clam
Agrolatina,24A9688860,03/08/2025,Sale,-80.0,910.0,19,SWEET GLOBE,Clam
Agrolatina,24A9688860,03/08/2025,Sale,-240.0,670.0,19,SWEET GLOBE,Clam
Agrolatina,24A9688860,03/10/2025,Sale,-480.0,190.0,21,SWEET GLOBE,Clam
Agrolatina,24A9688860,03/11/2025,Sale,-60.0,130.0,22,SWEET GLOBE,Clam
Agrolatina,24A9689390,01/30/2025,Entry,1520.0,1520.0,0,SWEET GLOBE,Clam
Agrolatina,24A9689390,01/30/2025,Entry,80.0,1600.0,0,SWEET GLOBE,Clam
Agrolatina,24A9689390,02/15/2025,Sale,-80.0,1520.0,16,SWEET GLOBE,Clam
Agrolatina,24A9689390,02/17/2025,Sale,-80.0,1440.0,18,SWEET GLOBE,Clam
Agrolatina,24A9689390,02/17/2025,Sale,-320.0,1120.0,18,SWEET GLOBE,Clam
Agrolatina,24A9689390,02/21/2025,Sale,-80.0,1040.0,22,SWEET GLOBE,Clam
Agrolatina,24A9689390,02/21/2025,Sale,-80.0,960.0,22,SWEET GLOBE,Clam
Agrolatina,24A9689390,02/21/2025,Sale,-160.0,800.0,22,SWEET GLOBE,Clam
Agrolatina,24A9689390,02/22/2025,Sale,-80.0,720.0,23,SWEET GLOBE,Clam
Agrolatina,24A9689390,02/22/2025,Sale,-80.0,640.0,23,SWEET GLOBE,Clam
Agrolatina,24A9689390,02/24/2025,Sale,-160.0,480.0,25,SWEET GLOBE,Clam
Agrolatina,24A9689390,02/25/2025,Sale,-40.0,440.0,26,SWEET GLOBE,Clam
Agrolatina,24A9689390,02/28/2025,Sale,-10.0,430.0,29,SWEET GLOBE,Clam
Agrolatina,24A9689390,02/28/2025,Sale,-40.0,390.0,29,SWEET GLOBE,Clam
Agrolatina,24A9689390,02/28/2025,Sale,-80.0,310.0,29,SWEET GLOBE,Clam
Agrolatina,24A9689390,03/05/2025,Sale,-40.0,270.0,34,SWEET GLOBE,Clam
Agrolatina,24A9690281,02/06/2025,Entry,1120.0,1120.0,0,ALLISON,Clam
Agrolatina,24A9690281,02/06/2025,Entry,480.0,1600.0,0,ALLISON,Clam
Agrolatina,24A9690281,02/21/2025,Sale,-80.0,1520.0,15,ALLISON,Clam
Agrolatina,24A9690281,03/04/2025,Sale,-240.0,1280.0,26,ALLISON,Clam
Agrolatina,24A9690281,03/04/2025,Sale,-160.0,1120.0,26,ALLISON,Clam
Agrolatina,24A9690281,03/12/2025,Sale,-80.0,1040.0,34,ALLISON,Clam
Agrolatina,24A9690281,03/13/2025,Sale,-560.0,480.0,35,ALLISON,Clam
Agrolatina,24A9690281,03/18/2025,Sale,-480.0,0.0,40,ALLISON,Clam
Agrolatina,24A9690426,01/07/2025,Entry,880.0,880.0,0,SWEET GLOBE,Clam
Agrolatina,24A9690426,01/07/2025,Entry,80.0,960.0,0,SWEET GLOBE,Clam
Agrolatina,24A9690426,01/07/2025,Entry,640.0,1600.0,0,SWEET GLOBE,Clam
Agrolatina,24A9690426,01/20/2025,Sale,-320.0,1280.0,13,SWEET GLOBE,Clam
Agrolatina,24A9690426,01/20/2025,Sale,-160.0,1120.0,13,SWEET GLOBE,Clam
Agrolatina,24A9690426,01/21/2025,Sale,-240.0,880.0,14,SWEET GLOBE,Clam
Agrolatina,24A9690426,01/21/2025,Sale,-320.0,560.0,14,SWEET GLOBE,Clam
Agrolatina,24A9690426,01/29/2025,Sale,-80.0,480.0,22,SWEET GLOBE,Clam
Agrolatina,24A9690426,01/31/2025,Sale,-320.0,160.0,24,SWEET GLOBE,Clam
Agrolatina,24A9690426,02/03/2025,Sale,-80.0,80.0,27,SWEET GLOBE,Clam
Agrolatina,24A9690426,02/12/2025,Sale,-80.0,0.0,36,SWEET GLOBE,Clam
Agrolatina,24A9696130,01/03/2025,Entry,1360.0,1360.0,0,CANDY SNAP,Clam
Agrolatina,24A9696130,01/03/2025,Entry,240.0,1600.0,0,CANDY SNAP,Clam
Agrolatina,24A9696130,01/15/2025,Sale,-400.0,1200.0,12,CANDY SNAP,Clam
Agrolatina,24A9696130,01/17/2025,Sale,-80.0,1120.0,14,CANDY SNAP,Clam
Agrolatina,24A9696130,01/18/2025,Sale,-320.0,800.0,15,CANDY SNAP,Clam
Agrolatina,24A9696130,01/18/2025,Sale,-560.0,240.0,15,CANDY SNAP,Clam
Agrolatina,24A9696130,01/18/2025,Sale,-240.0,0.0,15,CANDY SNAP,Clam
Agrolatina,24A9700915,01/03/2025,Entry,1280.0,1280.0,0,ALLISON,Clam
Agrolatina,24A9700915,01/03/2025,Entry,320.0,1600.0,0,ALLISON,Clam
Agrolatina,24A9700915,01/15/2025,Sale,-400.0,1200.0,12,ALLISON,Clam
Agrolatina,24A9700915,01/15/2025,Sale,-160.0,1040.0,12,ALLISON,Clam
Agrolatina,24A9700915,01/15/2025,Sale,-320.0,720.0,12,ALLISON,Clam
Agrolatina,24A9700915,01/16/2025,Sale,-720.0,0.0,13,ALLISON,Clam
Agrolatina,24A9705909,02/24/2025,Entry,1440.0,1440.0,0,TIMCO,Clam
Agrolatina,24A9705909,02/24/2025,Entry,80.0,1520.0,0,TIMCO,Clam
Agrolatina,24A9705909,02/24/2025,Entry,80.0,1600.0,0,TIMCO,Clam
Agrolatina,24A9706150,02/24/2025,Entry,1040.0,1040.0,0,TIMCO,Clam
Agrolatina,24A9706150,02/24/2025,Entry,560.0,1600.0,0,TIMCO,Clam
Agrolatina,24A9706150,03/11/2025,Sale,-1040.0,560.0,15,TIMCO,Clam
Agrolatina,24A9706150,04/02/2025,Sale,-560.0,0.0,37,TIMCO,Clam
Agrolatina,24A9708261,02/03/2025,Entry,640.0,640.0,0,SWEET GLOBE,Clam
Agrolatina,24A9708261,02/03/2025,Entry,960.0,1600.0,0,SWEET GLOBE,Clam
Agrolatina,24A9708261,02/18/2025,Sale,-640.0,960.0,15,SWEET GLOBE,Clam
Agrolatina,24A9708261,02/19/2025,Sale,-960.0,0.0,16,SWEET GLOBE,Clam
Agrolatina,24A9708602,01/03/2025,Entry,960.0,960.0,0,SWEET GLOBE,Clam
Agrolatina,24A9708602,01/03/2025,Entry,80.0,1040.0,0,SWEET GLOBE,Clam
Agrolatina,24A9708602,01/03/2025,Entry,560.0,1600.0,0,SWEET GLOBE,Clam
Agrolatina,24A9708602,01/16/2025,Sale,-240.0,1360.0,13,SWEET GLOBE,Clam
Agrolatina,24A9708602,01/17/2025,Sale,-160.0,1200.0,14,SWEET GLOBE,Clam
Agrolatina,24A9708602,01/17/2025,Sale,-560.0,640.0,14,SWEET GLOBE,Clam
Agrolatina,24A9708602,01/21/2025,Sale,-160.0,480.0,18,SWEET GLOBE,Clam
Agrolatina,24A9708602,01/21/2025,Sale,-400.0,80.0,18,SWEET GLOBE,Clam
Agrolatina,24A9708602,01/29/2025,Sale,-80.0,0.0,26,SWEET GLOBE,Clam
Agrolatina,24A9708662,12/23/2024,Entry,1600.0,1600.0,0,ALLISON,Clam
Agrolatina,24A9708662,01/04/2025,Sale,-1600.0,0.0,12,ALLISON,Clam
Agrolatina,24A9708791,01/13/2025,Entry,1360.0,1360.0,0,ALLISON,Clam
Agrolatina,24A9708791,01/13/2025,Entry,240.0,1600.0,0,ALLISON,Clam
Agrolatina,24A9708791,01/17/2025,Sale,-240.0,1360.0,4,ALLISON,Clam
Agrolatina,24A9708791,01/18/2025,Sale,-960.0,400.0,5,ALLISON,Clam
Agrolatina,24A9708791,01/20/2025,Sale,-400.0,0.0,7,ALLISON,Clam
Agrolatina,24A9708913,12/29/2024,Entry,1280.0,1280.0,0,ALLISON,Clam
Agrolatina,24A9708913,12/29/2024,Entry,320.0,1600.0,0,ALLISON,Clam
Agrolatina,24A9708913,01/16/2025,Sale,-1280.0,320.0,18,ALLISON,Clam
Agrolatina,24A9708913,01/17/2025,Sale,-320.0,0.0,19,ALLISON,Clam
Agrolatina,24A9708960,02/24/2025,Entry,1520.0,1520.0,0,TIMCO,Clam
Agrolatina,24A9708960,02/24/2025,Entry,80.0,1600.0,0,TIMCO,Clam
Agrolatina,24A9709912,02/17/2025,Entry,1120.0,1120.0,0,SWEET GLOBE,Clam
Agrolatina,24A9709912,02/17/2025,Entry,480.0,1600.0,0,SWEET GLOBE,Clam
Agrolatina,24A9709912,03/01/2025,Sale,-160.0,1440.0,12,SWEET GLOBE,Clam
Agrolatina,24A9709912,03/01/2025,Sale,-240.0,1200.0,12,SWEET GLOBE,Clam
Agrolatina,24A9709912,03/01/2025,Sale,-240.0,960.0,12,SWEET GLOBE,Clam
Agrolatina,24A9709912,03/01/2025,Sale,-160.0,800.0,12,SWEET GLOBE,Clam
Agrolatina,24A9709912,03/01/2025,Sale,-80.0,720.0,12,SWEET GLOBE,Clam
Agrolatina,24A9709912,03/03/2025,Sale,-240.0,480.0,14,SWEET GLOBE,Clam
Agrolatina,24A9709912,03/03/2025,Sale,-80.0,400.0,14,SWEET GLOBE,Clam
Agrolatina,24A9709912,03/10/2025,Sale,-20.0,380.0,21,SWEET GLOBE,Clam
Agrolatina,24A9709912,03/10/2025,Sale,-40.0,340.0,21,SWEET GLOBE,Clam
Agrolatina,24A9709912,03/11/2025,Sale,-276.0,64.0,22,SWEET GLOBE,Clam
Agrolatina,24A9710618,02/10/2025,Entry,1440.0,1440.0,0,TIMCO,Clam
Agrolatina,24A9710618,02/10/2025,Entry,160.0,1600.0,0,TIMCO,Clam
Agrolatina,24A9710618,03/08/2025,Sale,-1360.0,240.0,26,TIMCO,Clam
Agrolatina,24A9710618,03/10/2025,Sale,-80.0,160.0,28,TIMCO,Clam
Agrolatina,24A9710618,03/17/2025,Sale,-160.0,0.0,35,TIMCO,Clam
Agrolatina,24A9711630,02/24/2025,Entry,560.0,560.0,0,COTTON CANDY,Clam
Agrolatina,24A9711630,02/24/2025,Entry,1040.0,1600.0,0,COTTON CANDY,Clam
Agrolatina,24A9711630,03/08/2025,Sale,-960.0,640.0,12,COTTON CANDY,Clam
Agrolatina,24A9711630,03/25/2025,Sale,-480.0,160.0,29,COTTON CANDY,Clam
Agrolatina,24A9711630,03/26/2025,Sale,-80.0,80.0,30,COTTON CANDY,Clam
Agrolatina,24A9711630,04/01/2025,Sale,-80.0,0.0,36,COTTON CANDY,Clam
Agrolatina,24A9714781,02/17/2025,Entry,1120.0,1120.0,0,SWEET GLOBE,Clam
Agrolatina,24A9714781,02/17/2025,Entry,480.0,1600.0,0,SWEET GLOBE,Clam
Agrolatina,24A9714781,03/01/2025,Sale,-160.0,1440.0,12,SWEET GLOBE,Clam
Agrolatina,24A9714781,03/01/2025,Sale,-80.0,1360.0,12,SWEET GLOBE,Clam
Agrolatina,24A9714781,03/01/2025,Sale,-720.0,640.0,12,SWEET GLOBE,Clam
Agrolatina,24A9714781,03/01/2025,Sale,-80.0,560.0,12,SWEET GLOBE,Clam
Agrolatina,24A9714781,03/01/2025,Sale,-80.0,480.0,12,SWEET GLOBE,Clam
Agrolatina,24A9714781,03/01/2025,Sale,-80.0,400.0,12,SWEET GLOBE,Clam
Agrolatina,24A9714781,03/01/2025,Sale,-160.0,240.0,12,SWEET GLOBE,Clam
Agrolatina,24A9714781,03/03/2025,Sale,-80.0,160.0,14,SWEET GLOBE,Clam
Agrolatina,24A9714781,03/03/2025,Sale,-80.0,80.0,14,SWEET GLOBE,Clam
Agrolatina,24A9714781,03/10/2025,Sale,-40.0,40.0,21,SWEET GLOBE,Clam
Agrolatina,24A9714781,03/12/2025,Sale,-10.0,30.0,23,SWEET GLOBE,Clam
Agrolatina,24A9715287,02/06/2025,Entry,480.0,480.0,0,IVORY,Clam
Agrolatina,24A9715287,02/06/2025,Entry,80.0,560.0,0,IVORY,Clam
Agrolatina,24A9715287,02/06/2025,Entry,320.0,880.0,0,SWEET GLOBE,Clam
Agrolatina,24A9715287,02/06/2025,Entry,720.0,1600.0,0,SWEET GLOBE,Clam
Agrolatina,24A9715287,02/08/2025,Sale,-240.0,1360.0,2,SWEET GLOBE,Clam
Agrolatina,24A9715287,02/10/2025,Sale,-80.0,1280.0,4,IVORY,Clam
Agrolatina,24A9715287,02/11/2025,Sale,-80.0,1200.0,5,SWEET GLOBE,Clam
Agrolatina,24A9715287,02/12/2025,Sale,-400.0,800.0,6,IVORY,Clam
Agrolatina,24A9715287,02/13/2025,Sale,-80.0,720.0,7,IVORY,Clam
Agrolatina,24A9715287,02/15/2025,Sale,-320.0,400.0,9,SWEET GLOBE,Clam
Agrolatina,24A9715287,02/17/2025,Sale,-80.0,320.0,11,SWEET GLOBE,Clam
Agrolatina,24A9715287,02/18/2025,Sale,-80.0,240.0,12,SWEET GLOBE,Clam
Agrolatina,24A9715287,03/03/2025,Sale,-40.0,200.0,25,SWEET GLOBE,Clam
Agrolatina,24A9715287,03/05/2025,Sale,-80.0,120.0,27,SWEET GLOBE,Clam
Agrolatina,24A9718447,01/03/2025,Entry,1440.0,1440.0,0,CANDY SNAP,Clam
Agrolatina,24A9718447,01/03/2025,Entry,160.0,1600.0,0,CANDY SNAP,Clam
Agrolatina,24A9718447,01/15/2025,Sale,-80.0,1520.0,12,CANDY SNAP,Clam
Agrolatina,24A9718447,01/17/2025,Sale,-720.0,800.0,14,CANDY SNAP,Clam
Agrolatina,24A9718447,01/18/2025,Sale,-160.0,640.0,15,CANDY SNAP,Clam
Agrolatina,24A9718447,01/18/2025,Sale,-320.0,320.0,15,CANDY SNAP,Clam
Agrolatina,24A9718447,01/18/2025,Sale,-160.0,160.0,15,CANDY SNAP,Clam
Agrolatina,24A9718447,01/18/2025,Sale,-160.0,0.0,15,CANDY SNAP,Clam
Agrolatina,24A9719420,02/17/2025,Entry,480.0,480.0,0,AUTUMN CRISP,Clam
Agrolatina,24A9719420,02/17/2025,Entry,1120.0,1600.0,0,AUTUMN CRISP,Clam
Agrolatina,24A9719870,02/06/2025,Entry,1520.0,1520.0,0,ALLISON,Clam
Agrolatina,24A9719870,02/06/2025,Entry,80.0,1600.0,0,ALLISON,Clam
Agrolatina,24A9719870,03/03/2025,Sale,-80.0,1520.0,25,ALLISON,Clam
Agrolatina,24A9719870,03/07/2025,Sale,-1120.0,400.0,29,ALLISON,Clam
Agrolatina,24A9719870,03/07/2025,Sale,-80.0,320.0,29,ALLISON,Clam
Agrolatina,24A9719870,03/08/2025,Sale,-160.0,160.0,30,ALLISON,Clam
Agrolatina,24A9719870,03/14/2025,Sale,-50.0,110.0,36,ALLISON,Clam
Agrolatina,24A9719870,03/18/2025,Sale,-80.0,30.0,40,ALLISON,Clam
Agrolatina,24A9720642,02/17/2025,Entry,800.0,800.0,0,SWEET GLOBE,Clam
Agrolatina,24A9720642,02/17/2025,Entry,800.0,1600.0,0,SWEET GLOBE,Clam
Agrolatina,24A9720642,03/05/2025,Sale,-80.0,1520.0,16,SWEET GLOBE,Clam
Agrolatina,24A9720642,03/08/2025,Sale,-80.0,1440.0,19,SWEET GLOBE,Clam
Agrolatina,24A9720642,03/08/2025,Sale,-720.0,720.0,19,SWEET GLOBE,Clam
Agrolatina,24A9720642,03/10/2025,Sale,-200.0,520.0,21,SWEET GLOBE,Clam
Agrolatina,24A9720642,03/10/2025,Sale,-40.0,480.0,21,SWEET GLOBE,Clam
Agrolatina,24A9720642,03/11/2025,Sale,-90.0,390.0,22,SWEET GLOBE,Clam
Agrolatina,24A9720642,03/12/2025,Sale,-60.0,330.0,23,SWEET GLOBE,Clam
Agrolatina,24A9720642,03/14/2025,Sale,-40.0,290.0,25,SWEET GLOBE,Clam
Agrolatina,24A9720642,03/15/2025,Sale,-120.0,170.0,26,SWEET GLOBE,Clam
Agrolatina,24A9727156,02/11/2025,Entry,950.0,950.0,0,SWEET GLOBE,Bag
Agrolatina,24A9727156,02/11/2025,Entry,950.0,1900.0,0,SWEET GLOBE,Bag
Agrolatina,24A9727156,03/06/2025,Sale,-285.0,1615.0,23,SWEET GLOBE,Bag
Agrolatina,24A9727156,03/10/2025,Sale,-335.0,1280.0,27,SWEET GLOBE,Bag
Agrolatina,24A9727156,03/11/2025,Sale,-190.0,1090.0,28,SWEET GLOBE,Bag
Agrolatina,24A9727156,03/11/2025,Sale,-95.0,995.0,28,SWEET GLOBE,Bag
Agrolatina,24A9727156,03/12/2025,Sale,-190.0,805.0,29,SWEET GLOBE,Bag
Agrolatina,24A9727156,03/14/2025,Sale,-190.0,615.0,31,SWEET GLOBE,Bag
Agrolatina,24A9727156,03/14/2025,Sale,-95.0,520.0,31,SWEET GLOBE,Bag
Agrolatina,24A9727156,03/17/2025,Sale,-285.0,235.0,34,SWEET GLOBE,Bag
Agrolatina,24A9727156,03/19/2025,Sale,-95.0,140.0,36,SWEET GLOBE,Bag
Agrolatina,24A9727164,02/17/2025,Entry,1440.0,1440.0,0,IVORY,Clam
Agrolatina,24A9727164,02/17/2025,Entry,80.0,1520.0,0,IVORY,Clam
Agrolatina,24A9727164,02/17/2025,Entry,80.0,1600.0,0,IVORY,Clam
Agrolatina,24A9727164,03/04/2025,Sale,-160.0,1440.0,15,IVORY,Clam
Agrolatina,24A9727164,03/04/2025,Sale,-160.0,1280.0,15,IVORY,Clam
Agrolatina,24A9727164,03/11/2025,Sale,-80.0,1200.0,22,IVORY,Clam
Agrolatina,24A9727164,03/19/2025,Sale,-60.0,1140.0,30,IVORY,Clam
Agrolatina,24A9727164,03/21/2025,Sale,-80.0,1060.0,32,IVORY,Clam
Agrolatina,24A9727164,03/22/2025,Sale,-40.0,1020.0,33,IVORY,Clam
Agrolatina,24A9727164,03/22/2025,Sale,-80.0,940.0,33,IVORY,Clam
Agrolatina,24A9727164,03/22/2025,Sale,-441.0,499.0,33,IVORY,Clam
Agrolatina,24A9727164,03/22/2025,Sale,-100.0,399.0,33,IVORY,Clam
Agrolatina,24A9727164,03/29/2025,Sale,-55.0,344.0,40,IVORY,Clam
Agrolatina,24A9727164,04/01/2025,Sale,-5.0,339.0,43,IVORY,Clam
Agrolatina,24A9727460,02/11/2025,Entry,1045.0,1045.0,0,SWEET GLOBE,Bag
Agrolatina,24A9727460,02/11/2025,Entry,855.0,1900.0,0,SWEET GLOBE,Bag
Agrolatina,24A9727460,03/07/2025,Sale,-190.0,1710.0,24,SWEET GLOBE,Bag
Agrolatina,24A9727460,03/10/2025,Sale,-340.0,1370.0,27,SWEET GLOBE,Bag
Agrolatina,24A9727460,03/11/2025,Sale,-95.0,1275.0,28,SWEET GLOBE,Bag
Agrolatina,24A9727460,03/12/2025,Sale,-210.0,1065.0,29,SWEET GLOBE,Bag
Agrolatina,24A9727460,03/13/2025,Sale,-95.0,970.0,30,SWEET GLOBE,Bag
Agrolatina,24A9727460,03/14/2025,Sale,-95.0,875.0,31,SWEET GLOBE,Bag
Agrolatina,24A9727460,03/17/2025,Sale,-285.0,590.0,34,SWEET GLOBE,Bag
Agrolatina,24A9727460,03/19/2025,Sale,-380.0,210.0,36,SWEET GLOBE,Bag
Agrolatina,24A9729884,02/11/2025,Entry,1440.0,1440.0,0,TIMCO,Clam
Agrolatina,24A9729884,02/11/2025,Entry,160.0,1600.0,0,TIMCO,Clam
Agrolatina,24A9729884,03/10/2025,Sale,-240.0,1360.0,27,TIMCO,Clam
Agrolatina,24A9729884,03/13/2025,Sale,-640.0,720.0,30,TIMCO,Clam
Agrolatina,24A9729884,03/14/2025,Sale,-560.0,160.0,31,TIMCO,Clam
Agrolatina,24A9729884,03/14/2025,Sale,-160.0,0.0,31,TIMCO,Clam
Agrolatina,24A9742140,03/04/2025,Entry,1520.0,1520.0,0,COTTON CANDY,Clam
Agrolatina,24A9742140,03/04/2025,Entry,80.0,1600.0,0,COTTON CANDY,Clam
Agrolatina,24A9742140,04/11/2025,Sale,-1040.0,560.0,38,COTTON CANDY,Clam
Agrolatina,24A9744789,02/17/2025,Entry,1280.0,1280.0,0,IVORY,Clam
Agrolatina,24A9744789,02/17/2025,Entry,240.0,1520.0,0,IVORY,Clam
Agrolatina,24A9744789,02/17/2025,Entry,80.0,1600.0,0,IVORY,Clam
Agrolatina,24A9744789,03/04/2025,Sale,-80.0,1520.0,15,IVORY,Clam
Agrolatina,24A9744789,03/06/2025,Sale,-80.0,1440.0,17,IVORY,Clam
Agrolatina,24A9744789,03/12/2025,Sale,-80.0,1360.0,23,IVORY,Clam
Agrolatina,24A9744789,03/12/2025,Sale,-80.0,1280.0,23,IVORY,Clam
Agrolatina,24A9744789,03/12/2025,Sale,-80.0,1200.0,23,IVORY,Clam
Agrolatina,24A9744789,03/15/2025,Sale,-400.0,800.0,26,IVORY,Clam
Agrolatina,24A9744789,03/15/2025,Sale,-480.0,320.0,26,IVORY,Clam
Agrolatina,24A9744789,03/21/2025,Sale,-80.0,240.0,32,IVORY,Clam
Agrolatina,24A9744789,03/21/2025,Sale,-40.0,200.0,32,IVORY,Clam
Agrolatina,24A9744789,03/27/2025,Sale,-13.0,187.0,38,IVORY,Clam
Agrolatina,24A9744789,03/28/2025,Sale,-80.0,107.0,39,IVORY,Clam
Agrolatina,24A9745548,02/17/2025,Entry,1120.0,1120.0,0,SWEET GLOBE,Clam
Agrolatina,24A9745548,02/17/2025,Entry,480.0,1600.0,0,SWEET GLOBE,Clam
Agrolatina,24A9745548,03/01/2025,Sale,-960.0,640.0,12,SWEET GLOBE,Clam
Agrolatina,24A9745548,03/01/2025,Sale,-160.0,480.0,12,SWEET GLOBE,Clam
Agrolatina,24A9745548,03/01/2025,Sale,-160.0,320.0,12,SWEET GLOBE,Clam
Agrolatina,24A9745548,03/03/2025,Sale,-160.0,160.0,14,SWEET GLOBE,Clam
Agrolatina,24A9745548,03/10/2025,Sale,-40.0,120.0,21,SWEET GLOBE,Clam
Agrolatina,24A9745548,03/10/2025,Sale,-40.0,80.0,21,SWEET GLOBE,Clam
Agrolatina,24A9745548,03/11/2025,Sale,-10.0,70.0,22,SWEET GLOBE,Clam
Agrolatina,24A9745548,03/12/2025,Sale,-10.0,60.0,23,SWEET GLOBE,Clam
Agrolatina,24A9747854,01/03/2025,Entry,1520.0,1520.0,0,CANDY SNAP,Clam
Agrolatina,24A9747854,01/03/2025,Entry,80.0,1600.0,0,CANDY SNAP,Clam
Agrolatina,24A9747854,01/14/2025,Sale,-320.0,1280.0,11,CANDY SNAP,Clam
Agrolatina,24A9747854,01/15/2025,Sale,-240.0,1040.0,12,CANDY SNAP,Clam
Agrolatina,24A9747854,01/17/2025,Sale,-880.0,160.0,14,CANDY SNAP,Clam
Agrolatina,24A9747854,01/17/2025,Sale,-80.0,80.0,14,CANDY SNAP,Clam
Agrolatina,24A9747854,01/18/2025,Sale,-80.0,0.0,15,CANDY SNAP,Clam
Agrolatina,24A9747962,01/19/2025,Entry,640.0,640.0,0,IVORY,Clam
Agrolatina,24A9747962,01/19/2025,Entry,640.0,1280.0,0,SWEET GLOBE,Clam
Agrolatina,24A9747962,01/19/2025,Entry,320.0,1600.0,0,SWEET GLOBE,Clam
Agrolatina,24A9747962,02/06/2025,Sale,-160.0,1440.0,18,SWEET GLOBE,Clam
Agrolatina,24A9747962,02/10/2025,Sale,-80.0,1360.0,22,SWEET GLOBE,Clam
Agrolatina,24A9747962,02/12/2025,Sale,-80.0,1280.0,24,IVORY,Clam
Agrolatina,24A9747962,02/13/2025,Sale,-280.0,1000.0,25,IVORY,Clam
Agrolatina,24A9747962,02/15/2025,Sale,-160.0,840.0,27,SWEET GLOBE,Clam
Agrolatina,24A9747962,02/15/2025,Sale,-80.0,760.0,27,SWEET GLOBE,Clam
Agrolatina,24A9747962,02/17/2025,Sale,-80.0,680.0,29,SWEET GLOBE,Clam
Agrolatina,24A9747962,02/21/2025,Sale,-160.0,520.0,33,SWEET GLOBE,Clam
Agrolatina,24A9747962,02/25/2025,Sale,-45.0,475.0,37,SWEET GLOBE,Clam
Agrolatina,24A9747962,02/25/2025,Sale,-20.0,455.0,37,SWEET GLOBE,Clam
Agrolatina,24A9747962,02/28/2025,Sale,-40.0,415.0,40,SWEET GLOBE,Clam
Agrolatina,24A9747962,03/03/2025,Sale,-40.0,375.0,43,SWEET GLOBE,Clam
Agrolatina,24A9747962,03/25/2025,Sale,-10.0,365.0,65,IVORY,Clam
Agrolatina,24A9749778,02/05/2025,Entry,1710.0,1710.0,0,SWEET GLOBE,Bag
Agrolatina,24A9749778,02/05/2025,Entry,190.0,1900.0,0,SWEET GLOBE,Bag
Agrolatina,24A9749778,02/12/2025,Sale,-380.0,1520.0,7,SWEET GLOBE,Bag
Agrolatina,24A9749778,02/12/2025,Sale,-190.0,1330.0,7,SWEET GLOBE,Bag
Agrolatina,24A9749778,02/18/2025,Sale,-95.0,1235.0,13,SWEET GLOBE,Bag
Agrolatina,24A9749778,02/19/2025,Sale,-475.0,760.0,14,SWEET GLOBE,Bag
Agrolatina,24A9749778,02/25/2025,Sale,-95.0,665.0,20,SWEET GLOBE,Bag
Agrolatina,24A9749778,02/28/2025,Sale,-95.0,570.0,23,SWEET GLOBE,Bag
Agrolatina,24A9749778,03/01/2025,Sale,-190.0,380.0,24,SWEET GLOBE,Bag
Agrolatina,24A9749778,03/20/2025,Sale,-350.0,30.0,43,SWEET GLOBE,Bag
Agrolatina,24A9749778,03/20/2025,Sale,-30.0,0.0,43,SWEET GLOBE,Bag
Agrolatina,24A9749839,02/24/2025,Entry,160.0,160.0,0,AUTUMN CRISP,Clam
Agrolatina,24A9749839,02/24/2025,Entry,1440.0,1600.0,0,AUTUMN CRISP,Clam
Agrolatina,24A9749839,03/06/2025,Sale,-160.0,1440.0,10,AUTUMN CRISP,Clam
Agrolatina,24A9749839,03/14/2025,Sale,-160.0,1280.0,18,AUTUMN CRISP,Clam
Agrolatina,24A9749839,03/18/2025,Sale,-1280.0,0.0,22,AUTUMN CRISP,Clam
Agrolatina,24A9750423,01/13/2025,Entry,1440.0,1440.0,0,SWEET GLOBE,Clam
Agrolatina,24A9750423,01/13/2025,Entry,160.0,1600.0,0,SWEET GLOBE,Clam
Agrolatina,24A9750423,01/21/2025,Sale,-1440.0,160.0,8,SWEET GLOBE,Clam
Agrolatina,24A9750423,01/21/2025,Sale,-160.0,0.0,8,SWEET GLOBE,Clam
Agrolatina,24A9750742,02/10/2025,Entry,880.0,880.0,0,TIMCO,Clam
Agrolatina,24A9750742,02/10/2025,Entry,720.0,1600.0,0,TIMCO,Clam
Agrolatina,24A9750742,03/06/2025,Sale,-720.0,880.0,24,TIMCO,Clam
Agrolatina,24A9750742,03/08/2025,Sale,-880.0,0.0,26,TIMCO,Clam
Agrolatina,24A9750932,03/10/2025,Entry,320.0,320.0,0,AUTUMN CRISP,Clam
Agrolatina,24A9750932,03/10/2025,Entry,1280.0,1600.0,0,AUTUMN CRISP,Clam
Agrolatina,24A9750932,03/19/2025,Sale,-560.0,1040.0,9,AUTUMN CRISP,Clam
Agrolatina,24A9750932,03/19/2025,Sale,-720.0,320.0,9,AUTUMN CRISP,Clam
Agrolatina,24A9750932,04/02/2025,Sale,-80.0,240.0,23,AUTUMN CRISP,Clam
Agrolatina,24A9750932,04/03/2025,Sale,-80.0,160.0,24,AUTUMN CRISP,Clam
Agrolatina,24A9750932,04/15/2025,Sale,-160.0,0.0,36,AUTUMN CRISP,Clam
Agrolatina,24A9750980,03/03/2025,Entry,80.0,80.0,0,ALLISON,Clam
Agrolatina,24A9750980,03/03/2025,Entry,1520.0,1600.0,0,TIMCO,Clam
Agrolatina,24A9750980,04/17/2025,Sale,-1440.0,160.0,45,TIMCO,Clam
Agrolatina,24A9750980,04/21/2025,Sale,-80.0,80.0,49,TIMCO,Clam
Agrolatina,24A9750980,05/03/2025,Sale,-80.0,0.0,61,ALLISON,Clam
Agrolatina,24A9751100,01/08/2025,Sale,-80.0,-80.0,0,ALLISON,Clam
Agrolatina,24A9751100,01/09/2025,Entry,1440.0,1360.0,1,ALLISON,Clam
Agrolatina,24A9751100,01/09/2025,Entry,160.0,1520.0,1,ALLISON,Clam
Agrolatina,24A9751100,01/11/2025,Sale,-240.0,1280.0,3,ALLISON,Clam
Agrolatina,24A9751100,01/13/2025,Sale,-1040.0,240.0,5,ALLISON,Clam
Agrolatina,24A9751100,01/13/2025,Sale,-80.0,160.0,5,ALLISON,Clam
Agrolatina,24A9751100,01/14/2025,Sale,-160.0,0.0,6,ALLISON,Clam
Agrolatina,24A9751672,12/07/2024,Entry,1360.0,1360.0,0,CANDY SNAP,Clam
Agrolatina,24A9751672,12/07/2024,Entry,240.0,1600.0,0,CANDY SNAP,Clam
Agrolatina,24A9751672,01/06/2025,Sale,-160.0,1440.0,30,CANDY SNAP,Clam
Agrolatina,24A9751672,01/06/2025,Sale,-1200.0,240.0,30,CANDY SNAP,Clam
Agrolatina,24A9751672,01/06/2025,Sale,-240.0,0.0,30,CANDY SNAP,Clam
Agrolatina,24A9752262,02/03/2025,Entry,1425.0,1425.0,0,SWEET GLOBE,Bag
Agrolatina,24A9752262,02/03/2025,Entry,475.0,1900.0,0,SWEET GLOBE,Bag
Agrolatina,24A9752262,02/10/2025,Sale,-190.0,1710.0,7,SWEET GLOBE,Bag
Agrolatina,24A9752262,02/13/2025,Sale,-95.0,1615.0,10,SWEET GLOBE,Bag
Agrolatina,24A9752262,02/13/2025,Sale,-90.0,1525.0,10,SWEET GLOBE,Bag
Agrolatina,24A9752262,02/17/2025,Sale,-380.0,1145.0,14,SWEET GLOBE,Bag
Agrolatina,24A9752262,02/21/2025,Sale,-260.0,885.0,18,SWEET GLOBE,Bag
Agrolatina,24A9752262,02/22/2025,Sale,-150.0,735.0,19,SWEET GLOBE,Bag
Agrolatina,24A9752262,02/27/2025,Sale,-255.0,480.0,24,SWEET GLOBE,Bag
Agrolatina,24A9752262,02/27/2025,Sale,-3.0,477.0,24,SWEET GLOBE,Bag
Agrolatina,24A9752262,02/28/2025,Sale,-90.0,387.0,25,SWEET GLOBE,Bag
Agrolatina,24A9752262,02/28/2025,Sale,-90.0,297.0,25,SWEET GLOBE,Bag
Agrolatina,24A9752262,03/12/2025,Sale,-40.0,257.0,37,SWEET GLOBE,Bag
Agrolatina,24A9752508,01/09/2025,Entry,1600.0,1600.0,0,ALLISON,Clam
Agrolatina,24A9752508,01/22/2025,Sale,-1520.0,80.0,13,ALLISON,Clam
Agrolatina,24A9752508,01/23/2025,Sale,-80.0,0.0,14,ALLISON,Clam
Agrolatina,24A9766228,02/17/2025,Entry,1040.0,1040.0,0,IVORY,Clam
Agrolatina,24A9766228,02/17/2025,Entry,320.0,1360.0,0,IVORY,Clam
Agrolatina,24A9766228,02/17/2025,Entry,240.0,1600.0,0,IVORY,Clam
Agrolatina,24A9766228,03/11/2025,Sale,-160.0,1440.0,22,IVORY,Clam
Agrolatina,24A9766228,03/12/2025,Sale,-240.0,1200.0,23,IVORY,Clam
Agrolatina,24A9766228,03/22/2025,Sale,-40.0,1160.0,33,IVORY,Clam
Agrolatina,24A9766228,03/26/2025,Sale,-20.0,1140.0,37,IVORY,Clam
Agrolatina,24A9766228,03/28/2025,Sale,-100.0,1040.0,39,IVORY,Clam
Agrolatina,24A9766228,03/31/2025,Sale,-80.0,960.0,42,IVORY,Clam
Agrolatina,24A9766228,04/01/2025,Sale,-1.0,959.0,43,IVORY,Clam
Agrolatina,24A9766228,04/01/2025,Sale,-580.0,379.0,43,IVORY,Clam
Agrolatina,24A9766228,04/02/2025,Sale,-20.0,359.0,44,IVORY,Clam
Agrolatina,24A9766228,04/02/2025,Sale,-40.0,319.0,44,IVORY,Clam
Agrolatina,24A9766228,04/05/2025,Sale,-30.0,289.0,47,IVORY,Clam
Agrolatina,24A9766629,01/18/2025,Entry,1440.0,1440.0,0,SWEET GLOBE,Clam
Agrolatina,24A9766629,01/18/2025,Entry,160.0,1600.0,0,SWEET GLOBE,Clam
Agrolatina,24A9766629,01/20/2025,Sale,-80.0,1520.0,2,SWEET GLOBE,Clam
Agrolatina,24A9766629,01/20/2025,Sale,-640.0,880.0,2,SWEET GLOBE,Clam
Agrolatina,24A9766629,01/21/2025,Sale,-240.0,640.0,3,SWEET GLOBE,Clam
Agrolatina,24A9766629,01/27/2025,Sale,-80.0,560.0,9,SWEET GLOBE,Clam
Agrolatina,24A9766629,01/28/2025,Sale,-80.0,480.0,10,SWEET GLOBE,Clam
Agrolatina,24A9766629,01/29/2025,Sale,-80.0,400.0,11,SWEET GLOBE,Clam
Agrolatina,24A9766629,01/29/2025,Sale,-80.0,320.0,11,SWEET GLOBE,Clam
Agrolatina,24A9766629,01/30/2025,Sale,-160.0,160.0,12,SWEET GLOBE,Clam
Agrolatina,24A9766629,01/30/2025,Sale,-160.0,0.0,12,SWEET GLOBE,Clam
Agrolatina,24A9766790,02/04/2025,Entry,1200.0,1200.0,0,SWEET GLOBE,Clam
Agrolatina,24A9766790,02/04/2025,Entry,400.0,1600.0,0,SWEET GLOBE,Clam
Agrolatina,24A9766790,02/25/2025,Sale,-80.0,1520.0,21,SWEET GLOBE,Clam
Agrolatina,24A9766790,03/03/2025,Sale,-80.0,1440.0,27,SWEET GLOBE,Clam
Agrolatina,24A9766790,03/06/2025,Sale,-400.0,1040.0,30,SWEET GLOBE,Clam
Agrolatina,24A9766790,03/07/2025,Sale,-240.0,800.0,31,SWEET GLOBE,Clam
Agrolatina,24A9766790,03/19/2025,Sale,-800.0,0.0,43,SWEET GLOBE,Clam
Agrolatina,24A9772250,03/04/2025,Entry,1120.0,1120.0,0,IVORY,Clam
Agrolatina,24A9772250,03/04/2025,Entry,480.0,1600.0,0,IVORY,Clam
Agrolatina,24A9772250,03/12/2025,Sale,-80.0,1520.0,8,IVORY,Clam
Agrolatina,24A9772250,03/15/2025,Sale,-80.0,1440.0,11,IVORY,Clam
Agrolatina,24A9772250,03/22/2025,Sale,-320.0,1120.0,18,IVORY,Clam
Agrolatina,24A9772250,03/22/2025,Sale,-80.0,1040.0,18,IVORY,Clam
Agrolatina,24A9772250,03/22/2025,Sale,-120.0,920.0,18,IVORY,Clam
Agrolatina,24A9772250,03/28/2025,Sale,-95.0,825.0,24,IVORY,Clam
Agrolatina,24A9772250,03/29/2025,Sale,-80.0,745.0,25,IVORY,Clam
Agrolatina,24A9772250,03/31/2025,Sale,-115.0,630.0,27,IVORY,Clam
Agrolatina,24A9772250,04/01/2025,Sale,-160.0,470.0,28,IVORY,Clam
Agrolatina,24A9772250,04/03/2025,Sale,-160.0,310.0,30,IVORY,Clam
Agrolatina,24A9775894,01/27/2025,Entry,1120.0,1120.0,0,SWEET GLOBE,Clam
Agrolatina,24A9775894,01/27/2025,Entry,480.0,1600.0,0,SWEET GLOBE,Clam
Agrolatina,24A9775894,02/03/2025,Sale,-960.0,640.0,7,SWEET GLOBE,Clam
Agrolatina,24A9775894,02/04/2025,Sale,-480.0,160.0,8,SWEET GLOBE,Clam
Agrolatina,24A9775894,02/05/2025,Sale,-160.0,0.0,9,SWEET GLOBE,Clam
Agrolatina,24A9777897,01/03/2025,Entry,1120.0,1120.0,0,SWEET GLOBE,Clam
Agrolatina,24A9777897,01/03/2025,Entry,480.0,1600.0,0,SWEET GLOBE,Clam
Agrolatina,24A9777897,01/21/2025,Sale,-800.0,800.0,18,SWEET GLOBE,Clam
Agrolatina,24A9777897,01/21/2025,Sale,-160.0,640.0,18,SWEET GLOBE,Clam
Agrolatina,24A9777897,01/21/2025,Sale,-160.0,480.0,18,SWEET GLOBE,Clam
Agrolatina,24A9777897,01/21/2025,Sale,-320.0,160.0,18,SWEET GLOBE,Clam
Agrolatina,24A9777897,01/30/2025,Sale,-80.0,80.0,27,SWEET GLOBE,Clam
Agrolatina,24A9777897,02/12/2025,Sale,-80.0,0.0,40,SWEET GLOBE,Clam
Agrolatina,24A9778454,01/19/2025,Entry,1360.0,1360.0,0,SWEET GLOBE,Clam
Agrolatina,24A9778454,01/19/2025,Entry,240.0,1600.0,0,SWEET GLOBE,Clam
Agrolatina,24A9778454,02/06/2025,Sale,-80.0,1520.0,18,SWEET GLOBE,Clam
Agrolatina,24A9778454,02/06/2025,Sale,-320.0,1200.0,18,SWEET GLOBE,Clam
Agrolatina,24A9778454,02/07/2025,Sale,-320.0,880.0,19,SWEET GLOBE,Clam
Agrolatina,24A9778454,02/07/2025,Sale,-80.0,800.0,19,SWEET GLOBE,Clam
Agrolatina,24A9778454,02/07/2025,Sale,-240.0,560.0,19,SWEET GLOBE,Clam
Agrolatina,24A9778454,02/08/2025,Sale,-80.0,480.0,20,SWEET GLOBE,Clam
Agrolatina,24A9778454,02/10/2025,Sale,-80.0,400.0,22,SWEET GLOBE,Clam
Agrolatina,24A9778454,02/11/2025,Sale,-80.0,320.0,23,SWEET GLOBE,Clam
Agrolatina,24A9778454,02/13/2025,Sale,-80.0,240.0,25,SWEET GLOBE,Clam
Agrolatina,24A9778454,02/22/2025,Sale,-40.0,200.0,34,SWEET GLOBE,Clam
Agrolatina,24A9778454,02/22/2025,Sale,-20.0,180.0,34,SWEET GLOBE,Clam
Agrolatina,24A9778454,02/22/2025,Sale,-10.0,170.0,34,SWEET GLOBE,Clam
Agrolatina,24A9778454,03/13/2025,Sale,-20.0,150.0,53,SWEET GLOBE,Clam
Agrolatina,24A9778454,03/13/2025,Sale,-40.0,110.0,53,SWEET GLOBE,Clam
Agrolatina,24A9786130,01/03/2025,Entry,1360.0,1360.0,0,ALLISON,Clam
Agrolatina,24A9786130,01/03/2025,Entry,240.0,1600.0,0,ALLISON,Clam
Agrolatina,24A9786130,01/14/2025,Sale,-880.0,720.0,11,ALLISON,Clam
Agrolatina,24A9786130,01/14/2025,Sale,-80.0,640.0,11,ALLISON,Clam
Agrolatina,24A9786130,01/16/2025,Sale,-480.0,160.0,13,ALLISON,Clam
Agrolatina,24A9786130,01/17/2025,Sale,-160.0,0.0,14,ALLISON,Clam
Agrolatina,24A9806466,03/04/2025,Entry,960.0,960.0,0,IVORY,Clam
Agrolatina,24A9806466,03/04/2025,Entry,640.0,1600.0,0,IVORY,Clam
Agrolatina,24A9806466,03/04/2025,Sale,-400.0,1200.0,0,IVORY,Clam
Agrolatina,24A9806466,03/21/2025,Sale,-60.0,1140.0,17,IVORY,Clam
Agrolatina,24A9806466,03/22/2025,Sale,-160.0,980.0,18,IVORY,Clam
Agrolatina,24A9806466,03/22/2025,Sale,-80.0,900.0,18,IVORY,Clam
Agrolatina,24A9806466,03/22/2025,Sale,-80.0,820.0,18,IVORY,Clam
Agrolatina,24A9806466,03/22/2025,Sale,-80.0,740.0,18,IVORY,Clam
Agrolatina,24A9806466,03/24/2025,Sale,-80.0,660.0,20,IVORY,Clam
Agrolatina,24A9806466,03/25/2025,Sale,-240.0,420.0,21,IVORY,Clam
Agrolatina,24A9806466,03/29/2025,Sale,-80.0,340.0,25,IVORY,Clam
Agrolatina,24A9806466,03/29/2025,Sale,-86.0,254.0,25,IVORY,Clam
Agrolatina,24A9807502,01/13/2025,Entry,1440.0,1440.0,0,SWEET GLOBE,Clam
Agrolatina,24A9807502,01/13/2025,Entry,80.0,1520.0,0,SWEET GLOBE,Clam
Agrolatina,24A9807502,01/13/2025,Entry,80.0,1600.0,0,SWEET GLOBE,Clam
Agrolatina,24A9807502,01/29/2025,Sale,-960.0,640.0,16,SWEET GLOBE,Clam
Agrolatina,24A9807502,01/29/2025,Sale,-320.0,320.0,16,SWEET GLOBE,Clam
Agrolatina,24A9807502,01/29/2025,Sale,-80.0,240.0,16,SWEET GLOBE,Clam
Agrolatina,24A9807502,01/30/2025,Sale,-80.0,160.0,17,SWEET GLOBE,Clam
Agrolatina,24A9807502,01/31/2025,Sale,-160.0,0.0,18,SWEET GLOBE,Clam
Agrolatina,24A9807927,01/13/2025,Entry,1280.0,1280.0,0,CANDY SNAP,Clam
Agrolatina,24A9807927,01/13/2025,Entry,320.0,1600.0,0,CANDY SNAP,Clam
Agrolatina,24A9807927,01/31/2025,Sale,-640.0,960.0,18,CANDY SNAP,Clam
Agrolatina,24A9807927,02/03/2025,Sale,-240.0,720.0,21,CANDY SNAP,Clam
Agrolatina,24A9807927,02/17/2025,Sale,-80.0,640.0,35,CANDY SNAP,Clam
Agrolatina,24A9807927,02/27/2025,Sale,-330.0,310.0,45,CANDY SNAP,Clam
Agrolatina,24A9807927,02/28/2025,Sale,-42.0,268.0,46,CANDY SNAP,Clam
Agrolatina,24A9807927,03/03/2025,Sale,-40.0,228.0,49,CANDY SNAP,Clam
Agrolatina,24A9807927,03/31/2025,Sale,-80.0,148.0,77,CANDY SNAP,Clam
Agrolatina,24A9811478,01/19/2025,Entry,1360.0,1360.0,0,SWEET GLOBE,Clam
Agrolatina,24A9811478,01/19/2025,Entry,240.0,1600.0,0,SWEET GLOBE,Clam
Agrolatina,24A9811478,02/08/2025,Sale,-80.0,1520.0,20,SWEET GLOBE,Clam
Agrolatina,24A9811478,02/08/2025,Sale,-80.0,1440.0,20,SWEET GLOBE,Clam
Agrolatina,24A9811478,02/10/2025,Sale,-160.0,1280.0,22,SWEET GLOBE,Clam
Agrolatina,24A9811478,02/10/2025,Sale,-400.0,880.0,22,SWEET GLOBE,Clam
Agrolatina,24A9811478,02/11/2025,Sale,-320.0,560.0,23,SWEET GLOBE,Clam
Agrolatina,24A9811478,02/11/2025,Sale,-320.0,240.0,23,SWEET GLOBE,Clam
Agrolatina,24A9811478,02/18/2025,Sale,-80.0,160.0,30,SWEET GLOBE,Clam
Agrolatina,24A9811478,03/05/2025,Sale,-60.0,100.0,45,SWEET GLOBE,Clam
Agrolatina,24A9811478,03/05/2025,Sale,-50.0,50.0,45,SWEET GLOBE,Clam
Agrolatina,24A9820674,01/30/2025,Entry,880.0,880.0,0,SWEET GLOBE,Clam
Agrolatina,24A9820674,01/30/2025,Entry,720.0,1600.0,0,SWEET GLOBE,Clam
Agrolatina,24A9820674,02/05/2025,Sale,-160.0,1440.0,6,SWEET GLOBE,Clam
Agrolatina,24A9820674,02/05/2025,Sale,-640.0,800.0,6,SWEET GLOBE,Clam
Agrolatina,24A9820674,02/10/2025,Sale,-720.0,80.0,11,SWEET GLOBE,Clam
Agrolatina,24A9820674,02/10/2025,Sale,-80.0,0.0,11,SWEET GLOBE,Clam
Agrolatina,24A9821671,02/17/2025,Entry,1120.0,1120.0,0,SWEET GLOBE,Clam
Agrolatina,24A9821671,02/17/2025,Entry,480.0,1600.0,0,SWEET GLOBE,Clam
Agrolatina,24A9821671,03/01/2025,Sale,-880.0,720.0,12,SWEET GLOBE,Clam
Agrolatina,24A9821671,03/01/2025,Sale,-160.0,560.0,12,SWEET GLOBE,Clam
Agrolatina,24A9821671,03/01/2025,Sale,-400.0,160.0,12,SWEET GLOBE,Clam
Agrolatina,24A9821671,03/03/2025,Sale,-80.0,80.0,14,SWEET GLOBE,Clam
Agrolatina,24A9821671,03/03/2025,Sale,-80.0,0.0,14,SWEET GLOBE,Clam
Agrolatina,24A9821964,02/17/2025,Entry,1120.0,1120.0,0,SWEET GLOBE,Clam
Agrolatina,24A9821964,02/17/2025,Entry,480.0,1600.0,0,SWEET GLOBE,Clam
Agrolatina,24A9821964,02/28/2025,Sale,-240.0,1360.0,11,SWEET GLOBE,Clam
Agrolatina,24A9821964,02/28/2025,Sale,-160.0,1200.0,11,SWEET GLOBE,Clam
Agrolatina,24A9821964,02/28/2025,Sale,-80.0,1120.0,11,SWEET GLOBE,Clam
Agrolatina,24A9821964,03/01/2025,Sale,-80.0,1040.0,12,SWEET GLOBE,Clam
Agrolatina,24A9821964,03/01/2025,Sale,-480.0,560.0,12,SWEET GLOBE,Clam
Agrolatina,24A9821964,03/03/2025,Sale,-80.0,480.0,14,SWEET GLOBE,Clam
Agrolatina,24A9821964,03/10/2025,Sale,-20.0,460.0,21,SWEET GLOBE,Clam
Agrolatina,24A9821964,03/10/2025,Sale,-40.0,420.0,21,SWEET GLOBE,Clam
Agrolatina,24A9821964,03/11/2025,Sale,-130.0,290.0,22,SWEET GLOBE,Clam
Agrolatina,24A9821964,03/11/2025,Sale,-60.0,230.0,22,SWEET GLOBE,Clam
Agrolatina,24A9821964,03/12/2025,Sale,-87.0,143.0,23,SWEET GLOBE,Clam
Agrolatina,24A9823225,02/12/2025,Entry,1520.0,1520.0,0,ALLISON,Clam
Agrolatina,24A9823225,02/12/2025,Entry,80.0,1600.0,0,ALLISON,Clam
Agrolatina,24A9823225,03/06/2025,Sale,-1360.0,240.0,22,ALLISON,Clam
Agrolatina,24A9823225,03/06/2025,Sale,-80.0,160.0,22,ALLISON,Clam
Agrolatina,24A9823225,03/08/2025,Sale,-160.0,0.0,24,ALLISON,Clam
Agrolatina,24A9824156,01/09/2025,Entry,1440.0,1440.0,0,ALLISON,Clam
Agrolatina,24A9824156,01/09/2025,Entry,160.0,1600.0,0,ALLISON,Clam
Agrolatina,24A9824156,01/30/2025,Sale,-480.0,1120.0,21,ALLISON,Clam
Agrolatina,24A9824156,01/31/2025,Sale,-480.0,640.0,22,ALLISON,Clam
Agrolatina,24A9824156,02/05/2025,Sale,-160.0,480.0,27,ALLISON,Clam
Agrolatina,24A9824156,02/05/2025,Sale,-160.0,320.0,27,ALLISON,Clam
Agrolatina,24A9824156,02/06/2025,Sale,-38.0,282.0,28,ALLISON,Clam
Agrolatina,24A9824156,02/10/2025,Sale,-160.0,122.0,32,ALLISON,Clam
Agrolatina,24A9824156,03/03/2025,Sale,-47.0,75.0,53,ALLISON,Clam
Agrolatina,24A9824987,03/04/2025,Entry,1280.0,1280.0,0,IVORY,Clam
Agrolatina,24A9824987,03/04/2025,Entry,320.0,1600.0,0,IVORY,Clam
Agrolatina,24A9824987,03/11/2025,Sale,-80.0,1520.0,7,IVORY,Clam
Agrolatina,24A9824987,03/21/2025,Sale,-13.0,1507.0,17,IVORY,Clam
Agrolatina,24A9824987,03/22/2025,Sale,-160.0,1347.0,18,IVORY,Clam
Agrolatina,24A9824987,03/22/2025,Sale,-20.0,1327.0,18,IVORY,Clam
Agrolatina,24A9824987,03/22/2025,Sale,-40.0,1287.0,18,IVORY,Clam
Agrolatina,24A9824987,03/24/2025,Sale,-11.0,1276.0,20,IVORY,Clam
Agrolatina,24A9824987,03/25/2025,Sale,-99.0,1177.0,21,IVORY,Clam
Agrolatina,24A9824987,03/26/2025,Sale,-520.0,657.0,22,IVORY,Clam
Agrolatina,24A9824987,03/26/2025,Sale,-80.0,577.0,22,IVORY,Clam
Agrolatina,24A9824987,03/27/2025,Sale,-100.0,477.0,23,IVORY,Clam
Agrolatina,24A9824987,03/28/2025,Sale,-40.0,437.0,24,IVORY,Clam
Agrolatina,24A9826816,01/03/2025,Entry,1440.0,1440.0,0,SWEET GLOBE,Clam
Agrolatina,24A9826816,01/03/2025,Entry,80.0,1520.0,0,SWEET GLOBE,Clam
Agrolatina,24A9826816,01/03/2025,Entry,80.0,1600.0,0,SWEET GLOBE,Clam
Agrolatina,24A9826816,01/16/2025,Sale,-400.0,1200.0,13,SWEET GLOBE,Clam
Agrolatina,24A9826816,01/17/2025,Sale,-240.0,960.0,14,SWEET GLOBE,Clam
Agrolatina,24A9826816,01/17/2025,Sale,-480.0,480.0,14,SWEET GLOBE,Clam
Agrolatina,24A9826816,01/17/2025,Sale,-240.0,240.0,14,SWEET GLOBE,Clam
Agrolatina,24A9826816,01/17/2025,Sale,-80.0,160.0,14,SWEET GLOBE,Clam
Agrolatina,24A9826816,01/21/2025,Sale,-80.0,80.0,18,SWEET GLOBE,Clam
Agrolatina,24A9826816,01/21/2025,Sale,-80.0,0.0,18,SWEET GLOBE,Clam
Agrolatina,24A9827411,01/03/2025,Entry,1360.0,1360.0,0,ALLISON,Clam
Agrolatina,24A9827411,01/03/2025,Entry,240.0,1600.0,0,ALLISON,Clam
Agrolatina,24A9827411,01/15/2025,Sale,-240.0,1360.0,12,ALLISON,Clam
Agrolatina,24A9827411,01/15/2025,Sale,-240.0,1120.0,12,ALLISON,Clam
Agrolatina,24A9827411,01/17/2025,Sale,-800.0,320.0,14,ALLISON,Clam
Agrolatina,24A9827411,01/18/2025,Sale,-320.0,0.0,15,ALLISON,Clam
Agrolatina,24A9831519,03/04/2025,Entry,1120.0,1120.0,0,SWEET GLOBE,Clam
Agrolatina,24A9831519,03/04/2025,Entry,480.0,1600.0,0,SWEET GLOBE,Clam
Agrolatina,24A9831519,03/13/2025,Sale,-160.0,1440.0,9,SWEET GLOBE,Clam
Agrolatina,24A9831519,03/13/2025,Sale,-240.0,1200.0,9,SWEET GLOBE,Clam
Agrolatina,24A9831519,03/14/2025,Sale,-80.0,1120.0,10,SWEET GLOBE,Clam
Agrolatina,24A9831519,03/14/2025,Sale,-40.0,1080.0,10,SWEET GLOBE,Clam
Agrolatina,24A9831519,03/15/2025,Sale,-80.0,1000.0,11,SWEET GLOBE,Clam
Agrolatina,24A9831519,03/15/2025,Sale,-68.0,932.0,11,SWEET GLOBE,Clam
Agrolatina,24A9831519,03/17/2025,Sale,-140.0,792.0,13,SWEET GLOBE,Clam
Agrolatina,24A9831519,03/18/2025,Sale,-160.0,632.0,14,SWEET GLOBE,Clam
Agrolatina,24A9831519,03/19/2025,Sale,-222.0,410.0,15,SWEET GLOBE,Clam
Agrolatina,24A9834597,02/17/2025,Entry,1120.0,1120.0,0,IVORY,Clam
Agrolatina,24A9834597,02/17/2025,Entry,480.0,1600.0,0,IVORY,Clam
Agrolatina,24A9834597,02/25/2025,Sale,-880.0,720.0,8,IVORY,Clam
Agrolatina,24A9834597,02/25/2025,Sale,-160.0,560.0,8,IVORY,Clam
Agrolatina,24A9834597,02/25/2025,Sale,-80.0,480.0,8,IVORY,Clam
Agrolatina,24A9834597,02/25/2025,Sale,-400.0,80.0,8,IVORY,Clam
Agrolatina,24A9834597,02/26/2025,Sale,-80.0,0.0,9,IVORY,Clam
Agrolatina,24A9838550,03/04/2025,Entry,640.0,640.0,0,SWEET GLOBE,Clam
Agrolatina,24A9838550,03/04/2025,Entry,960.0,1600.0,0,SWEET GLOBE,Clam
Agrolatina,24A9838550,03/08/2025,Sale,-160.0,1440.0,4,SWEET GLOBE,Clam
Agrolatina,24A9838550,03/08/2025,Sale,-240.0,1200.0,4,SWEET GLOBE,Clam
Agrolatina,24A9838550,03/13/2025,Sale,-160.0,1040.0,9,SWEET GLOBE,Clam
Agrolatina,24A9838550,03/13/2025,Sale,-40.0,1000.0,9,SWEET GLOBE,Clam
Agrolatina,24A9838550,03/13/2025,Sale,-80.0,920.0,9,SWEET GLOBE,Clam
Agrolatina,24A9838550,03/15/2025,Sale,-320.0,600.0,11,SWEET GLOBE,Clam
Agrolatina,24A9838550,03/15/2025,Sale,-300.0,300.0,11,SWEET GLOBE,Clam
Agrolatina,24A9838550,03/17/2025,Sale,-40.0,260.0,13,SWEET GLOBE,Clam
Agrolatina,24A9840120,02/11/2025,Entry,800.0,800.0,0,SWEET GLOBE,Clam
Agrolatina,24A9840120,02/11/2025,Entry,800.0,1600.0,0,SWEET GLOBE,Clam
Agrolatina,24A9840120,02/18/2025,Sale,-80.0,1520.0,7,SWEET GLOBE,Clam
Agrolatina,24A9840120,02/19/2025,Sale,-160.0,1360.0,8,SWEET GLOBE,Clam
Agrolatina,24A9840120,02/19/2025,Sale,-400.0,960.0,8,SWEET GLOBE,Clam
Agrolatina,24A9840120,02/21/2025,Sale,-80.0,880.0,10,SWEET GLOBE,Clam
Agrolatina,24A9840120,02/22/2025,Sale,-80.0,800.0,11,SWEET GLOBE,Clam
Agrolatina,24A9840120,02/24/2025,Sale,-220.0,580.0,13,SWEET GLOBE,Clam
Agrolatina,24A9840120,02/27/2025,Sale,-280.0,300.0,16,SWEET GLOBE,Clam
Agrolatina,24A9840120,02/28/2025,Sale,-60.0,240.0,17,SWEET GLOBE,Clam
Agrolatina,24A9840120,03/01/2025,Sale,-3.0,237.0,18,SWEET GLOBE,Clam
Agrolatina,24A9840120,03/03/2025,Sale,-80.0,157.0,20,SWEET GLOBE,Clam
Agrolatina,24A9840120,03/03/2025,Sale,-40.0,117.0,20,SWEET GLOBE,Clam
Agrolatina,24A9840120,03/04/2025,Sale,-9.0,108.0,21,SWEET GLOBE,Clam
Agrolatina,24A9841894,02/13/2025,Entry,560.0,560.0,0,CANDY DREAMS,Clam
Agrolatina,24A9841894,02/13/2025,Entry,1040.0,1600.0,0,CANDY DREAMS,Clam
Agrolatina,24A9841894,02/24/2025,Sale,-400.0,1200.0,11,CANDY DREAMS,Clam
Agrolatina,24A9841894,02/25/2025,Sale,-208.0,992.0,12,CANDY DREAMS,Clam
Agrolatina,24A9841894,02/25/2025,Sale,-220.0,772.0,12,CANDY DREAMS,Clam
Agrolatina,24A9841894,02/26/2025,Sale,-80.0,692.0,13,CANDY DREAMS,Clam
Agrolatina,24A9841894,02/27/2025,Sale,-80.0,612.0,14,CANDY DREAMS,Clam
Agrolatina,24A9841894,02/27/2025,Sale,-387.0,225.0,14,CANDY DREAMS,Clam
Agrolatina,24A9841894,03/01/2025,Sale,-70.0,155.0,16,CANDY DREAMS,Clam
Agrolatina,24A9841894,03/01/2025,Sale,-40.0,115.0,16,CANDY DREAMS,Clam
Agrolatina,24A9841894,03/11/2025,Sale,-5.0,110.0,26,CANDY DREAMS,Clam
Agrolatina,24A9842397,03/09/2025,Entry,1445.0,1445.0,0,TIMCO,Bag
Agrolatina,24A9842397,03/09/2025,Entry,255.0,1700.0,0,TIMCO,Bag
Agrolatina,24A9842397,04/09/2025,Sale,-900.0,800.0,31,TIMCO,Bag
Agrolatina,24A9842397,04/10/2025,Sale,-180.0,620.0,32,TIMCO,Bag
Agrolatina,24A9842397,04/14/2025,Sale,-240.0,380.0,36,TIMCO,Bag
Agrolatina,24A9842761,01/13/2025,Entry,1040.0,1040.0,0,CANDY SNAP,Clam
Agrolatina,24A9842761,01/13/2025,Entry,560.0,1600.0,0,CANDY SNAP,Clam
Agrolatina,24A9842761,02/05/2025,Sale,-160.0,1440.0,23,CANDY SNAP,Clam
Agrolatina,24A9842761,02/06/2025,Sale,-160.0,1280.0,24,CANDY SNAP,Clam
Agrolatina,24A9842761,02/10/2025,Sale,-344.0,936.0,28,CANDY SNAP,Clam
Agrolatina,24A9842761,02/10/2025,Sale,-240.0,696.0,28,CANDY SNAP,Clam
Agrolatina,24A9842761,02/12/2025,Sale,-39.0,657.0,30,CANDY SNAP,Clam
Agrolatina,24A9842761,02/13/2025,Sale,-320.0,337.0,31,CANDY SNAP,Clam
Agrolatina,24A9842761,02/17/2025,Sale,-80.0,257.0,35,CANDY SNAP,Clam
Agrolatina,24A9845375,01/13/2025,Entry,1440.0,1440.0,0,SWEET GLOBE,Clam
Agrolatina,24A9845375,01/13/2025,Entry,80.0,1520.0,0,SWEET GLOBE,Clam
Agrolatina,24A9845375,01/13/2025,Entry,80.0,1600.0,0,SWEET GLOBE,Clam
Agrolatina,24A9845375,01/20/2025,Sale,-160.0,1440.0,7,SWEET GLOBE,Clam
Agrolatina,24A9845375,01/21/2025,Sale,-80.0,1360.0,8,SWEET GLOBE,Clam
Agrolatina,24A9845375,01/29/2025,Sale,-80.0,1280.0,16,SWEET GLOBE,Clam
Agrolatina,24A9845375,01/30/2025,Sale,-80.0,1200.0,17,SWEET GLOBE,Clam
Agrolatina,24A9845375,01/31/2025,Sale,-1040.0,160.0,18,SWEET GLOBE,Clam
Agrolatina,24A9845375,01/31/2025,Sale,-80.0,80.0,18,SWEET GLOBE,Clam
Agrolatina,24A9845375,02/04/2025,Sale,-80.0,0.0,22,SWEET GLOBE,Clam
Agrolatina,24A9850460,04/14/2025,Entry,1360.0,1360.0,0,SWEET GLOBE,Clam
Agrolatina,24A9850460,04/14/2025,Entry,160.0,1520.0,0,SWEET GLOBE,Clam
Agrolatina,24A9850460,04/26/2025,Sale,-1360.0,160.0,12,SWEET GLOBE,Clam
Agrolatina,24A9850460,04/28/2025,Sale,-160.0,0.0,14,SWEET GLOBE,Clam
Agrolatina,24A9858161,01/03/2025,Entry,1120.0,1120.0,0,SWEET GLOBE,Clam
Agrolatina,24A9858161,01/03/2025,Entry,80.0,1200.0,0,SWEET GLOBE,Clam
Agrolatina,24A9858161,01/03/2025,Entry,400.0,1600.0,0,SWEET GLOBE,Clam
Agrolatina,24A9858161,01/29/2025,Sale,-160.0,1440.0,26,SWEET GLOBE,Clam
Agrolatina,24A9858161,01/29/2025,Sale,-480.0,960.0,26,SWEET GLOBE,Clam
Agrolatina,24A9858161,01/29/2025,Sale,-80.0,880.0,26,SWEET GLOBE,Clam
Agrolatina,24A9858161,01/29/2025,Sale,-80.0,800.0,26,SWEET GLOBE,Clam
Agrolatina,24A9858161,01/30/2025,Sale,-160.0,640.0,27,SWEET GLOBE,Clam
Agrolatina,24A9858161,01/30/2025,Sale,-240.0,400.0,27,SWEET GLOBE,Clam
Agrolatina,24A9858161,01/30/2025,Sale,-80.0,320.0,27,SWEET GLOBE,Clam
Agrolatina,24A9858161,01/30/2025,Sale,-80.0,240.0,27,SWEET GLOBE,Clam
Agrolatina,24A9858161,01/30/2025,Sale,-80.0,160.0,27,SWEET GLOBE,Clam
Agrolatina,24A9858161,02/05/2025,Sale,-80.0,80.0,33,SWEET GLOBE,Clam
Agrolatina,24A9858161,02/12/2025,Sale,-80.0,0.0,40,SWEET GLOBE,Clam
Agrolatina,24A9860726,02/11/2025,Entry,1360.0,1360.0,0,TIMCO,Clam
Agrolatina,24A9860726,02/11/2025,Entry,160.0,1520.0,0,TIMCO,Clam
Agrolatina,24A9860726,02/11/2025,Entry,80.0,1600.0,0,TIMCO,Clam
Agrolatina,24A9860726,03/08/2025,Sale,-80.0,1520.0,25,TIMCO,Clam
Agrolatina,24A9860726,03/13/2025,Sale,-1280.0,240.0,30,TIMCO,Clam
Agrolatina,24A9860726,03/14/2025,Sale,-160.0,80.0,31,TIMCO,Clam
Agrolatina,24A9860726,03/17/2025,Sale,-80.0,0.0,34,TIMCO,Clam
Agrolatina,24A9862114,02/11/2025,Entry,1040.0,1040.0,0,SWEET GLOBE,Clam
Agrolatina,24A9862114,02/11/2025,Entry,560.0,1600.0,0,SWEET GLOBE,Clam
Agrolatina,24A9862114,02/26/2025,Sale,-1040.0,560.0,15,SWEET GLOBE,Clam
Agrolatina,24A9862114,03/05/2025,Sale,-560.0,0.0,22,SWEET GLOBE,Clam
Agrolatina,24A9865184,03/04/2025,Entry,480.0,480.0,0,TIMCO,Clam
Agrolatina,24A9865184,03/04/2025,Entry,1120.0,1600.0,0,TIMCO,Clam
Agrolatina,24A9865184,03/24/2025,Sale,-480.0,1120.0,20,TIMCO,Clam
Agrolatina,24A9865184,04/18/2025,Sale,-995.0,125.0,45,TIMCO,Clam
Agrolatina,24A9865184,05/08/2025,Sale,-79.0,46.0,65,TIMCO,Clam
Agrolatina,24A9866956,03/04/2025,Entry,400.0,400.0,0,AUTUMN CRISP,Clam
Agrolatina,24A9866956,03/04/2025,Entry,1200.0,1600.0,0,AUTUMN CRISP,Clam
Agrolatina,24A9866956,03/25/2025,Sale,-1200.0,400.0,21,AUTUMN CRISP,Clam
Agrolatina,24A9866956,03/29/2025,Sale,-240.0,160.0,25,AUTUMN CRISP,Clam
Agrolatina,24A9866956,04/15/2025,Sale,-160.0,0.0,42,AUTUMN CRISP,Clam
Agrolatina,24A9868748,01/19/2025,Entry,1040.0,1040.0,0,SWEET GLOBE,Clam
Agrolatina,24A9868748,01/19/2025,Entry,560.0,1600.0,0,SWEET GLOBE,Clam
Agrolatina,24A9868748,02/07/2025,Sale,-240.0,1360.0,19,SWEET GLOBE,Clam
Agrolatina,24A9868748,02/07/2025,Sale,-240.0,1120.0,19,SWEET GLOBE,Clam
Agrolatina,24A9868748,02/07/2025,Sale,-80.0,1040.0,19,SWEET GLOBE,Clam
Agrolatina,24A9868748,02/10/2025,Sale,-80.0,960.0,22,SWEET GLOBE,Clam
Agrolatina,24A9868748,02/10/2025,Sale,-80.0,880.0,22,SWEET GLOBE,Clam
Agrolatina,24A9868748,02/10/2025,Sale,-80.0,800.0,22,SWEET GLOBE,Clam
Agrolatina,24A9868748,02/10/2025,Sale,-160.0,640.0,22,SWEET GLOBE,Clam
Agrolatina,24A9868748,02/11/2025,Sale,-80.0,560.0,23,SWEET GLOBE,Clam
Agrolatina,24A9868748,02/15/2025,Sale,-160.0,400.0,27,SWEET GLOBE,Clam
Agrolatina,24A9868748,02/15/2025,Sale,-320.0,80.0,27,SWEET GLOBE,Clam
Agrolatina,24A9868748,03/01/2025,Sale,-40.0,40.0,41,SWEET GLOBE,Clam
Agrolatina,24A9876445,03/04/2025,Entry,800.0,800.0,0,TIMCO,Clam
Agrolatina,24A9876445,03/04/2025,Entry,800.0,1600.0,0,TIMCO,Clam
Agrolatina,24A9876445,03/29/2025,Sale,-80.0,1520.0,25,TIMCO,Clam
Agrolatina,24A9876445,04/01/2025,Sale,-80.0,1440.0,28,TIMCO,Clam
Agrolatina,24A9876445,04/06/2025,Sale,-240.0,1200.0,33,TIMCO,Clam
Agrolatina,24A9876445,04/09/2025,Sale,-640.0,560.0,36,TIMCO,Clam
Agrolatina,24A9876445,04/16/2025,Sale,-560.0,0.0,43,TIMCO,Clam
Agrolatina,24A9882700,03/10/2025,Entry,400.0,400.0,0,AUTUMN CRISP,Clam
Agrolatina,24A9882700,03/10/2025,Entry,1200.0,1600.0,0,AUTUMN CRISP,Clam
Agrolatina,24A9882700,03/19/2025,Sale,-240.0,1360.0,9,AUTUMN CRISP,Clam
Agrolatina,24A9882700,04/03/2025,Sale,-160.0,1200.0,24,AUTUMN CRISP,Clam
Agrolatina,24A9882700,04/03/2025,Sale,-1200.0,0.0,24,AUTUMN CRISP,Clam
Agrolatina,24A9883008,03/03/2025,Entry,560.0,560.0,0,SWEET GLOBE,Clam
Agrolatina,24A9883008,03/03/2025,Entry,1040.0,1600.0,0,SWEET GLOBE,Clam
Agrolatina,24A9883008,03/31/2025,Sale,-160.0,1440.0,28,SWEET GLOBE,Clam
Agrolatina,24A9883008,04/01/2025,Sale,-1040.0,400.0,29,SWEET GLOBE,Clam
Agrolatina,24A9883008,04/04/2025,Sale,-400.0,0.0,32,SWEET GLOBE,Clam
Agrolatina,24A9883190,03/03/2025,Entry,1600.0,1600.0,0,AUTUMN CRISP,Clam
Agrolatina,24A9884051,03/03/2025,Entry,640.0,640.0,0,AUTUMN CRISP,Clam
Agrolatina,24A9884051,03/03/2025,Entry,960.0,1600.0,0,AUTUMN CRISP,Clam
Agrolatina,24A9884133,01/13/2025,Entry,1040.0,1040.0,0,CANDY SNAP,Clam
Agrolatina,24A9884133,01/13/2025,Entry,560.0,1600.0,0,CANDY SNAP,Clam
Agrolatina,24A9884133,01/28/2025,Sale,-80.0,1520.0,15,CANDY SNAP,Clam
Agrolatina,24A9884133,01/30/2025,Sale,-400.0,1120.0,17,CANDY SNAP,Clam
Agrolatina,24A9884133,02/01/2025,Sale,-640.0,480.0,19,CANDY SNAP,Clam
Agrolatina,24A9884133,02/10/2025,Sale,-16.0,464.0,28,CANDY SNAP,Clam
Agrolatina,24A9884133,02/14/2025,Sale,-80.0,384.0,32,CANDY SNAP,Clam
Agrolatina,24A9884133,02/18/2025,Sale,-80.0,304.0,36,CANDY SNAP,Clam
Agrolatina,24A9884133,02/19/2025,Sale,-23.0,281.0,37,CANDY SNAP,Clam
Agrolatina,24A9884133,02/19/2025,Sale,-240.0,41.0,37,CANDY SNAP,Clam
Agrolatina,24A9884386,01/13/2025,Entry,1280.0,1280.0,0,CANDY SNAP,Clam
Agrolatina,24A9884386,01/13/2025,Entry,320.0,1600.0,0,CANDY SNAP,Clam
Agrolatina,24A9884386,02/01/2025,Sale,-320.0,1280.0,19,CANDY SNAP,Clam
Agrolatina,24A9884386,02/03/2025,Sale,-800.0,480.0,21,CANDY SNAP,Clam
Agrolatina,24A9884386,02/03/2025,Sale,-240.0,240.0,21,CANDY SNAP,Clam
Agrolatina,24A9884386,02/10/2025,Sale,-150.0,90.0,28,CANDY SNAP,Clam
Agrolatina,24A9884386,02/18/2025,Sale,-47.0,43.0,36,CANDY SNAP,Clam
Agrolatina,24A9884386,02/19/2025,Sale,-24.0,19.0,37,CANDY SNAP,Clam
Agrolatina,24A9884935,03/03/2025,Entry,1120.0,1120.0,0,COTTON CANDY,Clam
Agrolatina,24A9884935,03/03/2025,Entry,480.0,1600.0,0,COTTON CANDY,Clam
Agrolatina,24A9884935,03/28/2025,Sale,-240.0,1360.0,25,COTTON CANDY,Clam
Agrolatina,24A9884935,03/28/2025,Sale,-160.0,1200.0,25,COTTON CANDY,Clam
Agrolatina,24A9884935,03/28/2025,Sale,-80.0,1120.0,25,COTTON CANDY,Clam
Agrolatina,24A9884935,04/03/2025,Sale,-560.0,560.0,31,COTTON CANDY,Clam
Agrolatina,24A9884935,04/04/2025,Sale,-480.0,80.0,32,COTTON CANDY,Clam
Agrolatina,24A9885119,03/10/2025,Entry,1520.0,1520.0,0,TIMCO,Clam
Agrolatina,24A9885119,03/10/2025,Entry,80.0,1600.0,0,TIMCO,Clam
Agrolatina,24A9885119,04/22/2025,Sale,-11.0,1589.0,43,TIMCO,Clam
Agrolatina,24A9885119,04/23/2025,Sale,-80.0,1509.0,44,TIMCO,Clam
Agrolatina,24A9885119,04/26/2025,Sale,-160.0,1349.0,47,TIMCO,Clam
Agrolatina,24A9885382,12/16/2024,Entry,1520.0,1520.0,0,CANDY SNAP,Clam
Agrolatina,24A9885382,12/16/2024,Entry,80.0,1600.0,0,CANDY SNAP,Clam
Agrolatina,24A9885382,12/24/2024,Sale,-1520.0,80.0,8,CANDY SNAP,Clam
Agrolatina,24A9885382,12/24/2024,Sale,-80.0,0.0,8,CANDY SNAP,Clam
Agrolatina,24A9885464,02/24/2025,Entry,1120.0,1120.0,0,TIMCO,Clam
Agrolatina,24A9885464,02/24/2025,Entry,480.0,1600.0,0,TIMCO,Clam
Agrolatina,24A9885464,03/21/2025,Sale,-80.0,1520.0,25,TIMCO,Clam
Agrolatina,24A9885464,03/24/2025,Sale,-480.0,1040.0,28,TIMCO,Clam
Agrolatina,24A9885464,03/24/2025,Sale,-640.0,400.0,28,TIMCO,Clam
Agrolatina,24A9885464,04/06/2025,Sale,-400.0,0.0,41,TIMCO,Clam
Agrolatina,24A9886286,04/07/2025,Entry,1040.0,1040.0,0,JACK SALUTE,Clam
Agrolatina,24A9886286,04/07/2025,Entry,560.0,1600.0,0,JACK SALUTE,Clam
Agrolatina,24A9886286,04/14/2025,Sale,-560.0,1040.0,7,JACK SALUTE,Clam
Agrolatina,24A9886286,04/29/2025,Sale,-160.0,880.0,22,JACK SALUTE,Clam
Agrolatina,24A9886286,04/29/2025,Sale,-400.0,480.0,22,JACK SALUTE,Clam
Agrolatina,24A9886286,05/14/2025,Sale,-160.0,320.0,37,JACK SALUTE,Clam
Agrolatina,24A9886286,05/14/2025,Sale,-320.0,0.0,37,JACK SALUTE,Clam
Agrolatina,24A9886985,02/13/2025,Entry,1045.0,1045.0,0,IVORY,Bag
Agrolatina,24A9886985,02/13/2025,Entry,760.0,1805.0,0,IVORY,Bag
Agrolatina,24A9886985,03/04/2025,Sale,-95.0,1710.0,19,IVORY,Bag
Agrolatina,24A9886985,03/05/2025,Sale,-95.0,1615.0,20,IVORY,Bag
Agrolatina,24A9886985,03/11/2025,Sale,-760.0,855.0,26,IVORY,Bag
Agrolatina,24A9886985,03/17/2025,Sale,-855.0,0.0,32,IVORY,Bag
Agrolatina,24A9889668,03/03/2025,Entry,160.0,160.0,0,AUTUMN CRISP,Clam
Agrolatina,24A9889668,03/03/2025,Entry,1440.0,1600.0,0,AUTUMN CRISP,Clam
Agrolatina,24A9889713,01/13/2025,Entry,1520.0,1520.0,0,IVORY,Clam
Agrolatina,24A9889713,01/13/2025,Entry,80.0,1600.0,0,IVORY,Clam
Agrolatina,24A9889713,01/15/2025,Sale,-1520.0,80.0,2,IVORY,Clam
Agrolatina,24A9889713,01/15/2025,Sale,-80.0,0.0,2,IVORY,Clam
Agrolatina,24A9890078,02/03/2025,Entry,240.0,240.0,0,CANDY DREAMS,Clam
Agrolatina,24A9890078,02/03/2025,Entry,1360.0,1600.0,0,CANDY DREAMS,Clam
Agrolatina,24A9890078,03/07/2025,Sale,-240.0,1360.0,32,CANDY DREAMS,Clam
Agrolatina,24A9890078,03/07/2025,Sale,-1162.0,198.0,32,CANDY DREAMS,Clam
Agrolatina,24A9890078,03/11/2025,Sale,-30.0,168.0,36,CANDY DREAMS,Clam
Agrolatina,24A9890904,01/30/2025,Entry,880.0,880.0,0,SWEET GLOBE,Clam
Agrolatina,24A9890904,01/30/2025,Entry,720.0,1600.0,0,SWEET GLOBE,Clam
Agrolatina,24A9890904,02/05/2025,Sale,-80.0,1520.0,6,SWEET GLOBE,Clam
Agrolatina,24A9890904,02/10/2025,Sale,-880.0,640.0,11,SWEET GLOBE,Clam
Agrolatina,24A9890904,02/10/2025,Sale,-160.0,480.0,11,SWEET GLOBE,Clam
Agrolatina,24A9890904,02/11/2025,Sale,-80.0,400.0,12,SWEET GLOBE,Clam
Agrolatina,24A9890904,02/15/2025,Sale,-400.0,0.0,16,SWEET GLOBE,Clam
Agrolatina,24A9890925,03/10/2025,Entry,400.0,400.0,0,AUTUMN CRISP,Clam
Agrolatina,24A9890925,03/10/2025,Entry,1200.0,1600.0,0,AUTUMN CRISP,Clam
Agrolatina,24A9890925,04/01/2025,Sale,-400.0,1200.0,22,AUTUMN CRISP,Clam
Agrolatina,24A9890925,04/11/2025,Sale,-1200.0,0.0,32,AUTUMN CRISP,Clam
Agrolatina,24A9892065,12/29/2024,Entry,1520.0,1520.0,0,CANDY SNAP,Clam
Agrolatina,24A9892065,12/29/2024,Entry,80.0,1600.0,0,CANDY SNAP,Clam
Agrolatina,24A9892065,01/09/2025,Sale,-1520.0,80.0,11,CANDY SNAP,Clam
Agrolatina,24A9892065,01/09/2025,Sale,-80.0,0.0,11,CANDY SNAP,Clam
Agrolatina,24A9892229,01/13/2025,Entry,1440.0,1440.0,0,CANDY SNAP,Clam
Agrolatina,24A9892229,01/13/2025,Entry,160.0,1600.0,0,CANDY SNAP,Clam
Agrolatina,24A9892229,01/21/2025,Sale,-80.0,1520.0,8,CANDY SNAP,Clam
Agrolatina,24A9892229,01/25/2025,Sale,-80.0,1440.0,12,CANDY SNAP,Clam
Agrolatina,24A9892229,01/25/2025,Sale,-80.0,1360.0,12,CANDY SNAP,Clam
Agrolatina,24A9892229,01/28/2025,Sale,-80.0,1280.0,15,CANDY SNAP,Clam
Agrolatina,24A9892229,02/03/2025,Sale,-80.0,1200.0,21,CANDY SNAP,Clam
Agrolatina,24A9892229,02/04/2025,Sale,-480.0,720.0,22,CANDY SNAP,Clam
Agrolatina,24A9892229,02/05/2025,Sale,-320.0,400.0,23,CANDY SNAP,Clam
Agrolatina,24A9892229,02/05/2025,Sale,-320.0,80.0,23,CANDY SNAP,Clam
Agrolatina,24A9892229,02/10/2025,Sale,-74.0,6.0,28,CANDY SNAP,Clam
Agrolatina,24A9892574,12/16/2024,Entry,1600.0,1600.0,0,CANDY SNAP,Clam
Agrolatina,24A9892574,12/23/2024,Sale,-1440.0,160.0,7,CANDY SNAP,Clam
Agrolatina,24A9892574,12/24/2024,Sale,-160.0,0.0,8,CANDY SNAP,Clam
Agrolatina,24A9892682,02/03/2025,Entry,1280.0,1280.0,0,ALLISON,Clam
Agrolatina,24A9892682,02/03/2025,Entry,320.0,1600.0,0,ALLISON,Clam
Agrolatina,24A9892682,02/25/2025,Sale,-960.0,640.0,22,ALLISON,Clam
Agrolatina,24A9892682,02/27/2025,Sale,-240.0,400.0,24,ALLISON,Clam
Agrolatina,24A9892682,03/04/2025,Sale,-80.0,320.0,29,ALLISON,Clam
Agrolatina,24A9892682,03/09/2025,Sale,-320.0,0.0,34,ALLISON,Clam
Agrolatina,24A9893020,02/24/2025,Entry,800.0,800.0,0,SWEET GLOBE,Clam
Agrolatina,24A9893020,02/24/2025,Entry,800.0,1600.0,0,SWEET GLOBE,Clam
Agrolatina,24A9893020,02/26/2025,Sale,-80.0,1520.0,2,SWEET GLOBE,Clam
Agrolatina,24A9893020,02/27/2025,Sale,-80.0,1440.0,3,SWEET GLOBE,Clam
Agrolatina,24A9893020,03/01/2025,Sale,-320.0,1120.0,5,SWEET GLOBE,Clam
Agrolatina,24A9893020,03/11/2025,Sale,-400.0,720.0,15,SWEET GLOBE,Clam
Agrolatina,24A9893020,03/11/2025,Sale,-80.0,640.0,15,SWEET GLOBE,Clam
Agrolatina,24A9893020,03/17/2025,Sale,-80.0,560.0,21,SWEET GLOBE,Clam
Agrolatina,24A9893020,03/18/2025,Sale,-560.0,0.0,22,SWEET GLOBE,Clam
Agrolatina,24A9893122,03/03/2025,Entry,160.0,160.0,0,AUTUMN CRISP,Clam
Agrolatina,24A9893122,03/03/2025,Entry,1440.0,1600.0,0,AUTUMN CRISP,Clam
Agrolatina,24A9893122,03/08/2025,Sale,-160.0,1440.0,5,AUTUMN CRISP,Clam
Agrolatina,24A9893122,03/26/2025,Sale,-1440.0,0.0,23,AUTUMN CRISP,Clam
Agrolatina,24A9893400,04/07/2025,Entry,880.0,880.0,0,JACK SALUTE,Clam
Agrolatina,24A9893400,04/07/2025,Entry,720.0,1600.0,0,JACK SALUTE,Clam
Agrolatina,24A9893400,04/26/2025,Sale,-880.0,720.0,19,JACK SALUTE,Clam
Agrolatina,24A9893400,04/26/2025,Sale,-640.0,80.0,19,JACK SALUTE,Clam
Agrolatina,24A9893400,04/29/2025,Sale,-80.0,0.0,22,JACK SALUTE,Clam
Agrolatina,24A9893647,01/13/2025,Entry,1520.0,1520.0,0,SWEET GLOBE,Clam
Agrolatina,24A9893647,01/13/2025,Entry,80.0,1600.0,0,SWEET GLOBE,Clam
Agrolatina,24A9893647,01/15/2025,Sale,-240.0,1360.0,2,SWEET GLOBE,Clam
Agrolatina,24A9893647,01/15/2025,Sale,-1120.0,240.0,2,SWEET GLOBE,Clam
Agrolatina,24A9893647,01/15/2025,Sale,-160.0,80.0,2,SWEET GLOBE,Clam
Agrolatina,24A9893647,01/15/2025,Sale,-80.0,0.0,2,SWEET GLOBE,Clam
Agrolatina,24A9894366,03/24/2025,Entry,1040.0,1040.0,0,JACK SALUTE,Clam
Agrolatina,24A9894366,03/24/2025,Entry,560.0,1600.0,0,JACK SALUTE,Clam
Agrolatina,24A9894366,05/07/2025,Sale,-1040.0,560.0,44,JACK SALUTE,Clam
Agrolatina,24A9894366,05/07/2025,Sale,-560.0,0.0,44,JACK SALUTE,Clam
Agrolatina,24A9895070,03/09/2025,Entry,1440.0,1440.0,0,IVORY,Clam
Agrolatina,24A9895070,03/09/2025,Entry,160.0,1600.0,0,IVORY,Clam
Agrolatina,24A9895070,03/25/2025,Sale,-1280.0,320.0,16,IVORY,Clam
Agrolatina,24A9895070,03/29/2025,Sale,-80.0,240.0,20,IVORY,Clam
Agrolatina,24A9895070,03/29/2025,Sale,-40.0,200.0,20,IVORY,Clam
Agrolatina,24A9895070,04/07/2025,Sale,-100.0,100.0,29,IVORY,Clam
Agrolatina,24A9911079,03/04/2025,Entry,800.0,800.0,0,SWEET GLOBE,Clam
Agrolatina,24A9911079,03/04/2025,Entry,800.0,1600.0,0,SWEET GLOBE,Clam
Agrolatina,24A9911079,03/08/2025,Sale,-640.0,960.0,4,SWEET GLOBE,Clam
Agrolatina,24A9911079,03/13/2025,Sale,-40.0,920.0,9,SWEET GLOBE,Clam
Agrolatina,24A9911079,03/14/2025,Sale,-60.0,860.0,10,SWEET GLOBE,Clam
Agrolatina,24A9911079,03/15/2025,Sale,-320.0,540.0,11,SWEET GLOBE,Clam
Agrolatina,24A9911079,03/17/2025,Sale,-80.0,460.0,13,SWEET GLOBE,Clam
Agrolatina,24A9927035,02/26/2025,Entry,640.0,640.0,0,CANDY DREAMS,Clam
Agrolatina,24A9927035,02/26/2025,Entry,960.0,1600.0,0,CANDY DREAMS,Clam
Agrolatina,24A9927035,03/06/2025,Sale,-720.0,880.0,8,CANDY DREAMS,Clam
Agrolatina,24A9927035,03/10/2025,Sale,-560.0,320.0,12,CANDY DREAMS,Clam
Agrolatina,24A9927035,03/28/2025,Sale,-80.0,240.0,30,CANDY DREAMS,Clam
Agrolatina,24A9927035,03/28/2025,Sale,-62.0,178.0,30,CANDY DREAMS,Clam
Agrolatina,24A9927035,03/31/2025,Sale,-160.0,18.0,33,CANDY DREAMS,Clam
Agrolatina,24A9940799,01/27/2025,Entry,1120.0,1120.0,0,SWEET GLOBE,Clam
Agrolatina,24A9940799,01/27/2025,Entry,480.0,1600.0,0,SWEET GLOBE,Clam
Agrolatina,24A9940799,02/12/2025,Sale,-80.0,1520.0,16,SWEET GLOBE,Clam
Agrolatina,24A9940799,02/15/2025,Sale,-1120.0,400.0,19,SWEET GLOBE,Clam
Agrolatina,24A9940799,02/15/2025,Sale,-400.0,0.0,19,SWEET GLOBE,Clam
Agrolatina,24A9952613,01/27/2025,Entry,1360.0,1360.0,0,SWEET GLOBE,Clam
Agrolatina,24A9952613,01/27/2025,Entry,240.0,1600.0,0,SWEET GLOBE,Clam
Agrolatina,24A9952613,01/29/2025,Sale,-1360.0,240.0,2,SWEET GLOBE,Clam
Agrolatina,24A9952613,01/30/2025,Sale,-240.0,0.0,3,SWEET GLOBE,Clam
Agrolatina,24A9961813,02/06/2025,Entry,800.0,800.0,0,ALLISON,Clam
Agrolatina,24A9961813,02/06/2025,Entry,800.0,1600.0,0,ALLISON,Clam
Agrolatina,24A9961813,03/04/2025,Sale,-160.0,1440.0,26,ALLISON,Clam
Agrolatina,24A9961813,03/04/2025,Sale,-80.0,1360.0,26,ALLISON,Clam
Agrolatina,24A9961813,03/04/2025,Sale,-160.0,1200.0,26,ALLISON,Clam
Agrolatina,24A9961813,03/05/2025,Sale,-80.0,1120.0,27,ALLISON,Clam
Agrolatina,24A9961813,03/12/2025,Sale,-640.0,480.0,34,ALLISON,Clam
Agrolatina,24A9961813,03/13/2025,Sale,-80.0,400.0,35,ALLISON,Clam
Agrolatina,24A9961813,03/14/2025,Sale,-240.0,160.0,36,ALLISON,Clam
Agrolatina,24A9961813,03/18/2025,Sale,-80.0,80.0,40,ALLISON,Clam
Agrolatina,24A9962888,02/17/2025,Entry,1440.0,1440.0,0,IVORY,Clam
Agrolatina,24A9962888,02/17/2025,Entry,160.0,1600.0,0,IVORY,Clam
Agrolatina,24A9962888,03/04/2025,Sale,-240.0,1360.0,15,IVORY,Clam
Agrolatina,24A9962888,03/04/2025,Sale,-560.0,800.0,15,IVORY,Clam
Agrolatina,24A9962888,03/21/2025,Sale,-160.0,640.0,32,IVORY,Clam
Agrolatina,24A9962888,03/22/2025,Sale,-80.0,560.0,33,IVORY,Clam
Agrolatina,24A9962888,03/22/2025,Sale,-160.0,400.0,33,IVORY,Clam
Agrolatina,24A9962888,03/22/2025,Sale,-80.0,320.0,33,IVORY,Clam
Agrolatina,24A9962888,03/24/2025,Sale,-60.0,260.0,35,IVORY,Clam
Agrolatina,24A9962888,03/27/2025,Sale,-80.0,180.0,38,IVORY,Clam
Agrolatina,24A9962888,03/27/2025,Sale,-75.0,105.0,38,IVORY,Clam
Agrolatina,24A9977234,02/17/2025,Entry,880.0,880.0,0,SWEET GLOBE,Clam
Agrolatina,24A9977234,02/17/2025,Entry,720.0,1600.0,0,SWEET GLOBE,Clam
Agrolatina,24A9977234,03/08/2025,Sale,-160.0,1440.0,19,SWEET GLOBE,Clam
Agrolatina,24A9977234,03/08/2025,Sale,-160.0,1280.0,19,SWEET GLOBE,Clam
Agrolatina,24A9977234,03/08/2025,Sale,-560.0,720.0,19,SWEET GLOBE,Clam
Agrolatina,24A9977234,03/10/2025,Sale,-80.0,640.0,21,SWEET GLOBE,Clam
Agrolatina,24A9977234,03/13/2025,Sale,-280.0,360.0,24,SWEET GLOBE,Clam
Agrolatina,24A9977234,03/15/2025,Sale,-40.0,320.0,26,SWEET GLOBE,Clam
Agrolatina,24A9977234,03/15/2025,Sale,-80.0,240.0,26,SWEET GLOBE,Clam
Agrolatina,24A9990367,01/19/2025,Entry,240.0,240.0,0,IVORY,Clam
Agrolatina,24A9990367,01/19/2025,Entry,1120.0,1360.0,0,SWEET GLOBE,Clam
Agrolatina,24A9990367,01/19/2025,Entry,240.0,1600.0,0,SWEET GLOBE,Clam
Agrolatina,24A9990367,02/06/2025,Sale,-240.0,1360.0,18,SWEET GLOBE,Clam
Agrolatina,24A9990367,02/07/2025,Sale,-80.0,1280.0,19,SWEET GLOBE,Clam
Agrolatina,24A9990367,02/08/2025,Sale,-80.0,1200.0,20,SWEET GLOBE,Clam
Agrolatina,24A9990367,02/08/2025,Sale,-240.0,960.0,20,SWEET GLOBE,Clam
Agrolatina,24A9990367,02/11/2025,Sale,-80.0,880.0,23,SWEET GLOBE,Clam
Agrolatina,24A9990367,02/12/2025,Sale,-80.0,800.0,24,SWEET GLOBE,Clam
Agrolatina,24A9990367,02/13/2025,Sale,-160.0,640.0,25,IVORY,Clam
Agrolatina,24A9990367,02/15/2025,Sale,-160.0,480.0,27,SWEET GLOBE,Clam
Agrolatina,24A9990367,02/17/2025,Sale,-80.0,400.0,29,SWEET GLOBE,Clam
Agrolatina,24A9990367,02/22/2025,Sale,-26.0,374.0,34,SWEET GLOBE,Clam
Agrolatina,24A9990367,02/22/2025,Sale,-27.0,347.0,34,SWEET GLOBE,Clam
Agrolatina,24A9990367,02/25/2025,Sale,-40.0,307.0,37,SWEET GLOBE,Clam
Agrolatina,24A9990367,02/28/2025,Sale,-25.0,282.0,40,SWEET GLOBE,Clam
Agrolatina,24A9990367,03/08/2025,Sale,-80.0,202.0,48,SWEET GLOBE,Clam
Agrolatina,24X5405740,01/22/2025,Sale,-1360.0,-1360.0,0,SWEET GLOBE,Clam
Agrolatina,24X5405740,01/22/2025,Sale,-80.0,-1440.0,0,SWEET GLOBE,Clam
Agrolatina,24X5405740,01/22/2025,Sale,-160.0,-1600.0,0,SWEET GLOBE,Clam
Agrolatina,24X5405740,01/25/2025,Entry,1360.0,-240.0,3,SWEET GLOBE,Clam
Agrolatina,24X5405740,01/25/2025,Entry,80.0,-160.0,3,SWEET GLOBE,Clam
Agrolatina,24X5405740,01/25/2025,Entry,160.0,0.0,3,SWEET GLOBE,Clam
Agrolatina,24X5480363,01/22/2025,Sale,-1040.0,-1040.0,0,SWEET GLOBE,Clam
Agrolatina,24X5480363,01/22/2025,Sale,-560.0,-1600.0,0,SWEET GLOBE,Clam
Agrolatina,24X5480363,01/30/2025,Entry,1040.0,-560.0,8,SWEET GLOBE,Clam
Agrolatina,24X5480363,01/30/2025,Entry,560.0,0.0,8,SWEET GLOBE,Clam
Agrolatina,24X5543590,01/22/2025,Sale,-1200.0,-1200.0,0,SWEET GLOBE,Clam
Agrolatina,24X5543590,01/22/2025,Sale,-400.0,-1600.0,0,SWEET GLOBE,Clam
Agrolatina,24X5543590,01/30/2025,Entry,1200.0,-400.0,8,SWEET GLOBE,Clam
Agrolatina,24X5543590,01/30/2025,Entry,400.0,0.0,8,SWEET GLOBE,Clam
Agrolatina,24X5553285,01/22/2025,Sale,-1360.0,-1360.0,0,SWEET GLOBE,Clam
Agrolatina,24X5553285,01/22/2025,Sale,-240.0,-1600.0,0,SWEET GLOBE,Clam
Agrolatina,24X5553285,02/20/2025,Entry,1360.0,-240.0,29,SWEET GLOBE,Clam
Agrolatina,24X5553285,02/20/2025,Entry,240.0,0.0,29,SWEET GLOBE,Clam
Agrolatina,24X5566810,01/22/2025,Sale,-1040.0,-1040.0,0,SWEET GLOBE,Clam
Agrolatina,24X5566810,01/22/2025,Sale,-560.0,-1600.0,0,SWEET GLOBE,Clam
Agrolatina,24X5566810,02/20/2025,Entry,1040.0,-560.0,29,SWEET GLOBE,Clam
Agrolatina,24X5566810,02/20/2025,Entry,560.0,0.0,29,SWEET GLOBE,Clam
Agrovita,24V2506094,02/28/2025,Entry,96.0,96.0,0,ALLISON,Bag
Agrovita,24V2506094,02/28/2025,Entry,1193.0,1289.0,0,JACK SALUTE,Bag
Agrovita,24V2506094,02/28/2025,Entry,288.0,1577.0,0,JACK SALUTE,Bag
Agrovita,24V2506094,02/28/2025,Entry,192.0,1769.0,0,JACK SALUTE,Bag
Agrovita,24V2506094,02/28/2025,Entry,672.0,2441.0,0,MELODY,Bag
Agrovita,24V2506094,02/28/2025,Entry,192.0,2633.0,0,MELODY,Bag
Agrovita,24V2506094,02/28/2025,Entry,1056.0,3689.0,0,MELODY,Bag
Agrovita,24V2506094,03/12/2025,Sale,-192.0,3497.0,12,JACK SALUTE,Bag
Agrovita,24V2506094,03/13/2025,Sale,-1108.0,2389.0,13,JACK SALUTE,Bag
Agrovita,24V2506094,03/13/2025,Sale,-288.0,2101.0,13,JACK SALUTE,Bag
Agrovita,24V2506094,03/18/2025,Sale,-85.0,2016.0,18,JACK SALUTE,Bag
Agrovita,24V2506094,03/21/2025,Sale,-96.0,1920.0,21,ALLISON,Bag
Agrovita,24V2506094,04/11/2025,Sale,-960.0,960.0,42,MELODY,Bag
Agrovita,24V2506094,04/24/2025,Sale,-672.0,288.0,55,MELODY,Bag
Agrovita,24V2506094,04/24/2025,Sale,-96.0,192.0,55,MELODY,Bag
Agrovita,24V2506094,04/24/2025,Sale,-192.0,0.0,55,MELODY,Bag
Agrovita,24V7508204,03/16/2025,Entry,1600.0,1600.0,0,ALLISON,Clam
Agrovita,24V7508204,04/20/2025,Sale,-400.0,1200.0,35,ALLISON,Clam
Agrovita,24V7508204,04/24/2025,Sale,-77.0,1123.0,39,ALLISON,Clam
Agrovita,24V7508204,04/24/2025,Sale,-400.0,723.0,39,ALLISON,Clam
Agrovita,24V7508204,04/24/2025,Sale,-323.0,400.0,39,ALLISON,Clam
Agrovita,24V7508204,05/03/2025,Sale,-21.0,379.0,48,ALLISON,Clam
Agrovita,24V8505059,02/18/2025,Entry,192.0,192.0,0,JACK SALUTE,Bag
Agrovita,24V8505059,02/18/2025,Entry,96.0,288.0,0,JACK SALUTE,Bag
Agrovita,24V8505059,02/18/2025,Entry,576.0,864.0,0,JACK SALUTE,Bag
Agrovita,24V8505059,02/18/2025,Entry,480.0,1344.0,0,JACK SALUTE,Bag
Agrovita,24V8505059,02/18/2025,Entry,384.0,1728.0,0,JACK SALUTE,Bag
Agrovita,24V8505059,03/04/2025,Sale,-96.0,1632.0,14,JACK SALUTE,Bag
Agrovita,24V8505059,03/04/2025,Sale,-480.0,1152.0,14,JACK SALUTE,Bag
Agrovita,24V8505059,03/04/2025,Sale,-384.0,768.0,14,JACK SALUTE,Bag
Agrovita,24V8505059,03/07/2025,Sale,-96.0,672.0,17,JACK SALUTE,Bag
Agrovita,24V8505059,03/12/2025,Sale,-288.0,384.0,22,JACK SALUTE,Bag
Agrovita,24V8505059,03/18/2025,Sale,-96.0,288.0,28,JACK SALUTE,Bag
Agrovita,24V8505059,03/24/2025,Sale,-96.0,192.0,34,JACK SALUTE,Bag
Agrovita,24V8505059,03/27/2025,Sale,-96.0,96.0,37,JACK SALUTE,Bag
Agrovita,24V8511058,04/04/2025,Entry,1111.0,1111.0,0,ALLISON,Bag
Agrovita,24V8511058,04/04/2025,Entry,189.0,1300.0,0,MELODY,Bag
Agrovita,24V8511058,04/10/2025,Sale,-192.0,1108.0,6,ALLISON,Bag
Agrovita,24V8511058,04/12/2025,Sale,-432.0,676.0,8,ALLISON,Bag
Agrovita,24V8511058,04/14/2025,Sale,-56.0,620.0,10,ALLISON,Bag
Agrovita,24V8511058,04/14/2025,Sale,-45.0,575.0,10,ALLISON,Bag
Agrovita,24V8511058,04/15/2025,Sale,-96.0,479.0,11,ALLISON,Bag
Agrovita,24V8511058,04/15/2025,Sale,-192.0,287.0,11,ALLISON,Bag
Agrovita,24V8511058,04/15/2025,Sale,-88.0,199.0,11,ALLISON,Bag
Agrovita,24V8511058,04/24/2025,Sale,-96.0,103.0,20,MELODY,Bag
Agrovita,24V8511058,04/24/2025,Sale,-93.0,10.0,20,MELODY,Bag
Agrovita,24V9330622,02/10/2025,Entry,1080.0,1080.0,0,JACK SALUTE,Bag
Agrovita,24V9330622,02/10/2025,Entry,1028.0,2108.0,0,JACK SALUTE,Bag
Agrovita,24V9330622,02/14/2025,Sale,-406.0,1702.0,4,JACK SALUTE,Bag
Agrovita,24V9330622,02/14/2025,Sale,-298.0,1404.0,4,JACK SALUTE,Bag
Agrovita,24V9330622,02/20/2025,Sale,-1080.0,324.0,10,JACK SALUTE,Bag
Agrovita,24V9330622,02/20/2025,Sale,-324.0,0.0,10,JACK SALUTE,Bag
Agrovita,24V9336620,02/10/2025,Entry,108.0,108.0,0,ALLISON,Bag
Agrovita,24V9336620,02/10/2025,Entry,864.0,972.0,0,ALLISON,Bag
Agrovita,24V9336620,02/10/2025,Entry,1188.0,2160.0,0,ALLISON,Bag
Agrovita,24V9336620,02/21/2025,Sale,-756.0,1404.0,11,ALLISON,Bag
Agrovita,24V9336620,02/21/2025,Sale,-108.0,1296.0,11,ALLISON,Bag
Agrovita,24V9336620,02/21/2025,Sale,-1080.0,216.0,11,ALLISON,Bag
Agrovita,24V9336620,02/25/2025,Sale,-108.0,108.0,15,ALLISON,Bag
Agrovita,24V9336620,04/10/2025,Sale,-108.0,0.0,59,ALLISON,Bag
Agrovita,24V9350378,03/18/2025,Entry,864.0,864.0,0,MELODY,Bag
Agrovita,24V9350378,03/18/2025,Entry,1056.0,1920.0,0,MELODY,Bag
Agrovita,24V9350378,04/18/2025,Sale,-192.0,1728.0,31,MELODY,Bag
Agrovita,24V9350378,04/19/2025,Sale,-192.0,1536.0,32,MELODY,Bag
Agrovita,24V9350378,04/23/2025,Sale,-18.0,1518.0,36,MELODY,Bag
Agrovita,24V9350378,04/24/2025,Sale,-96.0,1422.0,37,MELODY,Bag
Agrovita,24V9350378,04/24/2025,Sale,-252.0,1170.0,37,MELODY,Bag
Agrovita,24V9350378,04/24/2025,Sale,-864.0,306.0,37,MELODY,Bag
Agrovita,24V9350378,04/24/2025,Sale,-192.0,114.0,37,MELODY,Bag
Agrovita,24V9351899,03/18/2025,Entry,384.0,384.0,0,ALLISON,Bag
Agrovita,24V9351899,03/18/2025,Entry,288.0,672.0,0,MELODY,Bag
Agrovita,24V9351899,03/18/2025,Entry,1056.0,1728.0,0,MELODY,Bag
Agrovita,24V9351899,03/18/2025,Entry,96.0,1824.0,0,RED SDLS,Bag
Agrovita,24V9351899,03/18/2025,Entry,108.0,1932.0,0,RED SDLS,Bag
Agrovita,24V9351899,03/25/2025,Sale,-96.0,1836.0,7,RED SDLS,Bag
Agrovita,24V9351899,03/28/2025,Sale,-288.0,1548.0,10,ALLISON,Bag
Agrovita,24V9351899,04/01/2025,Sale,-96.0,1452.0,14,ALLISON,Bag
Agrovita,24V9351899,04/08/2025,Sale,-108.0,1344.0,21,RED SDLS,Bag
Agrovita,24V9351899,04/24/2025,Sale,-288.0,1056.0,37,MELODY,Bag
Agrovita,24V9351899,04/24/2025,Sale,-288.0,768.0,37,MELODY,Bag
Agrovita,24V9351899,04/24/2025,Sale,-672.0,96.0,37,MELODY,Bag
Agrovita,24V9511077,03/26/2025,Entry,1152.0,1152.0,0,MELODY,Bag
Agrovita,24V9511077,04/23/2025,Sale,-90.0,1062.0,28,MELODY,Bag
Agrovita,24V9511077,04/26/2025,Sale,-480.0,582.0,31,MELODY,Bag
Agrovita,24V9627198,01/31/2025,Entry,342.0,342.0,0,FLAME,Bag
Agrovita,24V9627198,01/31/2025,Entry,1080.0,1422.0,0,TIMPSON,Bag
Agrovita,24V9627198,01/31/2025,Entry,648.0,2070.0,0,TIMPSON,Bag
Agrovita,24V9627198,01/31/2025,Entry,114.0,2184.0,0,TIMPSON,Bag
Agrovita,24V9627198,03/24/2025,Sale,-864.0,1320.0,52,TIMPSON,Bag
Agrovita,24V9627198,03/24/2025,Sale,-475.0,845.0,52,TIMPSON,Bag
Agrovita,24V9627198,03/27/2025,Sale,-98.0,747.0,55,FLAME,Bag
Agrovita,24V9627198,03/27/2025,Sale,-84.0,663.0,55,FLAME,Bag
Agrovita,24V9744804,03/26/2025,Entry,1080.0,1080.0,0,ALLISON,Bag
Agrovita,24V9744804,03/26/2025,Entry,1080.0,2160.0,0,ALLISON,Bag
Agrovita,24V9744804,03/31/2025,Sale,-864.0,1296.0,5,ALLISON,Bag
Agrovita,24V9744804,04/04/2025,Sale,-108.0,1188.0,9,ALLISON,Bag
Agrovita,24V9744804,04/04/2025,Sale,-216.0,972.0,9,ALLISON,Bag
Agrovita,24V9744804,04/04/2025,Sale,-756.0,216.0,9,ALLISON,Bag
Agrovita,24V9744804,04/11/2025,Sale,-108.0,108.0,16,ALLISON,Bag
Agrovita,24V9744804,04/24/2025,Sale,-106.0,2.0,29,ALLISON,Bag
Agrovita,24V9861462,03/26/2025,Entry,216.0,216.0,0,ALLISON,Bag
Agrovita,24V9861462,03/26/2025,Entry,324.0,540.0,0,ALLISON,Bag
Agrovita,24V9861462,03/26/2025,Entry,672.0,1212.0,0,JACK SALUTE,Bag
Agrovita,24V9861462,03/26/2025,Entry,96.0,1308.0,0,MELODY,Bag
Agrovita,24V9861462,03/26/2025,Entry,540.0,1848.0,0,RED SDLS,Bag
Agrovita,24V9861462,03/26/2025,Entry,216.0,2064.0,0,RED SDLS,Bag
Agrovita,24V9861462,03/31/2025,Sale,-216.0,1848.0,5,ALLISON,Bag
Agrovita,24V9861462,04/01/2025,Sale,-216.0,1632.0,6,ALLISON,Bag
Agrovita,24V9861462,04/04/2025,Sale,-108.0,1524.0,9,ALLISON,Bag
Agrovita,24V9861462,04/04/2025,Sale,-672.0,852.0,9,JACK SALUTE,Bag
Agrovita,24V9861462,04/07/2025,Sale,-324.0,528.0,12,RED SDLS,Bag
Agrovita,24V9861462,04/08/2025,Sale,-216.0,312.0,13,RED SDLS,Bag
Agrovita,24V9861462,04/15/2025,Sale,-216.0,96.0,20,RED SDLS,Bag
Agrovita,24V9861462,04/24/2025,Sale,-96.0,0.0,29,MELODY,Bag
Agrovita,24V9861781,02/18/2025,Entry,648.0,648.0,0,TAWNY,Bag
Agrovita,24V9861781,02/18/2025,Entry,1512.0,2160.0,0,TAWNY,Bag
Agrovita,24V9861781,03/03/2025,Sale,-756.0,1404.0,13,TAWNY,Bag
Agrovita,24V9861781,03/10/2025,Sale,-324.0,1080.0,20,TAWNY,Bag
Agrovita,24V9861781,03/10/2025,Sale,-108.0,972.0,20,TAWNY,Bag
Agrovita,24V9861781,03/10/2025,Sale,-756.0,216.0,20,TAWNY,Bag
Agrovita,24V9861781,03/17/2025,Sale,-216.0,0.0,27,TAWNY,Bag
Agrovita,24V9869210,02/18/2025,Entry,432.0,432.0,0,ALLISON,Bag
Agrovita,24V9869210,02/18/2025,Entry,108.0,540.0,0,ALLISON,Bag
Agrovita,24V9869210,02/18/2025,Entry,756.0,1296.0,0,JACK SALUTE,Bag
Agrovita,24V9869210,02/18/2025,Entry,108.0,1404.0,0,JACK SALUTE,Bag
Agrovita,24V9869210,02/18/2025,Entry,756.0,2160.0,0,JACK SALUTE,Bag
Agrovita,24V9869210,02/28/2025,Sale,-216.0,1944.0,10,JACK SALUTE,Bag
Agrovita,24V9869210,02/28/2025,Sale,-432.0,1512.0,10,JACK SALUTE,Bag
Agrovita,24V9869210,03/04/2025,Sale,-108.0,1404.0,14,JACK SALUTE,Bag
Agrovita,24V9869210,03/13/2025,Sale,-216.0,1188.0,23,JACK SALUTE,Bag
Agrovita,24V9869210,03/13/2025,Sale,-432.0,756.0,23,JACK SALUTE,Bag
Agrovita,24V9869210,03/14/2025,Sale,-108.0,648.0,24,ALLISON,Bag
Agrovita,24V9869210,03/18/2025,Sale,-432.0,216.0,28,ALLISON,Bag
Agrovita,24V9869210,03/18/2025,Sale,-108.0,108.0,28,JACK SALUTE,Bag
Agrovita,24V9869210,03/18/2025,Sale,-108.0,0.0,28,JACK SALUTE,Bag
MDT,24M1448891,04/03/2025,Entry,480.0,480.0,0,SWEET GLOBE,Bag
MDT,24M1448891,04/03/2025,Entry,288.0,768.0,0,SWEET GLOBE,Bag
MDT,24M1448891,04/03/2025,Entry,1152.0,1920.0,0,SWEET GLOBE,Bag
MDT,24M1448891,04/15/2025,Sale,-480.0,1440.0,12,SWEET GLOBE,Bag
MDT,24M1448891,04/16/2025,Sale,-383.0,1057.0,13,SWEET GLOBE,Bag
MDT,24M1448891,04/18/2025,Sale,-96.0,961.0,15,SWEET GLOBE,Bag
MDT,24M1448891,04/18/2025,Sale,-96.0,865.0,15,SWEET GLOBE,Bag
MDT,24M1448891,04/22/2025,Sale,-192.0,673.0,19,SWEET GLOBE,Bag
MDT,24M1448891,04/23/2025,Sale,-288.0,385.0,20,SWEET GLOBE,Bag
MDT,24M1448891,04/26/2025,Sale,-96.0,289.0,23,SWEET GLOBE,Bag
MDT,24M1590530,03/10/2025,Entry,960.0,960.0,0,SWEETCELEBRATION,Bag
MDT,24M1590530,03/10/2025,Entry,96.0,1056.0,0,SWEETCELEBRATION,Bag
MDT,24M1590530,03/10/2025,Entry,864.0,1920.0,0,SWEETCELEBRATION,Bag
MDT,24M1590530,03/10/2025,Sale,-384.0,1536.0,0,SWEETCELEBRATION,Bag
MDT,24M1590530,03/11/2025,Sale,-960.0,576.0,1,SWEETCELEBRATION,Bag
MDT,24M1590530,03/21/2025,Sale,-288.0,288.0,11,SWEETCELEBRATION,Bag
MDT,24M1590530,03/24/2025,Sale,-96.0,192.0,14,SWEETCELEBRATION,Bag
MDT,24M1590530,03/25/2025,Sale,-96.0,96.0,15,SWEETCELEBRATION,Bag
MDT,24M1590530,03/27/2025,Sale,-96.0,0.0,17,SWEETCELEBRATION,Bag
MDT,24M1613300,03/25/2025,Entry,1600.0,1600.0,0,BI-COLOR,Clam
MDT,24M1613300,05/01/2025,Sale,-1600.0,0.0,37,BI-COLOR,Clam
MDT,24M1619510,04/05/2025,Entry,96.0,96.0,0,SWEET GLOBE,Bag
MDT,24M1619510,04/05/2025,Entry,480.0,576.0,0,SWEET GLOBE,Bag
MDT,24M1619510,04/05/2025,Entry,1344.0,1920.0,0,SWEET GLOBE,Bag
MDT,24M1619510,04/14/2025,Sale,-192.0,1728.0,9,SWEET GLOBE,Bag
MDT,24M1619510,04/14/2025,Sale,-96.0,1632.0,9,SWEET GLOBE,Bag
MDT,24M1619510,04/14/2025,Sale,-192.0,1440.0,9,SWEET GLOBE,Bag
MDT,24M1619510,04/16/2025,Sale,-96.0,1344.0,11,SWEET GLOBE,Bag
MDT,24M1619510,04/18/2025,Sale,-464.0,880.0,13,SWEET GLOBE,Bag
MDT,24M1619510,04/23/2025,Sale,-14.0,866.0,18,SWEET GLOBE,Bag
MDT,24M1619510,04/24/2025,Sale,-96.0,770.0,19,SWEET GLOBE,Bag
MDT,24M1619510,04/25/2025,Sale,-384.0,386.0,20,SWEET GLOBE,Bag
MDT,24M1619510,04/26/2025,Sale,-96.0,290.0,21,SWEET GLOBE,Bag
MDT,24M1619510,04/30/2025,Sale,-60.0,230.0,25,SWEET GLOBE,Bag
MDT,24M2506153,02/28/2025,Entry,1536.0,1536.0,0,SWEETIES,Bag
MDT,24M2506153,02/28/2025,Entry,192.0,1728.0,0,SWEETIES,Bag
MDT,24M2506153,02/28/2025,Entry,384.0,2112.0,0,SWEETIES,Bag
MDT,24M2506153,03/12/2025,Sale,-1344.0,768.0,12,SWEETIES,Bag
MDT,24M2506153,03/13/2025,Sale,-192.0,576.0,13,SWEETIES,Bag
MDT,24M2506153,03/13/2025,Sale,-96.0,480.0,13,SWEETIES,Bag
MDT,24M2506153,03/13/2025,Sale,-288.0,192.0,13,SWEETIES,Bag
MDT,24M2506153,04/12/2025,Sale,-96.0,96.0,43,SWEETIES,Bag
MDT,24M2506153,04/15/2025,Sale,-96.0,0.0,46,SWEETIES,Bag
MDT,24M284346,04/23/2025,Entry,1600.0,1600.0,0,SWEET GLOBE,Clam
MDT,24M6081612,03/15/2025,Entry,768.0,768.0,0,SWEET SAPPHIRE,Clam
MDT,24M6081612,03/15/2025,Entry,960.0,1728.0,0,SWEET SAPPHIRE,Clam
MDT,24M6081612,04/08/2025,Sale,-320.0,1408.0,24,SWEET SAPPHIRE,Clam
MDT,24M6081612,04/10/2025,Sale,-96.0,1312.0,26,SWEET SAPPHIRE,Bag
MDT,24M6081612,04/10/2025,Sale,-672.0,640.0,26,SWEET SAPPHIRE,Bag
MDT,24M6081612,04/10/2025,Sale,-80.0,560.0,26,SWEET SAPPHIRE,Clam
MDT,24M6081612,04/11/2025,Sale,-320.0,240.0,27,SWEET SAPPHIRE,Clam
MDT,24M6081612,04/21/2025,Sale,-239.0,1.0,37,SWEET SAPPHIRE,Clam
MDT,24M6322659,04/05/2025,Entry,384.0,384.0,0,SWEET FAVORS,Bag
MDT,24M6322659,04/05/2025,Entry,1536.0,1920.0,0,SWEET FAVORS,Bag
MDT,24M6322659,04/29/2025,Sale,-192.0,1728.0,24,SWEET FAVORS,Bag
MDT,24M6322659,04/30/2025,Sale,-192.0,1536.0,25,SWEET FAVORS,Bag
MDT,24M6322659,04/30/2025,Sale,-1536.0,0.0,25,SWEET FAVORS,Bag
MDT,24M6374884,03/30/2025,Entry,1600.0,1600.0,0,SWEETCELEBRATION,Clam
MDT,24M6374884,05/09/2025,Sale,-1335.0,265.0,40,SWEETCELEBRATION,Clam
MDT,24M6375411,02/28/2025,Entry,1600.0,1600.0,0,BI-COLOR,Clam
MDT,24M6375411,04/07/2025,Sale,-1520.0,80.0,38,BI-COLOR,Clam
MDT,24M6375411,04/08/2025,Sale,-80.0,0.0,39,BI-COLOR,Clam
MDT,24M6698121,04/03/2025,Entry,384.0,384.0,0,SWEET GLOBE,Bag
MDT,24M6698121,04/03/2025,Entry,768.0,1152.0,0,SWEET GLOBE,Bag
MDT,24M6698121,04/03/2025,Entry,768.0,1920.0,0,SWEET GLOBE,Bag
MDT,24M6698121,04/14/2025,Sale,-96.0,1824.0,11,SWEET GLOBE,Bag
MDT,24M6698121,04/15/2025,Sale,-40.0,1784.0,12,SWEET GLOBE,Bag
MDT,24M6698121,04/16/2025,Sale,-480.0,1304.0,13,SWEET GLOBE,Bag
MDT,24M6698121,04/18/2025,Sale,-146.0,1158.0,15,SWEET GLOBE,Bag
MDT,24M6698121,04/22/2025,Sale,-192.0,966.0,19,SWEET GLOBE,Bag
MDT,24M6698121,04/23/2025,Sale,-96.0,870.0,20,SWEET GLOBE,Bag
MDT,24M6698121,04/23/2025,Sale,-299.0,571.0,20,SWEET GLOBE,Bag
MDT,24M6698121,04/24/2025,Sale,-96.0,475.0,21,SWEET GLOBE,Bag
MDT,24M6698121,04/25/2025,Sale,-96.0,379.0,22,SWEET GLOBE,Bag
MDT,24M6698121,04/26/2025,Sale,-192.0,187.0,23,SWEET GLOBE,Bag
MDT,24M6698986,04/03/2025,Entry,96.0,96.0,0,AUTUMN ROYAL,Bag
MDT,24M6698986,04/03/2025,Entry,672.0,768.0,0,AUTUMN ROYAL,Bag
MDT,24M6698986,04/03/2025,Entry,1152.0,1920.0,0,AUTUMN ROYAL,Bag
MDT,24M6698986,04/29/2025,Sale,-96.0,1824.0,26,AUTUMN ROYAL,Bag
MDT,24M6698986,04/29/2025,Sale,-96.0,1728.0,26,AUTUMN ROYAL,Bag
MDT,24M6698986,04/30/2025,Sale,-192.0,1536.0,27,AUTUMN ROYAL,Bag
MDT,24M6698986,05/05/2025,Sale,-96.0,1440.0,32,AUTUMN ROYAL,Bag
MDT,24M6698986,05/05/2025,Sale,-479.0,961.0,32,AUTUMN ROYAL,Bag
MDT,24M6698986,05/05/2025,Sale,-960.0,1.0,32,AUTUMN ROYAL,Bag
MDT,24M6955280,02/25/2025,Entry,340.0,340.0,0,SWEETCELEBRATION,Bag
MDT,24M6955280,02/25/2025,Entry,1056.0,1396.0,0,Unknown Variety,Bag
MDT,24M6955280,02/25/2025,Entry,480.0,1876.0,0,Unknown Variety,Bag
MDT,24M6955280,03/07/2025,Sale,-480.0,1396.0,10,Unknown Variety,Bag
MDT,24M6955280,03/08/2025,Sale,-480.0,916.0,11,Unknown Variety,Bag
MDT,24M6955280,03/10/2025,Sale,-288.0,628.0,13,Unknown Variety,Bag
MDT,24M6955280,03/10/2025,Sale,-288.0,340.0,13,Unknown Variety,Bag
MDT,24M6955280,03/11/2025,Sale,-340.0,0.0,14,SWEETCELEBRATION,Bag
MDT,24M7393565,02/25/2025,Entry,1600.0,1600.0,0,SWEETCELEBRATION,Clam
MDT,24M7393565,03/03/2025,Sale,-160.0,1440.0,6,SWEETCELEBRATION,Clam
MDT,24M7393565,03/13/2025,Sale,-1280.0,160.0,16,SWEETCELEBRATION,Clam
MDT,24M7393565,03/18/2025,Sale,-80.0,80.0,21,SWEETCELEBRATION,Clam
MDT,24M7393565,03/21/2025,Sale,-80.0,0.0,24,SWEETCELEBRATION,Clam
MDT,24M7504047,02/10/2025,Entry,768.0,768.0,0,Unknown Variety,Bag
MDT,24M7504047,02/10/2025,Entry,1536.0,2304.0,0,Unknown Variety,Bag
MDT,24M7504047,02/20/2025,Sale,-480.0,1824.0,10,Unknown Variety,Bag
MDT,24M7504047,02/25/2025,Sale,-960.0,864.0,15,Unknown Variety,Bag
MDT,24M7504047,03/07/2025,Sale,-663.0,201.0,25,Unknown Variety,Bag
MDT,24M7504047,03/07/2025,Sale,-9.0,192.0,25,Unknown Variety,Bag
MDT,24M7504047,03/07/2025,Sale,-96.0,96.0,25,Unknown Variety,Bag
MDT,24M7504047,03/08/2025,Sale,-96.0,0.0,26,Unknown Variety,Bag
MDT,24M8048734,03/10/2025,Entry,1600.0,1600.0,0,BI-COLOR,Clam
MDT,24M8048734,04/29/2025,Sale,-1600.0,0.0,50,BI-COLOR,Clam
MDT,24M8215456,05/15/2025,Entry,1824.0,1824.0,0,CRIMSON,Clam
MDT,24M8215456,05/15/2025,Entry,96.0,1920.0,0,CRIMSON,Clam
MDT,24M8581603,02/25/2025,Entry,1600.0,1600.0,0,SWEETCELEBRATION,Clam
MDT,24M8581603,03/03/2025,Sale,-160.0,1440.0,6,SWEETCELEBRATION,Clam
MDT,24M8581603,03/13/2025,Sale,-640.0,800.0,16,SWEETCELEBRATION,Clam
MDT,24M8581603,03/14/2025,Sale,-80.0,720.0,17,SWEETCELEBRATION,Clam
MDT,24M8581603,03/14/2025,Sale,-160.0,560.0,17,SWEETCELEBRATION,Clam
MDT,24M8581603,03/15/2025,Sale,-160.0,400.0,18,SWEETCELEBRATION,Clam
MDT,24M8581603,03/18/2025,Sale,-80.0,320.0,21,SWEETCELEBRATION,Clam
MDT,24M8581603,03/19/2025,Sale,-75.0,245.0,22,SWEETCELEBRATION,Clam
MDT,24M8581603,03/19/2025,Sale,-5.0,240.0,22,SWEETCELEBRATION,Clam
MDT,24M8581603,03/21/2025,Sale,-80.0,160.0,24,SWEETCELEBRATION,Clam
MDT,24M8581603,03/22/2025,Sale,-80.0,80.0,25,SWEETCELEBRATION,Clam
MDT,24M8581603,03/27/2025,Sale,-80.0,0.0,30,SWEETCELEBRATION,Clam
MDT,24M9177032,03/31/2025,Entry,1600.0,1600.0,0,SWEET GLOBE,Bag
MDT,24M9177109,03/31/2025,Entry,864.0,864.0,0,AUTUMN ROYAL,Bag
MDT,24M9177109,03/31/2025,Entry,576.0,1440.0,0,AUTUMN ROYAL,Bag
MDT,24M9177109,03/31/2025,Entry,480.0,1920.0,0,SWEET FAVORS,Bag
MDT,24M9177109,04/12/2025,Sale,-864.0,1056.0,12,AUTUMN ROYAL,Bag
MDT,24M9177109,04/12/2025,Sale,-576.0,480.0,12,AUTUMN ROYAL,Bag
MDT,24M9177109,04/12/2025,Sale,-480.0,0.0,12,SWEET FAVORS,Bag
MDT,24M9177264,03/15/2025,Entry,1600.0,1600.0,0,SWEET GLOBE,Clam
MDT,24M9177264,03/20/2025,Sale,-640.0,960.0,5,SWEET GLOBE,Clam
MDT,24M9177264,04/04/2025,Sale,-960.0,0.0,20,SWEET GLOBE,Clam
MDT,24M9181259,04/10/2025,Entry,80.0,80.0,0,BI-COLOR,Clam
MDT,24M9181259,04/10/2025,Entry,1280.0,1360.0,0,JACK SALUTE,Clam
MDT,24M9181259,04/10/2025,Entry,240.0,1600.0,0,SWEETCELEBRATION,Clam
MDT,24M9181259,05/02/2025,Sale,-1040.0,560.0,22,JACK SALUTE,Clam
MDT,24M9181259,05/05/2025,Sale,-80.0,480.0,25,BI-COLOR,Clam
MDT,24M9181259,05/10/2025,Sale,-240.0,240.0,30,JACK SALUTE,Clam
MDT,24M9181259,05/10/2025,Sale,-211.0,29.0,30,SWEETCELEBRATION,Clam
MDT,24M9181449,04/10/2025,Entry,1600.0,1600.0,0,JACK SALUTE,Clam
MDT,24M9181449,05/05/2025,Sale,-320.0,1280.0,25,JACK SALUTE,Clam
MDT,24M9181449,05/06/2025,Sale,-1280.0,0.0,26,JACK SALUTE,Clam
MDT,24M9183939,04/03/2025,Entry,1600.0,1600.0,0,SWEET FAVORS,Clam
MDT,24M9183939,04/14/2025,Sale,-1600.0,0.0,11,SWEET FAVORS,Clam
MDT,24M9295291,04/12/2025,Entry,1344.0,1344.0,0,JACK SALUTE,Bag
MDT,24M9295291,04/12/2025,Entry,576.0,1920.0,0,JACK SALUTE,Bag
MDT,24M9295291,04/22/2025,Sale,-384.0,1536.0,10,JACK SALUTE,Bag
MDT,24M9295291,04/23/2025,Sale,-192.0,1344.0,11,JACK SALUTE,Bag
MDT,24M9295291,04/24/2025,Sale,-480.0,864.0,12,JACK SALUTE,Bag
MDT,24M9295291,04/25/2025,Sale,-576.0,288.0,13,JACK SALUTE,Bag
MDT,24M9295291,04/30/2025,Sale,-288.0,0.0,18,JACK SALUTE,Bag
MDT,24M9295919,03/15/2025,Entry,288.0,288.0,0,SWEETCELEBRATION,Bag
MDT,24M9295919,03/15/2025,Entry,480.0,768.0,0,SWEETCELEBRATION,Bag
MDT,24M9295919,03/15/2025,Entry,1152.0,1920.0,0,SWEETCELEBRATION,Bag
MDT,24M9295919,03/22/2025,Sale,-288.0,1632.0,7,SWEETCELEBRATION,Bag
MDT,24M9295919,03/25/2025,Sale,-1152.0,480.0,10,SWEETCELEBRATION,Bag
MDT,24M9295919,03/29/2025,Sale,-480.0,0.0,14,SWEETCELEBRATION,Bag
MDT,24M9296197,03/15/2025,Entry,384.0,384.0,0,SWEETCELEBRATION,Bag
MDT,24M9296197,03/15/2025,Entry,288.0,672.0,0,SWEETCELEBRATION,Bag
MDT,24M9296197,03/15/2025,Entry,1248.0,1920.0,0,SWEETCELEBRATION,Bag
MDT,24M9296197,03/20/2025,Sale,-384.0,1536.0,5,SWEETCELEBRATION,Bag
MDT,24M9296197,03/20/2025,Sale,-96.0,1440.0,5,SWEETCELEBRATION,Bag
MDT,24M9296197,03/20/2025,Sale,-480.0,960.0,5,SWEETCELEBRATION,Bag
MDT,24M9296197,03/24/2025,Sale,-672.0,288.0,9,SWEETCELEBRATION,Bag
MDT,24M9296197,03/25/2025,Sale,-192.0,96.0,10,SWEETCELEBRATION,Bag
MDT,24M9296197,03/25/2025,Sale,-96.0,0.0,10,SWEETCELEBRATION,Bag
MDT,24M9299822,02/28/2025,Entry,1600.0,1600.0,0,Unknown Variety,Clam
MDT,24M9299822,03/17/2025,Sale,-60.0,1540.0,17,Unknown Variety,Clam
MDT,24M9299822,03/17/2025,Sale,-160.0,1380.0,17,Unknown Variety,Clam
MDT,24M9299822,03/17/2025,Sale,-216.0,1164.0,17,Unknown Variety,Clam
MDT,24M9299822,03/17/2025,Sale,-860.0,304.0,17,Unknown Variety,Clam
MDT,24M9299822,03/18/2025,Sale,-60.0,244.0,18,Unknown Variety,Clam
MDT,24M9299822,03/19/2025,Sale,-80.0,164.0,19,Unknown Variety,Clam
MDT,24M9305635,03/10/2025,Entry,1600.0,1600.0,0,Unknown Variety,Clam
MDT,24M9305635,03/17/2025,Sale,-280.0,1320.0,7,Unknown Variety,Clam
MDT,24M9305635,03/17/2025,Sale,-900.0,420.0,7,Unknown Variety,Clam
MDT,24M9305635,03/17/2025,Sale,-160.0,260.0,7,Unknown Variety,Clam
MDT,24M9305635,03/17/2025,Sale,-80.0,180.0,7,Unknown Variety,Clam
MDT,24M9305635,03/18/2025,Sale,-120.0,60.0,8,Unknown Variety,Clam
MDT,24M9307075,04/30/2025,Entry,1056.0,1056.0,0,CRIMSON,Bag
MDT,24M9307075,04/30/2025,Entry,160.0,1216.0,0,CRIMSON,Bag
MDT,24M9307075,04/30/2025,Entry,320.0,1536.0,0,JACK SALUTE,Bag
MDT,24M9307075,04/30/2025,Entry,240.0,1776.0,0,SWEETCELEBRATION,Bag
MDT,24M9307075,05/07/2025,Sale,-384.0,1392.0,7,CRIMSON,Bag
MDT,24M9307075,05/08/2025,Sale,-576.0,816.0,8,CRIMSON,Bag
MDT,24M9307075,05/08/2025,Sale,-96.0,720.0,8,CRIMSON,Bag
MDT,24M9307075,05/14/2025,Sale,-80.0,640.0,14,CRIMSON,Clam
MDT,24M9307075,05/14/2025,Sale,-320.0,320.0,14,JACK SALUTE,Clam
MDT,24M9307075,05/14/2025,Sale,-177.0,143.0,14,SWEETCELEBRATION,Clam
MDT,24M9307809,02/28/2025,Entry,1600.0,1600.0,0,SWEETCELEBRATION,Clam
MDT,24M9307809,03/07/2025,Sale,-80.0,1520.0,7,SWEETCELEBRATION,Clam
MDT,24M9307809,03/14/2025,Sale,-160.0,1360.0,14,SWEETCELEBRATION,Clam
MDT,24M9307809,03/18/2025,Sale,-240.0,1120.0,18,SWEETCELEBRATION,Clam
MDT,24M9307809,03/19/2025,Sale,-1120.0,0.0,19,SWEETCELEBRATION,Clam
MDT,24M9308699,03/30/2025,Entry,400.0,400.0,0,JACK SALUTE,Clam
MDT,24M9308699,03/30/2025,Entry,1200.0,1600.0,0,SWEETCELEBRATION,Clam
MDT,24M9308699,04/15/2025,Sale,-400.0,1200.0,16,JACK SALUTE,Clam
MDT,24M9308699,04/29/2025,Sale,-80.0,1120.0,30,SWEETCELEBRATION,Clam
MDT,24M9308699,05/09/2025,Sale,-585.0,535.0,40,SWEETCELEBRATION,Clam
MDT,24M9308699,05/10/2025,Sale,-334.0,201.0,41,SWEETCELEBRATION,Clam
MDT,24M9336596,03/10/2025,Entry,1600.0,1600.0,0,SWEETCELEBRATION,Clam
MDT,24M9336596,03/14/2025,Sale,-240.0,1360.0,4,SWEETCELEBRATION,Clam
MDT,24M9336596,03/17/2025,Sale,-1360.0,0.0,7,SWEETCELEBRATION,Clam
MDT,24M9338135,03/10/2025,Entry,1600.0,1600.0,0,SWEETCELEBRATION,Clam
MDT,24M9338135,03/14/2025,Sale,-160.0,1440.0,4,SWEETCELEBRATION,Clam
MDT,24M9338135,03/18/2025,Sale,-1280.0,160.0,8,SWEETCELEBRATION,Clam
MDT,24M9338135,03/19/2025,Sale,-160.0,0.0,9,SWEETCELEBRATION,Clam
MDT,24M9338480,03/25/2025,Entry,1595.0,1595.0,0,Unknown Variety,Clam
MDT,24M9338480,04/29/2025,Sale,-800.0,795.0,35,Unknown Variety,Clam
MDT,24M9338480,05/11/2025,Sale,-69.0,726.0,47,Unknown Variety,Clam
MDT,24M9345350,04/12/2025,Entry,2160.0,2160.0,0,RED GLOBE,Bag
MDT,24M9345350,04/22/2025,Sale,-1944.0,216.0,10,RED GLOBE,Bag
MDT,24M9345350,04/23/2025,Sale,-108.0,108.0,11,RED GLOBE,Bag
MDT,24M9345350,04/30/2025,Sale,-108.0,0.0,18,RED GLOBE,Bag
MDT,24M9349910,03/03/2025,Entry,1600.0,1600.0,0,SWEETCELEBRATION,Clam
MDT,24M9349910,03/14/2025,Sale,-960.0,640.0,11,SWEETCELEBRATION,Clam
MDT,24M9349910,03/19/2025,Sale,-400.0,240.0,16,SWEETCELEBRATION,Clam
MDT,24M9349910,03/22/2025,Sale,-80.0,160.0,19,SWEETCELEBRATION,Clam
MDT,24M9349910,03/24/2025,Sale,-80.0,80.0,21,SWEETCELEBRATION,Clam
MDT,24M9349910,03/26/2025,Sale,-80.0,0.0,23,SWEETCELEBRATION,Clam
MDT,24M9350383,03/15/2025,Entry,1600.0,1600.0,0,BI-COLOR,Clam
MDT,24M9350383,04/07/2025,Sale,-80.0,1520.0,23,BI-COLOR,Clam
MDT,24M9350383,04/08/2025,Sale,-212.0,1308.0,24,BI-COLOR,Clam
MDT,24M9350383,04/08/2025,Sale,-1308.0,0.0,24,BI-COLOR,Clam
MDT,24M9352940,04/05/2025,Entry,480.0,480.0,0,SWEET GLOBE,Bag
MDT,24M9352940,04/05/2025,Entry,96.0,576.0,0,SWEET GLOBE,Bag
MDT,24M9352940,04/05/2025,Entry,1344.0,1920.0,0,SWEET GLOBE,Bag
MDT,24M9352940,04/14/2025,Sale,-576.0,1344.0,9,SWEET GLOBE,Bag
MDT,24M9352940,04/14/2025,Sale,-96.0,1248.0,9,SWEET GLOBE,Bag
MDT,24M9352940,04/16/2025,Sale,-192.0,1056.0,11,SWEET GLOBE,Bag
MDT,24M9352940,04/18/2025,Sale,-142.0,914.0,13,SWEET GLOBE,Bag
MDT,24M9352940,04/23/2025,Sale,-96.0,818.0,18,SWEET GLOBE,Bag
MDT,24M9352940,04/24/2025,Sale,-192.0,626.0,19,SWEET GLOBE,Bag
MDT,24M9352940,04/26/2025,Sale,-96.0,530.0,21,SWEET GLOBE,Bag
MDT,24M9352940,04/28/2025,Sale,-96.0,434.0,23,SWEET GLOBE,Bag
MDT,24M9352940,05/05/2025,Sale,-96.0,338.0,30,SWEET GLOBE,Bag
MDT,24M9352940,05/06/2025,Sale,-96.0,242.0,31,SWEET GLOBE,Bag
MDT,24M9352940,05/09/2025,Sale,-96.0,146.0,34,SWEET GLOBE,Bag
MDT,24M9352940,05/09/2025,Sale,-13.0,133.0,34,SWEET GLOBE,Bag
MDT,24M9507249,03/05/2025,Entry,1152.0,1152.0,0,Unknown Variety,Bag
MDT,24M9507249,03/05/2025,Entry,768.0,1920.0,0,Unknown Variety,Bag
MDT,24M9507249,03/10/2025,Sale,-672.0,1248.0,5,Unknown Variety,Bag
MDT,24M9507249,03/14/2025,Sale,-480.0,768.0,9,Unknown Variety,Bag
MDT,24M9507249,03/17/2025,Sale,-192.0,576.0,12,Unknown Variety,Bag
MDT,24M9507249,03/18/2025,Sale,-480.0,96.0,13,Unknown Variety,Bag
MDT,24M9511131,03/24/2025,Entry,1920.0,1920.0,0,SWEETCELEBRATION,Bag
MDT,24M9511131,04/01/2025,Sale,-1824.0,96.0,8,SWEETCELEBRATION,Bag
MDT,24M9623989,03/10/2025,Entry,1600.0,1600.0,0,Unknown Variety,Clam
MDT,24M9623989,03/17/2025,Sale,-372.0,1228.0,7,Unknown Variety,Clam
MDT,24M9623989,03/17/2025,Sale,-60.0,1168.0,7,Unknown Variety,Clam
MDT,24M9623989,03/17/2025,Sale,-779.0,389.0,7,Unknown Variety,Clam
MDT,24M9623989,03/17/2025,Sale,-200.0,189.0,7,Unknown Variety,Clam
MDT,24M9623989,03/18/2025,Sale,-20.0,169.0,8,Unknown Variety,Clam
MDT,24M9627475,02/28/2025,Entry,1600.0,1600.0,0,Unknown Variety,Clam
MDT,24M9627475,03/17/2025,Sale,-708.0,892.0,17,Unknown Variety,Clam
MDT,24M9627475,03/17/2025,Sale,-80.0,812.0,17,Unknown Variety,Clam
MDT,24M9627475,03/17/2025,Sale,-292.0,520.0,17,Unknown Variety,Clam
MDT,24M9627475,03/17/2025,Sale,-20.0,500.0,17,Unknown Variety,Clam
MDT,24M9627475,03/18/2025,Sale,-20.0,480.0,18,Unknown Variety,Clam
MDT,24M9627475,03/18/2025,Sale,-146.0,334.0,18,Unknown Variety,Clam
MDT,24M9628569,03/07/2025,Sale,-1056.0,-1056.0,0,Unknown Variety,Bag
MDT,24M9628569,03/07/2025,Sale,-96.0,-1152.0,0,Unknown Variety,Bag
MDT,24M9628569,03/08/2025,Sale,-288.0,-1440.0,1,Unknown Variety,Bag
MDT,24M9628569,03/10/2025,Entry,288.0,-1152.0,3,Unknown Variety,Bag
MDT,24M9628569,03/10/2025,Entry,1632.0,480.0,3,Unknown Variety,Bag
MDT,24M9628569,03/10/2025,Sale,-480.0,0.0,3,Unknown Variety,Bag
MDT,24M9630416,03/30/2025,Entry,1600.0,1600.0,0,BI-COLOR,Clam
MDT,24M9630416,05/01/2025,Sale,-1600.0,0.0,32,BI-COLOR,Clam
MDT,24M9654909,03/07/2025,Sale,-384.0,-384.0,0,Unknown Variety,Bag
MDT,24M9654909,03/07/2025,Sale,-288.0,-672.0,0,Unknown Variety,Bag
MDT,24M9654909,03/10/2025,Entry,1152.0,480.0,3,Unknown Variety,Bag
MDT,24M9654909,03/10/2025,Entry,768.0,1248.0,3,Unknown Variety,Bag
MDT,24M9654909,03/10/2025,Sale,-96.0,1152.0,3,Unknown Variety,Bag
MDT,24M9654909,03/17/2025,Sale,-768.0,384.0,10,Unknown Variety,Bag
MDT,24M9654909,03/25/2025,Sale,-192.0,192.0,18,Unknown Variety,Bag
MDT,24M9655757,03/03/2025,Entry,1600.0,1600.0,0,Unknown Variety,Clam
MDT,24M9655757,03/17/2025,Sale,-320.0,1280.0,14,Unknown Variety,Clam
MDT,24M9655757,03/18/2025,Sale,-160.0,1120.0,15,Unknown Variety,Clam
MDT,24M9655757,03/18/2025,Sale,-60.0,1060.0,15,Unknown Variety,Clam
MDT,24M9655757,03/18/2025,Sale,-760.0,300.0,15,Unknown Variety,Clam
MDT,24M9655757,03/19/2025,Sale,-80.0,220.0,16,Unknown Variety,Clam
MDT,24M9655757,04/15/2025,Sale,-3.0,217.0,43,Unknown Variety,Bag
MDT,24M9667499,04/03/2025,Entry,384.0,384.0,0,SWEET FAVORS,Bag
MDT,24M9667499,04/03/2025,Entry,1536.0,1920.0,0,SWEET FAVORS,Bag
MDT,24M9667499,04/17/2025,Sale,-288.0,1632.0,14,SWEET FAVORS,Bag
MDT,24M9667499,04/24/2025,Sale,-96.0,1536.0,21,SWEET FAVORS,Bag
MDT,24M9667499,04/24/2025,Sale,-96.0,1440.0,21,SWEET FAVORS,Bag
MDT,24M9667499,04/25/2025,Sale,-192.0,1248.0,22,SWEET FAVORS,Bag
MDT,24M9667499,04/25/2025,Sale,-96.0,1152.0,22,SWEET FAVORS,Bag
MDT,24M9667499,04/28/2025,Sale,-192.0,960.0,25,SWEET FAVORS,Bag
MDT,24M9667499,04/29/2025,Sale,-192.0,768.0,26,SWEET FAVORS,Bag
MDT,24M9667499,04/30/2025,Sale,-192.0,576.0,27,SWEET FAVORS,Bag
MDT,24M9667499,04/30/2025,Sale,-480.0,96.0,27,SWEET FAVORS,Bag
MDT,24M9667499,05/05/2025,Sale,-96.0,0.0,32,SWEET FAVORS,Bag
MDT,24M9695084,02/28/2025,Entry,1600.0,1600.0,0,Unknown Variety,Clam
MDT,24M9695084,03/17/2025,Sale,-320.0,1280.0,17,Unknown Variety,Clam
MDT,24M9695084,03/17/2025,Sale,-400.0,880.0,17,Unknown Variety,Clam
MDT,24M9695084,03/17/2025,Sale,-200.0,680.0,17,Unknown Variety,Clam
MDT,24M9695084,03/17/2025,Sale,-140.0,540.0,17,Unknown Variety,Clam
MDT,24M9695084,03/18/2025,Sale,-380.0,160.0,18,Unknown Variety,Clam
MDT,24M9695680,04/10/2025,Entry,1600.0,1600.0,0,SWEETCELEBRATION,Clam
MDT,24M9695680,04/29/2025,Sale,-1600.0,0.0,19,SWEETCELEBRATION,Clam
MDT,24M9696115,04/12/2025,Entry,96.0,96.0,0,SWEET GLOBE,Bag
MDT,24M9696115,04/12/2025,Entry,480.0,576.0,0,SWEET GLOBE,Bag
MDT,24M9696115,04/12/2025,Entry,1344.0,1920.0,0,SWEET GLOBE,Bag
MDT,24M9696115,04/23/2025,Sale,-288.0,1632.0,11,SWEET GLOBE,Bag
MDT,24M9696115,04/24/2025,Sale,-96.0,1536.0,12,SWEET GLOBE,Bag
MDT,24M9696115,04/25/2025,Sale,-96.0,1440.0,13,SWEET GLOBE,Bag
MDT,24M9696115,04/26/2025,Sale,-96.0,1344.0,14,SWEET GLOBE,Bag
MDT,24M9696115,04/26/2025,Sale,-768.0,576.0,14,SWEET GLOBE,Bag
MDT,24M9696115,04/28/2025,Sale,-96.0,480.0,16,SWEET GLOBE,Bag
MDT,24M9696115,04/30/2025,Sale,-96.0,384.0,18,SWEET GLOBE,Bag
MDT,24M9696115,05/09/2025,Sale,-96.0,288.0,27,SWEET GLOBE,Bag
MDT,24M9696202,04/05/2025,Entry,192.0,192.0,0,SWEET GLOBE,Bag
MDT,24M9696202,04/05/2025,Entry,576.0,768.0,0,SWEET GLOBE,Bag
MDT,24M9696202,04/05/2025,Entry,1152.0,1920.0,0,SWEET GLOBE,Bag
MDT,24M9696202,04/14/2025,Sale,-96.0,1824.0,9,SWEET GLOBE,Bag
MDT,24M9696202,04/14/2025,Sale,-192.0,1632.0,9,SWEET GLOBE,Bag
MDT,24M9696202,04/14/2025,Sale,-96.0,1536.0,9,SWEET GLOBE,Bag
MDT,24M9696202,04/17/2025,Sale,-192.0,1344.0,12,SWEET GLOBE,Bag
MDT,24M9696202,04/18/2025,Sale,-96.0,1248.0,13,SWEET GLOBE,Bag
MDT,24M9696202,04/18/2025,Sale,-112.0,1136.0,13,SWEET GLOBE,Bag
MDT,24M9696202,04/21/2025,Sale,-96.0,1040.0,16,SWEET GLOBE,Bag
MDT,24M9696202,04/23/2025,Sale,-192.0,848.0,18,SWEET GLOBE,Bag
MDT,24M9696202,04/23/2025,Sale,-192.0,656.0,18,SWEET GLOBE,Bag
MDT,24M9696202,04/23/2025,Sale,-71.0,585.0,18,SWEET GLOBE,Bag
MDT,24M9696202,04/26/2025,Sale,-96.0,489.0,21,SWEET GLOBE,Bag
MDT,24M9696202,04/28/2025,Sale,-192.0,297.0,23,SWEET GLOBE,Bag
MDT,24M9696202,04/30/2025,Sale,-36.0,261.0,25,SWEET GLOBE,Bag
MDT,24M9696202,05/03/2025,Sale,-96.0,165.0,28,SWEET GLOBE,Bag
MDT,24M9696202,05/08/2025,Sale,-96.0,69.0,33,SWEET GLOBE,Bag
MDT,24M9698653,03/15/2025,Entry,1600.0,1600.0,0,Unknown Variety,Clam
MDT,24M9698653,04/15/2025,Sale,-240.0,1360.0,31,Unknown Variety,Clam
MDT,24M9698653,04/16/2025,Sale,-480.0,880.0,32,Unknown Variety,Clam
MDT,24M9698653,05/03/2025,Sale,-11.0,869.0,49,Unknown Variety,Clam
MDT,24M9698653,05/11/2025,Sale,-560.0,309.0,57,Unknown Variety,Clam
MDT,24M9699500,03/15/2025,Entry,1600.0,1600.0,0,SWEETCELEBRATION,Clam
MDT,24M9699500,05/10/2025,Sale,-800.0,800.0,56,SWEETCELEBRATION,Clam
MDT,24M9699500,05/10/2025,Sale,-95.0,705.0,56,SWEETCELEBRATION,Clam
MDT,24M9699500,05/14/2025,Sale,-543.0,162.0,60,SWEETCELEBRATION,Clam
MDT,24M9723205,02/28/2025,Entry,1600.0,1600.0,0,Unknown Variety,Clam
MDT,24M9723205,03/14/2025,Sale,-80.0,1520.0,14,Unknown Variety,Clam
MDT,24M9723205,03/17/2025,Sale,-180.0,1340.0,17,Unknown Variety,Clam
MDT,24M9723205,03/17/2025,Sale,-273.0,1067.0,17,Unknown Variety,Clam
MDT,24M9723205,03/17/2025,Sale,-620.0,447.0,17,Unknown Variety,Clam
MDT,24M9723205,03/18/2025,Sale,-194.0,253.0,18,Unknown Variety,Clam
MDT,24M9740100,04/10/2025,Entry,1600.0,1600.0,0,BI-COLOR,Clam
MDT,24M9740100,05/05/2025,Sale,-1600.0,0.0,25,BI-COLOR,Clam
MDT,24M9741003,04/10/2025,Entry,1600.0,1600.0,0,JACK SALUTE,Clam
MDT,24M9741003,05/05/2025,Sale,-1600.0,0.0,25,JACK SALUTE,Clam
MDT,24M9832431,04/03/2025,Entry,960.0,960.0,0,SWEET GLOBE,Bag
MDT,24M9832431,04/03/2025,Entry,960.0,1920.0,0,SWEET GLOBE,Bag
MDT,24M9832431,04/15/2025,Sale,-480.0,1440.0,12,SWEET GLOBE,Bag
MDT,24M9832431,04/16/2025,Sale,-192.0,1248.0,13,SWEET GLOBE,Bag
MDT,24M9832431,04/16/2025,Sale,-192.0,1056.0,13,SWEET GLOBE,Bag
MDT,24M9832431,04/22/2025,Sale,-192.0,864.0,19,SWEET GLOBE,Bag
MDT,24M9832431,04/26/2025,Sale,-96.0,768.0,23,SWEET GLOBE,Bag
MDT,24M9832431,05/05/2025,Sale,-192.0,576.0,32,SWEET GLOBE,Bag
MDT,24M9832431,05/09/2025,Sale,-96.0,480.0,36,SWEET GLOBE,Bag
MDT,24M9832431,05/09/2025,Sale,-121.0,359.0,36,SWEET GLOBE,Bag
MDT,24M9832431,05/09/2025,Sale,-58.0,301.0,36,SWEET GLOBE,Bag
MDT,24M9861879,03/15/2025,Entry,1600.0,1600.0,0,Unknown Variety,Clam
MDT,24M9861879,03/28/2025,Sale,-1600.0,0.0,13,Unknown Variety,Clam
MDT,24M9861890,02/28/2025,Entry,1600.0,1600.0,0,SWEETCELEBRATION,Clam
MDT,24M9861890,03/14/2025,Sale,-400.0,1200.0,14,SWEETCELEBRATION,Clam
MDT,24M9861890,03/17/2025,Sale,-560.0,640.0,17,SWEETCELEBRATION,Clam
MDT,24M9861890,03/18/2025,Sale,-400.0,240.0,18,SWEETCELEBRATION,Clam
MDT,24M9861890,03/19/2025,Sale,-240.0,0.0,19,SWEETCELEBRATION,Clam
MDT,24M9869381,03/15/2025,Entry,1600.0,1600.0,0,JACK SALUTE,Clam
MDT,24M9869381,03/26/2025,Sale,-160.0,1440.0,11,JACK SALUTE,Clam
MDT,24M9869381,03/27/2025,Sale,-400.0,1040.0,12,JACK SALUTE,Clam
MDT,24M9869381,03/28/2025,Sale,-240.0,800.0,13,JACK SALUTE,Clam
MDT,24M9869381,03/31/2025,Sale,-400.0,400.0,16,JACK SALUTE,Clam
MDT,24M9869381,04/01/2025,Sale,-395.0,5.0,17,JACK SALUTE,Clam
MDT,24M9869381,05/03/2025,Sale,-5.0,0.0,49,JACK SALUTE,Clam
Quintay,24Q1022587,03/30/2025,Entry,1600.0,1600.0,0,Unknown Variety,Clam
Quintay,24Q1022587,04/23/2025,Sale,-400.0,1200.0,24,Unknown Variety,Clam
Quintay,24Q1022587,04/26/2025,Sale,-320.0,880.0,27,Unknown Variety,Clam
Quintay,24Q1022587,04/28/2025,Sale,-52.0,828.0,29,Unknown Variety,Clam
Quintay,24Q1022587,04/30/2025,Sale,-160.0,668.0,31,Unknown Variety,Clam
Quintay,24Q1022587,05/02/2025,Sale,-80.0,588.0,33,Unknown Variety,Clam
Quintay,24Q1022587,05/09/2025,Sale,-80.0,508.0,40,Unknown Variety,Clam
Quintay,24Q1022587,05/10/2025,Sale,-80.0,428.0,41,Unknown Variety,Clam
Quintay,24Q1022587,05/10/2025,Sale,-80.0,348.0,41,Unknown Variety,Clam
Quintay,24Q1028040,04/04/2025,Entry,1600.0,1600.0,0,Unknown Variety,Bag
Quintay,24Q1028040,04/30/2025,Sale,-880.0,720.0,26,Unknown Variety,Bag
Quintay,24Q1028040,05/01/2025,Sale,-320.0,400.0,27,Unknown Variety,Bag
Quintay,24Q1425427,04/04/2025,Entry,1235.0,1235.0,0,Unknown Variety,Bag
Quintay,24Q1425427,04/04/2025,Entry,650.0,1885.0,0,Unknown Variety,Bag
Quintay,24Q1425427,04/14/2025,Sale,-570.0,1315.0,10,Unknown Variety,Bag
Quintay,24Q1425427,04/17/2025,Sale,-40.0,1275.0,13,Unknown Variety,Bag
Quintay,24Q1425427,04/18/2025,Sale,-475.0,800.0,14,Unknown Variety,Bag
Quintay,24Q1425427,04/28/2025,Sale,-95.0,705.0,24,Unknown Variety,Bag
Quintay,24Q1425427,04/28/2025,Sale,-20.0,685.0,24,Unknown Variety,Bag
Quintay,24Q1425427,04/29/2025,Sale,-97.0,588.0,25,Unknown Variety,Bag
Quintay,24Q1425427,04/29/2025,Sale,-190.0,398.0,25,Unknown Variety,Bag
Quintay,24Q1425427,05/09/2025,Sale,-180.0,218.0,35,Unknown Variety,Bag
Quintay,24Q1483491,04/03/2025,Entry,80.0,80.0,0,Unknown Variety,Bag
Quintay,24Q1483491,04/03/2025,Entry,1080.0,1160.0,0,Unknown Variety,Bag
Quintay,24Q1483491,04/03/2025,Entry,560.0,1720.0,0,Unknown Variety,Bag
Quintay,24Q1483491,04/15/2025,Sale,-180.0,1540.0,12,Unknown Variety,Bag
Quintay,24Q1483491,04/15/2025,Sale,-633.0,907.0,12,Unknown Variety,Bag
Quintay,24Q1483491,04/17/2025,Sale,-60.0,847.0,14,Unknown Variety,Bag
Quintay,24Q1483491,04/30/2025,Sale,-80.0,767.0,27,Unknown Variety,Clam
Quintay,24Q1483491,05/01/2025,Sale,-80.0,687.0,28,Unknown Variety,Bag
Quintay,24Q1483491,05/02/2025,Sale,-160.0,527.0,29,Unknown Variety,Clam
Quintay,24Q1483491,05/07/2025,Sale,-10.0,517.0,34,Unknown Variety,Bag
Quintay,24Q1483491,05/09/2025,Sale,-160.0,357.0,36,Unknown Variety,Clam
Quintay,24Q1580090,04/10/2025,Entry,1600.0,1600.0,0,Unknown Variety,Clam
Quintay,24Q1580090,04/29/2025,Sale,-560.0,1040.0,19,Unknown Variety,Clam
Quintay,24Q1580090,04/30/2025,Sale,-480.0,560.0,20,Unknown Variety,Clam
Quintay,24Q1580090,05/09/2025,Sale,-40.0,520.0,29,Unknown Variety,Clam
Quintay,24Q1580090,05/10/2025,Sale,-80.0,440.0,30,Unknown Variety,Clam
Quintay,24Q1581353,04/20/2025,Entry,1600.0,1600.0,0,Unknown Variety,Clam
Quintay,24Q1581353,05/04/2025,Sale,-588.0,1012.0,14,Unknown Variety,Clam
Quintay,24Q1581353,05/07/2025,Sale,-320.0,692.0,17,Unknown Variety,Clam
Quintay,24Q1581353,05/11/2025,Sale,-27.0,665.0,21,Unknown Variety,Clam
Quintay,24Q1590484,04/10/2025,Entry,1600.0,1600.0,0,Unknown Variety,Clam
Quintay,24Q1590484,04/29/2025,Sale,-1038.0,562.0,19,Unknown Variety,Clam
Quintay,24Q1590484,04/30/2025,Sale,-240.0,322.0,20,Unknown Variety,Clam
Quintay,24Q1612217,03/23/2025,Entry,1944.0,1944.0,0,Unknown Variety,Bag
Quintay,24Q1612217,03/23/2025,Entry,216.0,2160.0,0,Unknown Variety,Bag
Quintay,24Q1612217,03/31/2025,Sale,-972.0,1188.0,8,Unknown Variety,Bag
Quintay,24Q1612217,04/03/2025,Sale,-324.0,864.0,11,Unknown Variety,Bag
Quintay,24Q1612217,04/04/2025,Sale,-216.0,648.0,12,Unknown Variety,Bag
Quintay,24Q1612217,04/07/2025,Sale,-108.0,540.0,15,Unknown Variety,Bag
Quintay,24Q1612217,04/08/2025,Sale,-108.0,432.0,16,Unknown Variety,Bag
Quintay,24Q1612217,04/08/2025,Sale,-108.0,324.0,16,Unknown Variety,Bag
Quintay,24Q1612217,04/08/2025,Sale,-108.0,216.0,16,Unknown Variety,Bag
Quintay,24Q1612217,04/11/2025,Sale,-108.0,108.0,19,Unknown Variety,Bag
Quintay,24Q1612217,04/12/2025,Sale,-108.0,0.0,20,Unknown Variety,Bag
Quintay,24Q1613002,04/03/2025,Entry,80.0,80.0,0,Unknown Variety,Bag
Quintay,24Q1613002,04/03/2025,Entry,1520.0,1600.0,0,Unknown Variety,Bag
Quintay,24Q1613002,04/10/2025,Sale,-1040.0,560.0,7,Unknown Variety,Bag
Quintay,24Q1613002,04/15/2025,Sale,-320.0,240.0,12,Unknown Variety,Bag
Quintay,24Q1613002,04/23/2025,Sale,-31.0,209.0,20,Unknown Variety,Bag
Quintay,24Q1613002,05/01/2025,Sale,-18.0,191.0,28,Unknown Variety,Bag
Quintay,24Q3514146,04/24/2025,Entry,3440.0,3440.0,0,Unknown Variety,Bag
Quintay,24Q3514146,04/24/2025,Entry,80.0,3520.0,0,Unknown Variety,Bag
Quintay,24Q3514146,05/13/2025,Sale,-160.0,3360.0,19,Unknown Variety,Bag
Quintay,24Q5343659,04/02/2025,Entry,558.0,558.0,0,Unknown Variety,Bag
Quintay,24Q5343659,04/02/2025,Entry,108.0,666.0,0,Unknown Variety,Bag
Quintay,24Q5343659,04/02/2025,Entry,1404.0,2070.0,0,Unknown Variety,Bag
Quintay,24Q5343659,04/11/2025,Sale,-540.0,1530.0,9,Unknown Variety,Bag
Quintay,24Q5343659,04/11/2025,Sale,-235.0,1295.0,9,Unknown Variety,Bag
Quintay,24Q5343659,04/12/2025,Sale,-108.0,1187.0,10,Unknown Variety,Bag
Quintay,24Q5343659,04/15/2025,Sale,-180.0,1007.0,13,Unknown Variety,Bag
Quintay,24Q5343659,04/15/2025,Sale,-432.0,575.0,13,Unknown Variety,Bag
Quintay,24Q5343659,04/16/2025,Sale,-108.0,467.0,14,Unknown Variety,Bag
Quintay,24Q5343659,04/16/2025,Sale,-108.0,359.0,14,Unknown Variety,Bag
Quintay,24Q5343659,04/17/2025,Sale,-180.0,179.0,15,Unknown Variety,Bag
Quintay,24Q5343659,04/21/2025,Sale,-90.0,89.0,19,Unknown Variety,Bag
Quintay,24Q5343659,04/21/2025,Sale,-89.0,0.0,19,Unknown Variety,Bag
Quintay,24Q5515115,04/25/2025,Entry,400.0,400.0,0,Unknown Variety,Bag
Quintay,24Q5515115,04/25/2025,Entry,1360.0,1760.0,0,Unknown Variety,Bag
Quintay,24Q5515115,05/08/2025,Sale,-630.0,1130.0,13,Unknown Variety,Bag
Quintay,24Q5515115,05/09/2025,Sale,-180.0,950.0,14,Unknown Variety,Bag
Quintay,24Q5515115,05/09/2025,Sale,-151.0,799.0,14,Unknown Variety,Bag
Quintay,24Q5515115,05/09/2025,Sale,-540.0,259.0,14,Unknown Variety,Bag
Quintay,24Q5582457,03/07/2025,Entry,1800.0,1800.0,0,Unknown Variety,Bag
Quintay,24Q5582457,03/14/2025,Sale,-1260.0,540.0,7,Unknown Variety,Bag
Quintay,24Q5582457,03/21/2025,Sale,-360.0,180.0,14,Unknown Variety,Bag
Quintay,24Q5582457,03/21/2025,Sale,-90.0,90.0,14,Unknown Variety,Bag
Quintay,24Q5582457,03/24/2025,Sale,-90.0,0.0,17,Unknown Variety,Bag
Quintay,24Q6081741,04/03/2025,Entry,1600.0,1600.0,0,Unknown Variety,Bag
Quintay,24Q6081741,04/12/2025,Sale,-340.0,1260.0,9,Unknown Variety,Bag
Quintay,24Q6081741,04/14/2025,Sale,-560.0,700.0,11,Unknown Variety,Bag
Quintay,24Q6081741,04/16/2025,Sale,-160.0,540.0,13,Unknown Variety,Bag
Quintay,24Q6081741,04/17/2025,Sale,-340.0,200.0,14,Unknown Variety,Bag
Quintay,24Q6081741,05/07/2025,Sale,-21.0,179.0,34,Unknown Variety,Bag
Quintay,24Q6081762,04/03/2025,Entry,1600.0,1600.0,0,Unknown Variety,Bag
Quintay,24Q6081762,04/12/2025,Sale,-540.0,1060.0,9,Unknown Variety,Bag
Quintay,24Q6081762,04/14/2025,Sale,-400.0,660.0,11,Unknown Variety,Bag
Quintay,24Q6081762,04/16/2025,Sale,-160.0,500.0,13,Unknown Variety,Bag
Quintay,24Q6081762,04/17/2025,Sale,-160.0,340.0,14,Unknown Variety,Bag
Quintay,24Q6081762,05/07/2025,Sale,-27.0,313.0,34,Unknown Variety,Bag
Quintay,24Q6085182,04/10/2025,Entry,1600.0,1600.0,0,Unknown Variety,Clam
Quintay,24Q6085182,04/28/2025,Sale,-436.0,1164.0,18,Unknown Variety,Clam
Quintay,24Q6085182,04/29/2025,Sale,-160.0,1004.0,19,Unknown Variety,Clam
Quintay,24Q6085182,04/30/2025,Sale,-560.0,444.0,20,Unknown Variety,Clam
Quintay,24Q6085182,05/02/2025,Sale,-83.0,361.0,22,Unknown Variety,Clam
Quintay,24Q6085330,04/10/2025,Entry,1600.0,1600.0,0,Unknown Variety,Clam
Quintay,24Q6114017,04/04/2025,Entry,1600.0,1600.0,0,Unknown Variety,Clam
Quintay,24Q6114017,04/23/2025,Sale,-160.0,1440.0,19,Unknown Variety,Clam
Quintay,24Q6114017,04/26/2025,Sale,-240.0,1200.0,22,Unknown Variety,Clam
Quintay,24Q6114017,04/28/2025,Sale,-22.0,1178.0,24,Unknown Variety,Clam
Quintay,24Q6114017,04/28/2025,Sale,-15.0,1163.0,24,Unknown Variety,Clam
Quintay,24Q6114017,04/30/2025,Sale,-160.0,1003.0,26,Unknown Variety,Clam
Quintay,24Q6114017,05/02/2025,Sale,-219.0,784.0,28,Unknown Variety,Clam
Quintay,24Q6114017,05/09/2025,Sale,-80.0,704.0,35,Unknown Variety,Clam
Quintay,24Q6114017,05/10/2025,Sale,-80.0,624.0,36,Unknown Variety,Clam
Quintay,24Q6320297,04/03/2025,Entry,640.0,640.0,0,Unknown Variety,Bag
Quintay,24Q6320297,04/03/2025,Entry,960.0,1600.0,0,Unknown Variety,Bag
Quintay,24Q6320297,04/18/2025,Sale,-320.0,1280.0,15,Unknown Variety,Bag
Quintay,24Q6320297,04/23/2025,Sale,-160.0,1120.0,20,Unknown Variety,Bag
Quintay,24Q6320297,04/28/2025,Sale,-320.0,800.0,25,Unknown Variety,Bag
Quintay,24Q6320297,05/01/2025,Sale,-160.0,640.0,28,Unknown Variety,Bag
Quintay,24Q6320297,05/09/2025,Sale,-80.0,560.0,36,Unknown Variety,Bag
Quintay,24Q6320297,05/10/2025,Sale,-80.0,480.0,37,Unknown Variety,Bag
Quintay,24Q6320297,05/13/2025,Sale,-80.0,400.0,40,Unknown Variety,Bag
Quintay,24Q6320297,05/13/2025,Sale,-160.0,240.0,40,Unknown Variety,Bag
Quintay,24Q6320722,04/20/2025,Entry,1600.0,1600.0,0,Unknown Variety,Clam
Quintay,24Q6320722,05/07/2025,Sale,-800.0,800.0,17,Unknown Variety,Clam
Quintay,24Q6320722,05/11/2025,Sale,-30.0,770.0,21,Unknown Variety,Clam
Quintay,24Q6320785,03/15/2025,Entry,2160.0,2160.0,0,Unknown Variety,Bag
Quintay,24Q6320785,03/22/2025,Sale,-108.0,2052.0,7,Unknown Variety,Bag
Quintay,24Q6320785,03/26/2025,Sale,-108.0,1944.0,11,Unknown Variety,Bag
Quintay,24Q6320785,03/26/2025,Sale,-970.0,974.0,11,Unknown Variety,Bag
Quintay,24Q6320785,03/27/2025,Sale,-648.0,326.0,12,Unknown Variety,Bag
Quintay,24Q6320785,03/29/2025,Sale,-108.0,218.0,14,Unknown Variety,Bag
Quintay,24Q6320785,04/03/2025,Sale,-166.0,52.0,19,Unknown Variety,Bag
Quintay,24Q6366528,04/04/2025,Entry,560.0,560.0,0,Unknown Variety,Bag
Quintay,24Q6366528,04/04/2025,Entry,1040.0,1600.0,0,Unknown Variety,Bag
Quintay,24Q6366528,04/28/2025,Sale,-424.0,1176.0,24,Unknown Variety,Bag
Quintay,24Q6366528,05/01/2025,Sale,-542.0,634.0,27,Unknown Variety,Bag
Quintay,24Q6366528,05/09/2025,Sale,-240.0,394.0,35,Unknown Variety,Bag
Quintay,24Q6366528,05/10/2025,Sale,-80.0,314.0,36,Unknown Variety,Bag
Quintay,24Q6366528,05/12/2025,Sale,-160.0,154.0,38,Unknown Variety,Bag
Quintay,24Q6371885,04/04/2025,Entry,1554.0,1554.0,0,Unknown Variety,Bag
Quintay,24Q6371885,04/04/2025,Entry,108.0,1662.0,0,Unknown Variety,Bag
Quintay,24Q6371885,04/04/2025,Entry,288.0,1950.0,0,Unknown Variety,Bag
Quintay,24Q6371885,04/12/2025,Sale,-773.0,1177.0,8,Unknown Variety,Bag
Quintay,24Q6371885,04/15/2025,Sale,-90.0,1087.0,11,Unknown Variety,Bag
Quintay,24Q6371885,04/15/2025,Sale,-166.0,921.0,11,Unknown Variety,Bag
Quintay,24Q6371885,04/17/2025,Sale,-288.0,633.0,13,Unknown Variety,Bag
Quintay,24Q6371885,05/06/2025,Sale,-80.0,553.0,32,Unknown Variety,Bag
Quintay,24Q6371885,05/07/2025,Sale,-17.0,536.0,33,Unknown Variety,Bag
Quintay,24Q6374082,03/08/2025,Entry,2016.0,2016.0,0,Unknown Variety,Bag
Quintay,24Q6374082,03/14/2025,Sale,-180.0,1836.0,6,Unknown Variety,Bag
Quintay,24Q6374082,03/14/2025,Sale,-90.0,1746.0,6,Unknown Variety,Bag
Quintay,24Q6374082,03/21/2025,Sale,-180.0,1566.0,13,Unknown Variety,Bag
Quintay,24Q6374082,03/21/2025,Sale,-90.0,1476.0,13,Unknown Variety,Bag
Quintay,24Q6374082,03/21/2025,Sale,-90.0,1386.0,13,Unknown Variety,Bag
Quintay,24Q6374082,03/22/2025,Sale,-756.0,630.0,14,Unknown Variety,Bag
Quintay,24Q6374082,03/24/2025,Sale,-108.0,522.0,16,Unknown Variety,Bag
Quintay,24Q6374082,03/24/2025,Sale,-198.0,324.0,16,Unknown Variety,Bag
Quintay,24Q6374082,03/26/2025,Sale,-324.0,0.0,18,Unknown Variety,Bag
Quintay,24Q6374713,03/23/2025,Entry,216.0,216.0,0,Unknown Variety,Bag
Quintay,24Q6374713,03/23/2025,Entry,1944.0,2160.0,0,Unknown Variety,Bag
Quintay,24Q6374713,04/03/2025,Sale,-108.0,2052.0,11,Unknown Variety,Bag
Quintay,24Q6374713,04/03/2025,Sale,-216.0,1836.0,11,Unknown Variety,Bag
Quintay,24Q6374713,04/04/2025,Sale,-432.0,1404.0,12,Unknown Variety,Bag
Quintay,24Q6374713,04/07/2025,Sale,-108.0,1296.0,15,Unknown Variety,Bag
Quintay,24Q6374713,04/07/2025,Sale,-324.0,972.0,15,Unknown Variety,Bag
Quintay,24Q6374713,04/07/2025,Sale,-424.0,548.0,15,Unknown Variety,Bag
Quintay,24Q6374713,04/08/2025,Sale,-108.0,440.0,16,Unknown Variety,Bag
Quintay,24Q6374713,04/09/2025,Sale,-84.0,356.0,17,Unknown Variety,Bag
Quintay,24Q6597961,04/02/2025,Entry,432.0,432.0,0,Unknown Variety,Bag
Quintay,24Q6597961,04/02/2025,Entry,1728.0,2160.0,0,Unknown Variety,Bag
Quintay,24Q6597961,04/14/2025,Sale,-216.0,1944.0,12,Unknown Variety,Bag
Quintay,24Q6597961,04/15/2025,Sale,-324.0,1620.0,13,Unknown Variety,Bag
Quintay,24Q6597961,04/16/2025,Sale,-108.0,1512.0,14,Unknown Variety,Bag
Quintay,24Q6597961,04/16/2025,Sale,-756.0,756.0,14,Unknown Variety,Bag
Quintay,24Q6597961,04/17/2025,Sale,-432.0,324.0,15,Unknown Variety,Bag
Quintay,24Q6597961,04/17/2025,Sale,-108.0,216.0,15,Unknown Variety,Bag
Quintay,24Q6597961,04/21/2025,Sale,-216.0,0.0,19,Unknown Variety,Bag
Quintay,24Q6605178,03/19/2025,Entry,1600.0,1600.0,0,Unknown Variety,Clam
Quintay,24Q6605178,04/20/2025,Sale,-1600.0,0.0,32,Unknown Variety,Clam
Quintay,24Q6947313,03/19/2025,Entry,1600.0,1600.0,0,Unknown Variety,Bag
Quintay,24Q6947313,05/03/2025,Sale,-400.0,1200.0,45,Unknown Variety,Bag
Quintay,24Q6947313,05/03/2025,Sale,-240.0,960.0,45,Unknown Variety,Bag
Quintay,24Q6947313,05/05/2025,Sale,-160.0,800.0,47,Unknown Variety,Bag
Quintay,24Q6947313,05/05/2025,Sale,-80.0,720.0,47,Unknown Variety,Bag
Quintay,24Q6947313,05/05/2025,Sale,-231.0,489.0,47,Unknown Variety,Bag
Quintay,24Q6947313,05/06/2025,Sale,-80.0,409.0,48,Unknown Variety,Bag
Quintay,24Q6997572,03/19/2025,Entry,1600.0,1600.0,0,Unknown Variety,Clam
Quintay,24Q6997572,04/17/2025,Sale,-160.0,1440.0,29,Unknown Variety,Clam
Quintay,24Q6997572,04/18/2025,Sale,-80.0,1360.0,30,Unknown Variety,Clam
Quintay,24Q6997572,04/21/2025,Sale,-80.0,1280.0,33,Unknown Variety,Clam
Quintay,24Q6997572,04/25/2025,Sale,-80.0,1200.0,37,Unknown Variety,Clam
Quintay,24Q6997572,05/07/2025,Sale,-240.0,960.0,49,Unknown Variety,Bag
Quintay,24Q6997572,05/07/2025,Sale,-240.0,720.0,49,Unknown Variety,Bag
Quintay,24Q6997572,05/08/2025,Sale,-160.0,560.0,50,Unknown Variety,Bag
Quintay,24Q6997572,05/08/2025,Sale,-80.0,480.0,50,Unknown Variety,Bag
Quintay,24Q8006245,03/19/2025,Entry,1600.0,1600.0,0,Unknown Variety,Clam
Quintay,24Q8006245,04/20/2025,Sale,-320.0,1280.0,32,Unknown Variety,Clam
Quintay,24Q8006245,04/20/2025,Sale,-1280.0,0.0,32,Unknown Variety,Clam
Quintay,24Q8079792,04/27/2025,Entry,540.0,540.0,0,Unknown Variety,Bag
Quintay,24Q8079792,04/27/2025,Entry,1260.0,1800.0,0,Unknown Variety,Bag
Quintay,24Q8972753,04/20/2025,Entry,160.0,160.0,0,Unknown Variety,Bag
Quintay,24Q8972753,04/20/2025,Entry,240.0,400.0,0,Unknown Variety,Bag
Quintay,24Q8972753,04/20/2025,Entry,1200.0,1600.0,0,Unknown Variety,Bag
Quintay,24Q8972753,05/05/2025,Sale,-80.0,1520.0,15,Unknown Variety,Bag
Quintay,24Q8972753,05/05/2025,Sale,-80.0,1440.0,15,Unknown Variety,Bag
Quintay,24Q8972753,05/05/2025,Sale,-160.0,1280.0,15,Unknown Variety,Bag
Quintay,24Q8972753,05/05/2025,Sale,-80.0,1200.0,15,Unknown Variety,Bag
Quintay,24Q9026900,04/27/2025,Entry,1710.0,1710.0,0,Unknown Variety,Clam
Quintay,24Q9026900,04/27/2025,Entry,90.0,1800.0,0,Unknown Variety,Clam
Quintay,24Q9027966,04/27/2025,Entry,180.0,180.0,0,Unknown Variety,Clam
Quintay,24Q9027966,04/27/2025,Entry,1620.0,1800.0,0,Unknown Variety,Clam
Quintay,24Q9030876,04/27/2025,Entry,1440.0,1440.0,0,Unknown Variety,Clam
Quintay,24Q9030876,04/27/2025,Entry,360.0,1800.0,0,Unknown Variety,Clam
Quintay,24Q9031358,03/30/2025,Entry,1600.0,1600.0,0,Unknown Variety,Clam
Quintay,24Q9031358,04/23/2025,Sale,-480.0,1120.0,24,Unknown Variety,Clam
Quintay,24Q9031358,04/26/2025,Sale,-320.0,800.0,27,Unknown Variety,Clam
Quintay,24Q9031358,04/30/2025,Sale,-80.0,720.0,31,Unknown Variety,Clam
Quintay,24Q9031358,05/02/2025,Sale,-80.0,640.0,33,Unknown Variety,Clam
Quintay,24Q9031358,05/02/2025,Sale,-6.0,634.0,33,Unknown Variety,Clam
Quintay,24Q9031358,05/09/2025,Sale,-80.0,554.0,40,Unknown Variety,Clam
Quintay,24Q9031358,05/10/2025,Sale,-160.0,394.0,41,Unknown Variety,Clam
Quintay,24Q9083950,04/27/2025,Entry,400.0,400.0,0,Unknown Variety,Clam
Quintay,24Q9083950,04/27/2025,Entry,805.0,1205.0,0,Unknown Variety,Clam
Quintay,24Q9083950,04/27/2025,Entry,480.0,1685.0,0,Unknown Variety,Clam
Quintay,24Q9118800,04/04/2025,Entry,1600.0,1600.0,0,Unknown Variety,Clam
Quintay,24Q9118800,04/25/2025,Sale,-560.0,1040.0,21,Unknown Variety,Clam
Quintay,24Q9118800,04/27/2025,Sale,-720.0,320.0,23,Unknown Variety,Clam
Quintay,24Q9129277,03/22/2025,Entry,1600.0,1600.0,0,Unknown Variety,Clam
Quintay,24Q9129277,03/27/2025,Sale,-400.0,1200.0,5,Unknown Variety,Clam
Quintay,24Q9129277,03/28/2025,Sale,-400.0,800.0,6,Unknown Variety,Clam
Quintay,24Q9129277,05/02/2025,Sale,-80.0,720.0,41,Unknown Variety,Clam
Quintay,24Q9129277,05/03/2025,Sale,-273.0,447.0,42,Unknown Variety,Clam
Quintay,24Q9129277,05/03/2025,Sale,-320.0,127.0,42,Unknown Variety,Clam
Quintay,24Q9179179,04/27/2025,Entry,1350.0,1350.0,0,Unknown Variety,Bag
Quintay,24Q9179179,04/27/2025,Entry,450.0,1800.0,0,Unknown Variety,Bag
Quintay,24Q9180632,03/15/2025,Entry,2160.0,2160.0,0,Unknown Variety,Bag
Quintay,24Q9180632,03/29/2025,Sale,-540.0,1620.0,14,Unknown Variety,Bag
Quintay,24Q9180632,04/03/2025,Sale,-648.0,972.0,19,Unknown Variety,Bag
Quintay,24Q9180632,04/03/2025,Sale,-590.0,382.0,19,Unknown Variety,Bag
Quintay,24Q9180632,04/12/2025,Sale,-83.0,299.0,28,Unknown Variety,Bag
Quintay,24Q9180632,04/17/2025,Sale,-38.0,261.0,33,Unknown Variety,Bag
Quintay,24Q9187770,04/04/2025,Entry,1700.0,1700.0,0,Unknown Variety,Bag
Quintay,24Q9187770,04/15/2025,Sale,-720.0,980.0,11,Unknown Variety,Bag
Quintay,24Q9187770,04/15/2025,Sale,-26.0,954.0,11,Unknown Variety,Bag
Quintay,24Q9187770,04/17/2025,Sale,-40.0,914.0,13,Unknown Variety,Bag
Quintay,24Q9187770,04/18/2025,Sale,-560.0,354.0,14,Unknown Variety,Bag
Quintay,24Q9187770,04/28/2025,Sale,-56.0,298.0,24,Unknown Variety,Bag
Quintay,24Q9228335,04/07/2025,Entry,1600.0,1600.0,0,Unknown Variety,Bag
Quintay,24Q9306082,04/10/2025,Entry,2280.0,2280.0,0,Unknown Variety,Bag
Quintay,24Q9306082,05/07/2025,Sale,-330.0,1950.0,27,Unknown Variety,Bag
Quintay,24Q9306082,05/09/2025,Sale,-720.0,1230.0,29,Unknown Variety,Bag
Quintay,24Q9306082,05/09/2025,Sale,-540.0,690.0,29,Unknown Variety,Bag
Quintay,24Q9306082,05/09/2025,Sale,-119.0,571.0,29,Unknown Variety,Bag
Quintay,24Q9307877,04/20/2025,Entry,1600.0,1600.0,0,Unknown Variety,Clam
Quintay,24Q9307877,05/05/2025,Sale,-1600.0,0.0,15,Unknown Variety,Clam
Quintay,24Q9330237,03/23/2025,Entry,1600.0,1600.0,0,Unknown Variety,Clam
Quintay,24Q9330237,04/14/2025,Sale,-80.0,1520.0,22,Unknown Variety,Clam
Quintay,24Q9330237,04/17/2025,Sale,-80.0,1440.0,25,Unknown Variety,Clam
Quintay,24Q9330237,04/28/2025,Sale,-240.0,1200.0,36,Unknown Variety,Clam
Quintay,24Q9330237,04/29/2025,Sale,-160.0,1040.0,37,Unknown Variety,Clam
Quintay,24Q9330237,04/29/2025,Sale,-320.0,720.0,37,Unknown Variety,Clam
Quintay,24Q9333030,04/10/2025,Entry,1140.0,1140.0,0,Unknown Variety,Clam
Quintay,24Q9333030,04/10/2025,Entry,960.0,2100.0,0,Unknown Variety,Clam
Quintay,24Q9333030,04/28/2025,Sale,-595.0,1505.0,18,Unknown Variety,Clam
Quintay,24Q9333030,04/29/2025,Sale,-80.0,1425.0,19,Unknown Variety,Clam
Quintay,24Q9333030,05/07/2025,Sale,-170.0,1255.0,27,Unknown Variety,Bag
Quintay,24Q9333030,05/09/2025,Sale,-180.0,1075.0,29,Unknown Variety,Bag
Quintay,24Q9333030,05/09/2025,Sale,-270.0,805.0,29,Unknown Variety,Bag
Quintay,24Q9338840,03/23/2025,Entry,1600.0,1600.0,0,Unknown Variety,Clam
Quintay,24Q9338840,04/01/2025,Sale,-800.0,800.0,9,Unknown Variety,Clam
Quintay,24Q9338840,04/16/2025,Sale,-640.0,160.0,24,Unknown Variety,Clam
Quintay,24Q9463436,04/07/2025,Entry,1600.0,1600.0,0,Unknown Variety,Clam
Quintay,24Q9463436,04/27/2025,Sale,-1200.0,400.0,20,Unknown Variety,Clam
Quintay,24Q9463436,05/03/2025,Sale,-9.0,391.0,26,Unknown Variety,Clam
Quintay,24Q9507534,04/04/2025,Entry,640.0,640.0,0,Unknown Variety,Bag
Quintay,24Q9507534,04/04/2025,Entry,960.0,1600.0,0,Unknown Variety,Bag
Quintay,24Q9507534,05/07/2025,Sale,-463.0,1137.0,33,Unknown Variety,Bag
Quintay,24Q9507534,05/07/2025,Sale,-720.0,417.0,33,Unknown Variety,Bag
Quintay,24Q9611972,03/31/2025,Sale,-90.0,-90.0,0,Unknown Variety,Bag
Quintay,24Q9611972,03/31/2025,Sale,-270.0,-360.0,0,Unknown Variety,Bag
Quintay,24Q9611972,04/02/2025,Sale,-90.0,-450.0,2,Unknown Variety,Bag
Quintay,24Q9611972,04/04/2025,Sale,-180.0,-630.0,4,Unknown Variety,Bag
Quintay,24Q9611972,04/04/2025,Sale,-180.0,-810.0,4,Unknown Variety,Bag
Quintay,24Q9611972,04/04/2025,Sale,-510.0,-1320.0,4,Unknown Variety,Bag
Quintay,24Q9611972,04/05/2025,Entry,1800.0,480.0,5,Unknown Variety,Bag
Quintay,24Q9611972,04/05/2025,Sale,-315.0,165.0,5,Unknown Variety,Bag
Quintay,24Q9611972,04/05/2025,Sale,-110.0,55.0,5,Unknown Variety,Bag
Quintay,24Q9612120,03/29/2025,Sale,-270.0,-270.0,0,Unknown Variety,Bag
Quintay,24Q9612120,03/31/2025,Sale,-630.0,-900.0,2,Unknown Variety,Bag
Quintay,24Q9612120,03/31/2025,Sale,-270.0,-1170.0,2,Unknown Variety,Bag
Quintay,24Q9612120,03/31/2025,Sale,-90.0,-1260.0,2,Unknown Variety,Bag
Quintay,24Q9612120,04/01/2025,Sale,-180.0,-1440.0,3,Unknown Variety,Bag
Quintay,24Q9612120,04/02/2025,Sale,-180.0,-1620.0,4,Unknown Variety,Bag
Quintay,24Q9612120,04/05/2025,Sale,-150.0,-1770.0,7,Unknown Variety,Bag
Quintay,24Q9612120,04/06/2025,Entry,1800.0,30.0,8,Unknown Variety,Bag
Quintay,24Q9612120,04/15/2025,Sale,-20.0,10.0,17,Unknown Variety,Bag
Quintay,24Q9620547,03/22/2025,Entry,1600.0,1600.0,0,Unknown Variety,Clam
Quintay,24Q9620547,03/23/2025,Sale,-1600.0,0.0,1,Unknown Variety,Clam
Quintay,24Q9623103,03/31/2025,Sale,-270.0,-270.0,0,Unknown Variety,Bag
Quintay,24Q9623103,03/31/2025,Sale,-360.0,-630.0,0,Unknown Variety,Bag
Quintay,24Q9623103,04/02/2025,Sale,-90.0,-720.0,2,Unknown Variety,Bag
Quintay,24Q9623103,04/04/2025,Sale,-420.0,-1140.0,4,Unknown Variety,Bag
Quintay,24Q9623103,04/05/2025,Sale,-255.0,-1395.0,5,Unknown Variety,Bag
Quintay,24Q9623103,04/05/2025,Sale,-155.0,-1550.0,5,Unknown Variety,Bag
Quintay,24Q9623103,04/06/2025,Entry,1800.0,250.0,6,Unknown Variety,Bag
Quintay,24Q9623103,04/08/2025,Sale,-180.0,70.0,8,Unknown Variety,Bag
Quintay,24Q9625261,03/29/2025,Sale,-630.0,-630.0,0,Unknown Variety,Bag
Quintay,24Q9625261,03/31/2025,Sale,-90.0,-720.0,2,Unknown Variety,Bag
Quintay,24Q9625261,03/31/2025,Sale,-360.0,-1080.0,2,Unknown Variety,Bag
Quintay,24Q9625261,04/02/2025,Sale,-180.0,-1260.0,4,Unknown Variety,Bag
Quintay,24Q9625261,04/04/2025,Sale,-90.0,-1350.0,6,Unknown Variety,Bag
Quintay,24Q9625261,04/04/2025,Sale,-180.0,-1530.0,6,Unknown Variety,Bag
Quintay,24Q9625261,04/05/2025,Sale,-65.0,-1595.0,7,Unknown Variety,Bag
Quintay,24Q9625261,04/06/2025,Entry,1800.0,205.0,8,Unknown Variety,Bag
Quintay,24Q9625261,04/15/2025,Sale,-94.0,111.0,17,Unknown Variety,Bag
Quintay,24Q9625277,03/31/2025,Sale,-360.0,-360.0,0,Unknown Variety,Bag
Quintay,24Q9625277,03/31/2025,Sale,-180.0,-540.0,0,Unknown Variety,Bag
Quintay,24Q9625277,04/01/2025,Sale,-270.0,-810.0,1,Unknown Variety,Bag
Quintay,24Q9625277,04/02/2025,Sale,-90.0,-900.0,2,Unknown Variety,Bag
Quintay,24Q9625277,04/05/2025,Sale,-270.0,-1170.0,5,Unknown Variety,Bag
Quintay,24Q9625277,04/05/2025,Sale,-410.0,-1580.0,5,Unknown Variety,Bag
Quintay,24Q9625277,04/06/2025,Entry,1800.0,220.0,6,Unknown Variety,Bag
Quintay,24Q9625277,04/15/2025,Sale,-168.0,52.0,15,Unknown Variety,Bag
Quintay,24Q9627259,03/29/2025,Sale,-90.0,-90.0,0,Unknown Variety,Bag
Quintay,24Q9627259,03/31/2025,Sale,-360.0,-450.0,2,Unknown Variety,Bag
Quintay,24Q9627259,03/31/2025,Sale,-270.0,-720.0,2,Unknown Variety,Bag
Quintay,24Q9627259,03/31/2025,Sale,-540.0,-1260.0,2,Unknown Variety,Bag
Quintay,24Q9627259,04/04/2025,Sale,-270.0,-1530.0,6,Unknown Variety,Bag
Quintay,24Q9627259,04/04/2025,Sale,-60.0,-1590.0,6,Unknown Variety,Bag
Quintay,24Q9627259,04/05/2025,Sale,-60.0,-1650.0,7,Unknown Variety,Bag
Quintay,24Q9627259,04/05/2025,Sale,-100.0,-1750.0,7,Unknown Variety,Bag
Quintay,24Q9627259,04/06/2025,Entry,1800.0,50.0,8,Unknown Variety,Bag
Quintay,24Q9627259,04/15/2025,Sale,-10.0,40.0,17,Unknown Variety,Bag
Quintay,24Q9627428,03/15/2025,Entry,1800.0,1800.0,0,Unknown Variety,Bag
Quintay,24Q9627428,03/21/2025,Sale,-90.0,1710.0,6,Unknown Variety,Bag
Quintay,24Q9627428,03/24/2025,Sale,-1710.0,0.0,9,Unknown Variety,Bag
Quintay,24Q9656630,03/07/2025,Entry,1800.0,1800.0,0,Unknown Variety,Bag
Quintay,24Q9656630,03/21/2025,Sale,-270.0,1530.0,14,Unknown Variety,Bag
Quintay,24Q9656630,03/21/2025,Sale,-180.0,1350.0,14,Unknown Variety,Bag
Quintay,24Q9656630,03/21/2025,Sale,-900.0,450.0,14,Unknown Variety,Bag
Quintay,24Q9656630,03/21/2025,Sale,-360.0,90.0,14,Unknown Variety,Bag
Quintay,24Q9656630,04/03/2025,Sale,-58.0,32.0,27,Unknown Variety,Bag
Quintay,24Q9657507,04/20/2025,Entry,1600.0,1600.0,0,Unknown Variety,Clam
Quintay,24Q9657507,05/07/2025,Sale,-480.0,1120.0,17,Unknown Variety,Clam
Quintay,24Q9657507,05/11/2025,Sale,-17.0,1103.0,21,Unknown Variety,Clam
Quintay,24Q9678066,04/10/2025,Entry,1800.0,1800.0,0,Unknown Variety,Bag
Quintay,24Q9678066,04/22/2025,Sale,-180.0,1620.0,12,Unknown Variety,Bag
Quintay,24Q9678066,04/24/2025,Sale,-1530.0,90.0,14,Unknown Variety,Bag
Quintay,24Q9678066,05/03/2025,Sale,-90.0,0.0,23,Unknown Variety,Bag
Quintay,24Q9684135,03/22/2025,Entry,1600.0,1600.0,0,Unknown Variety,Clam
Quintay,24Q9684135,03/23/2025,Sale,-1600.0,0.0,1,Unknown Variety,Clam
Quintay,24Q9693228,04/04/2025,Entry,1600.0,1600.0,0,Unknown Variety,Clam
Quintay,24Q9693228,05/01/2025,Sale,-400.0,1200.0,27,Unknown Variety,Clam
Quintay,24Q9693228,05/02/2025,Sale,-80.0,1120.0,28,Unknown Variety,Clam
Quintay,24Q9693228,05/03/2025,Sale,-40.0,1080.0,29,Unknown Variety,Clam
Quintay,24Q9693228,05/04/2025,Sale,-612.0,468.0,30,Unknown Variety,Clam
Quintay,24Q9694679,03/15/2025,Entry,2160.0,2160.0,0,Unknown Variety,Bag
Quintay,24Q9694679,03/22/2025,Sale,-108.0,2052.0,7,Unknown Variety,Bag
Quintay,24Q9694679,03/26/2025,Sale,-756.0,1296.0,11,Unknown Variety,Bag
Quintay,24Q9694679,03/27/2025,Sale,-540.0,756.0,12,Unknown Variety,Bag
Quintay,24Q9694679,03/29/2025,Sale,-324.0,432.0,14,Unknown Variety,Bag
Quintay,24Q9694679,04/03/2025,Sale,-158.0,274.0,19,Unknown Variety,Bag
Quintay,24Q9694679,04/03/2025,Sale,-216.0,58.0,19,Unknown Variety,Bag
Quintay,24Q9696440,04/10/2025,Entry,1800.0,1800.0,0,Unknown Variety,Bag
Quintay,24Q9696440,04/23/2025,Sale,-270.0,1530.0,13,Unknown Variety,Bag
Quintay,24Q9696440,04/24/2025,Sale,-450.0,1080.0,14,Unknown Variety,Bag
Quintay,24Q9696440,04/28/2025,Sale,-180.0,900.0,18,Unknown Variety,Bag
Quintay,24Q9696440,04/29/2025,Sale,-180.0,720.0,19,Unknown Variety,Bag
Quintay,24Q9696440,05/02/2025,Sale,-80.0,640.0,22,Unknown Variety,Bag
Quintay,24Q9696440,05/03/2025,Sale,-90.0,550.0,23,Unknown Variety,Bag
Quintay,24Q9696440,05/09/2025,Sale,-270.0,280.0,29,Unknown Variety,Bag
Quintay,24Q9696440,05/09/2025,Sale,-25.0,255.0,29,Unknown Variety,Bag
Quintay,24Q9696440,05/12/2025,Sale,-10.0,245.0,32,Unknown Variety,Bag
Quintay,24Q9696440,05/12/2025,Sale,-10.0,235.0,32,Unknown Variety,Bag
Quintay,24Q9720700,03/15/2025,Entry,2160.0,2160.0,0,Unknown Variety,Bag
Quintay,24Q9720700,03/22/2025,Sale,-972.0,1188.0,7,Unknown Variety,Bag
Quintay,24Q9720700,03/24/2025,Sale,-108.0,1080.0,9,Unknown Variety,Bag
Quintay,24Q9720700,03/26/2025,Sale,-216.0,864.0,11,Unknown Variety,Bag
Quintay,24Q9720700,03/26/2025,Sale,-432.0,432.0,11,Unknown Variety,Bag
Quintay,24Q9720700,03/27/2025,Sale,-324.0,108.0,12,Unknown Variety,Bag
Quintay,24Q9720700,04/12/2025,Sale,-8.0,100.0,28,Unknown Variety,Bag
Quintay,24Q9720700,04/17/2025,Sale,-58.0,42.0,33,Unknown Variety,Bag
Quintay,24Q9720905,04/10/2025,Entry,720.0,720.0,0,Unknown Variety,Bag
Quintay,24Q9720905,04/10/2025,Entry,900.0,1620.0,0,Unknown Variety,Bag
Quintay,24Q9720905,04/10/2025,Entry,160.0,1780.0,0,Unknown Variety,Bag
Quintay,24Q9720905,04/23/2025,Sale,-720.0,1060.0,13,Unknown Variety,Bag
Quintay,24Q9720905,04/23/2025,Sale,-49.0,1011.0,13,Unknown Variety,Bag
Quintay,24Q9720905,04/25/2025,Sale,-180.0,831.0,15,Unknown Variety,Bag
Quintay,24Q9720905,04/28/2025,Sale,-180.0,651.0,18,Unknown Variety,Bag
Quintay,24Q9720905,04/30/2025,Sale,-80.0,571.0,20,Unknown Variety,Bag
Quintay,24Q9720905,04/30/2025,Sale,-80.0,491.0,20,Unknown Variety,Clam
Quintay,24Q9720905,05/01/2025,Sale,-160.0,331.0,21,Unknown Variety,Bag
Quintay,24Q9720905,05/07/2025,Sale,-32.0,299.0,27,Unknown Variety,Bag
Quintay,24Q9725066,04/27/2025,Entry,1800.0,1800.0,0,Unknown Variety,Bag
Quintay,24Q9725066,05/13/2025,Sale,-180.0,1620.0,16,Unknown Variety,Bag
Quintay,24Q9740054,04/10/2025,Entry,1530.0,1530.0,0,Unknown Variety,Bag
Quintay,24Q9740054,04/10/2025,Entry,90.0,1620.0,0,Unknown Variety,Bag
Quintay,24Q9740054,04/10/2025,Entry,160.0,1780.0,0,Unknown Variety,Bag
Quintay,24Q9740054,04/28/2025,Sale,-713.0,1067.0,18,Unknown Variety,Bag
Quintay,24Q9740054,04/28/2025,Sale,-90.0,977.0,18,Unknown Variety,Bag
Quintay,24Q9740054,04/30/2025,Sale,-80.0,897.0,20,Unknown Variety,Clam
Quintay,24Q9740054,05/02/2025,Sale,-12.0,885.0,22,Unknown Variety,Clam
Quintay,24Q9740054,05/09/2025,Sale,-90.0,795.0,29,Unknown Variety,Bag
Quintay,24Q9740054,05/09/2025,Sale,-270.0,525.0,29,Unknown Variety,Bag
Quintay,24Q9740054,05/09/2025,Sale,-90.0,435.0,29,Unknown Variety,Bag
Quintay,24Q9740054,05/09/2025,Sale,-40.0,395.0,29,Unknown Variety,Clam
Quintay,24Q9740374,04/27/2025,Entry,180.0,180.0,0,Unknown Variety,Clam
Quintay,24Q9740374,04/27/2025,Entry,1620.0,1800.0,0,Unknown Variety,Clam
Quintay,24Q9740510,04/04/2025,Entry,1600.0,1600.0,0,Unknown Variety,Clam
Quintay,24Q9740510,04/21/2025,Sale,-320.0,1280.0,17,Unknown Variety,Clam
Quintay,24Q9740510,04/22/2025,Sale,-1280.0,0.0,18,Unknown Variety,Clam
Quintay,24Q9800236,04/04/2025,Entry,1600.0,1600.0,0,Unknown Variety,Clam
Quintay,24Q9800236,04/21/2025,Sale,-1600.0,0.0,17,Unknown Variety,Clam
Quintay,24Q9870283,04/04/2025,Entry,665.0,665.0,0,Unknown Variety,Bag
Quintay,24Q9870283,04/04/2025,Entry,1104.0,1769.0,0,Unknown Variety,Bag
Quintay,24Q9870283,04/17/2025,Sale,-400.0,1369.0,13,Unknown Variety,Bag
Quintay,24Q9870283,04/18/2025,Sale,-608.0,761.0,14,Unknown Variety,Bag
Quintay,24Q9870283,04/29/2025,Sale,-95.0,666.0,25,Unknown Variety,Bag
Quintay,24Q9870283,04/29/2025,Sale,-570.0,96.0,25,Unknown Variety,Bag
Quintay,24Q9870283,05/08/2025,Sale,-38.0,58.0,34,Unknown Variety,Bag
Quintay,24Q9882321,04/27/2025,Entry,990.0,990.0,0,Unknown Variety,Bag
Quintay,24Q9882321,04/27/2025,Entry,810.0,1800.0,0,Unknown Variety,Bag
Quintay,24Q9883230,04/27/2025,Entry,810.0,810.0,0,Unknown Variety,Bag
Quintay,24Q9883230,04/27/2025,Entry,990.0,1800.0,0,Unknown Variety,Bag
Quintay,24Q9883502,04/27/2025,Entry,90.0,90.0,0,Unknown Variety,Bag
Quintay,24Q9883502,04/27/2025,Entry,1620.0,1710.0,0,Unknown Variety,Bag
Quintay,24Q9883502,04/27/2025,Entry,90.0,1800.0,0,Unknown Variety,Bag
Quintay,24Q9911438,04/04/2025,Entry,1600.0,1600.0,0,Unknown Variety,Bag
Quintay,24Q9911438,05/06/2025,Sale,-80.0,1520.0,32,Unknown Variety,Bag
Unknown Exporter,24A14634399,03/28/2025,Sale,-60.0,-60.0,0,IVORY,Clam
Unknown Exporter,24A5471525,01/18/2025,Entry,1600.0,1600.0,0,SWEET GLOBE,Clam
Unknown Exporter,24A5471525,01/20/2025,Sale,-1520.0,80.0,2,SWEET GLOBE,Clam
Unknown Exporter,24A5471525,01/20/2025,Sale,-80.0,0.0,2,SWEET GLOBE,Clam
Unknown Exporter,24A5472516,03/31/2025,Entry,960.0,960.0,0,JACK SALUTE,Clam
Unknown Exporter,24A5472516,03/31/2025,Entry,640.0,1600.0,0,JACK SALUTE,Clam
Unknown Exporter,24A5472516,04/15/2025,Sale,-960.0,640.0,15,JACK SALUTE,Clam
Unknown Exporter,24A5472516,04/29/2025,Sale,-560.0,80.0,29,JACK SALUTE,Clam
Unknown Exporter,24A5769620,01/18/2025,Entry,1520.0,1520.0,0,SWEET GLOBE,Clam
Unknown Exporter,24A5769620,01/18/2025,Entry,80.0,1600.0,0,SWEET GLOBE,Clam
Unknown Exporter,24A5769620,01/21/2025,Sale,-80.0,1520.0,3,SWEET GLOBE,Clam
Unknown Exporter,24A5769620,01/22/2025,Sale,-480.0,1040.0,4,SWEET GLOBE,Clam
Unknown Exporter,24A5769620,01/25/2025,Sale,-1040.0,0.0,7,SWEET GLOBE,Clam
Unknown Exporter,24A5770560,01/18/2025,Entry,1360.0,1360.0,0,ALLISON,Clam
Unknown Exporter,24A5770560,01/18/2025,Entry,240.0,1600.0,0,ALLISON,Clam
Unknown Exporter,24A5770560,02/19/2025,Sale,-160.0,1440.0,32,ALLISON,Clam
Unknown Exporter,24A5770560,02/19/2025,Sale,-240.0,1200.0,32,ALLISON,Clam
Unknown Exporter,24A5770560,02/19/2025,Sale,-160.0,1040.0,32,ALLISON,Clam
Unknown Exporter,24A5770560,02/20/2025,Sale,-160.0,880.0,33,ALLISON,Clam
Unknown Exporter,24A5770560,02/25/2025,Sale,-80.0,800.0,38,ALLISON,Clam
Unknown Exporter,24A5770560,03/04/2025,Sale,-80.0,720.0,45,ALLISON,Clam
Unknown Exporter,24A5770560,03/07/2025,Sale,-80.0,640.0,48,ALLISON,Clam
Unknown Exporter,24A5770560,03/07/2025,Sale,-480.0,160.0,48,ALLISON,Clam
Unknown Exporter,24A5770560,03/14/2025,Sale,-100.0,60.0,55,ALLISON,Clam
Unknown Exporter,24A5782529,03/04/2025,Entry,720.0,720.0,0,TIMCO,Clam
Unknown Exporter,24A5782529,03/04/2025,Entry,880.0,1600.0,0,TIMCO,Clam
Unknown Exporter,24A5782529,04/06/2025,Sale,-880.0,720.0,33,TIMCO,Clam
Unknown Exporter,24A5782529,04/16/2025,Sale,-400.0,320.0,43,TIMCO,Clam
Unknown Exporter,24A5782529,04/20/2025,Sale,-80.0,240.0,47,TIMCO,Clam
Unknown Exporter,24A5782529,04/20/2025,Sale,-240.0,0.0,47,TIMCO,Clam
Unknown Exporter,24A6118654,01/21/2025,Entry,1440.0,1440.0,0,ALLISON,Clam
Unknown Exporter,24A6118654,01/21/2025,Entry,160.0,1600.0,0,ALLISON,Clam
Unknown Exporter,24A6118654,01/29/2025,Sale,-80.0,1520.0,8,ALLISON,Clam
Unknown Exporter,24A6118654,01/29/2025,Sale,-800.0,720.0,8,ALLISON,Clam
Unknown Exporter,24A6118654,02/01/2025,Sale,-47.0,673.0,11,ALLISON,Clam
Unknown Exporter,24A6118654,02/04/2025,Sale,-80.0,593.0,14,ALLISON,Clam
Unknown Exporter,24A6118654,02/06/2025,Sale,-33.0,560.0,16,ALLISON,Clam
Unknown Exporter,24A6118654,02/10/2025,Sale,-80.0,480.0,20,ALLISON,Clam
Unknown Exporter,24A6118654,02/12/2025,Sale,-160.0,320.0,22,ALLISON,Clam
Unknown Exporter,24A6118654,02/13/2025,Sale,-80.0,240.0,23,ALLISON,Clam
Unknown Exporter,24A6118654,02/14/2025,Sale,-80.0,160.0,24,ALLISON,Clam
Unknown Exporter,24A6118654,02/17/2025,Sale,-160.0,0.0,27,ALLISON,Clam
Unknown Exporter,24A6130775,01/18/2025,Entry,1360.0,1360.0,0,ALLISON,Clam
Unknown Exporter,24A6130775,01/18/2025,Entry,240.0,1600.0,0,ALLISON,Clam
Unknown Exporter,24A6130775,02/19/2025,Sale,-400.0,1200.0,32,ALLISON,Clam
Unknown Exporter,24A6130775,02/20/2025,Sale,-80.0,1120.0,33,ALLISON,Clam
Unknown Exporter,24A6130775,02/20/2025,Sale,-80.0,1040.0,33,ALLISON,Clam
Unknown Exporter,24A6130775,02/22/2025,Sale,-320.0,720.0,35,ALLISON,Clam
Unknown Exporter,24A6130775,02/24/2025,Sale,-400.0,320.0,37,ALLISON,Clam
Unknown Exporter,24A6130775,03/03/2025,Sale,-160.0,160.0,44,ALLISON,Clam
Unknown Exporter,24A6130775,03/07/2025,Sale,-80.0,80.0,48,ALLISON,Clam
Unknown Exporter,24A6130775,03/14/2025,Sale,-60.0,20.0,55,ALLISON,Clam
Unknown Exporter,24A6559846,01/18/2025,Entry,1600.0,1600.0,0,SWEET GLOBE,Clam
Unknown Exporter,24A6559846,01/30/2025,Sale,-80.0,1520.0,12,SWEET GLOBE,Clam
Unknown Exporter,24A6559846,01/31/2025,Sale,-640.0,880.0,13,SWEET GLOBE,Clam
Unknown Exporter,24A6559846,01/31/2025,Sale,-80.0,800.0,13,SWEET GLOBE,Clam
Unknown Exporter,24A6559846,01/31/2025,Sale,-640.0,160.0,13,SWEET GLOBE,Clam
Unknown Exporter,24A6559846,01/31/2025,Sale,-160.0,0.0,13,SWEET GLOBE,Clam
Unknown Exporter,24A8064273,01/18/2025,Entry,1280.0,1280.0,0,SWEET GLOBE,Clam
Unknown Exporter,24A8064273,01/18/2025,Entry,320.0,1600.0,0,SWEET GLOBE,Clam
Unknown Exporter,24A8064273,01/20/2025,Sale,-240.0,1360.0,2,SWEET GLOBE,Clam
Unknown Exporter,24A8064273,01/21/2025,Sale,-240.0,1120.0,3,SWEET GLOBE,Clam
Unknown Exporter,24A8064273,01/21/2025,Sale,-80.0,1040.0,3,SWEET GLOBE,Clam
Unknown Exporter,24A8064273,01/22/2025,Sale,-560.0,480.0,4,SWEET GLOBE,Clam
Unknown Exporter,24A8064273,01/22/2025,Sale,-80.0,400.0,4,SWEET GLOBE,Clam
Unknown Exporter,24A8064273,01/22/2025,Sale,-240.0,160.0,4,SWEET GLOBE,Clam
Unknown Exporter,24A8064273,01/28/2025,Sale,-160.0,0.0,10,SWEET GLOBE,Clam
Unknown Exporter,24A8128336,01/18/2025,Entry,1200.0,1200.0,0,ALLISON,Clam
Unknown Exporter,24A8128336,01/18/2025,Entry,400.0,1600.0,0,ALLISON,Clam
Unknown Exporter,24A8128336,02/20/2025,Sale,-80.0,1520.0,33,ALLISON,Clam
Unknown Exporter,24A8128336,02/27/2025,Sale,-240.0,1280.0,40,ALLISON,Clam
Unknown Exporter,24A8128336,03/03/2025,Sale,-320.0,960.0,44,ALLISON,Clam
Unknown Exporter,24A8128336,03/03/2025,Sale,-160.0,800.0,44,ALLISON,Clam
Unknown Exporter,24A8128336,03/04/2025,Sale,-80.0,720.0,45,ALLISON,Clam
Unknown Exporter,24A8128336,03/06/2025,Sale,-160.0,560.0,47,ALLISON,Clam
Unknown Exporter,24A8128336,03/07/2025,Sale,-320.0,240.0,48,ALLISON,Clam
Unknown Exporter,24A8128336,03/08/2025,Sale,-80.0,160.0,49,ALLISON,Clam
Unknown Exporter,24A8128336,03/27/2025,Sale,-142.0,18.0,68,ALLISON,Clam
Unknown Exporter,24A8184556,01/18/2025,Entry,1440.0,1440.0,0,SWEET GLOBE,Clam
Unknown Exporter,24A8184556,01/18/2025,Entry,80.0,1520.0,0,SWEET GLOBE,Clam
Unknown Exporter,24A8184556,01/18/2025,Entry,80.0,1600.0,0,SWEET GLOBE,Clam
Unknown Exporter,24A8184556,02/06/2025,Sale,-80.0,1520.0,19,SWEET GLOBE,Clam
Unknown Exporter,24A8184556,02/06/2025,Sale,-240.0,1280.0,19,SWEET GLOBE,Clam
Unknown Exporter,24A8184556,02/06/2025,Sale,-80.0,1200.0,19,SWEET GLOBE,Clam
Unknown Exporter,24A8184556,02/07/2025,Sale,-160.0,1040.0,20,SWEET GLOBE,Clam
Unknown Exporter,24A8184556,02/07/2025,Sale,-560.0,480.0,20,SWEET GLOBE,Clam
Unknown Exporter,24A8184556,02/07/2025,Sale,-80.0,400.0,20,SWEET GLOBE,Clam
Unknown Exporter,24A8184556,02/08/2025,Sale,-160.0,240.0,21,SWEET GLOBE,Clam
Unknown Exporter,24A8184556,02/11/2025,Sale,-80.0,160.0,24,SWEET GLOBE,Clam
Unknown Exporter,24A8184556,02/15/2025,Sale,-80.0,80.0,28,SWEET GLOBE,Clam
Unknown Exporter,24A8184556,03/17/2025,Sale,-60.0,20.0,58,SWEET GLOBE,Clam
Unknown Exporter,24A8229613,01/18/2025,Entry,1440.0,1440.0,0,SWEET GLOBE,Clam
Unknown Exporter,24A8229613,01/18/2025,Entry,80.0,1520.0,0,SWEET GLOBE,Clam
Unknown Exporter,24A8229613,01/18/2025,Entry,80.0,1600.0,0,SWEET GLOBE,Clam
Unknown Exporter,24A8229613,01/29/2025,Sale,-80.0,1520.0,11,SWEET GLOBE,Clam
Unknown Exporter,24A8229613,01/29/2025,Sale,-240.0,1280.0,11,SWEET GLOBE,Clam
Unknown Exporter,24A8229613,01/29/2025,Sale,-80.0,1200.0,11,SWEET GLOBE,Clam
Unknown Exporter,24A8229613,01/30/2025,Sale,-80.0,1120.0,12,SWEET GLOBE,Clam
Unknown Exporter,24A8229613,01/30/2025,Sale,-240.0,880.0,12,SWEET GLOBE,Clam
Unknown Exporter,24A8229613,01/30/2025,Sale,-160.0,720.0,12,SWEET GLOBE,Clam
Unknown Exporter,24A8229613,01/30/2025,Sale,-80.0,640.0,12,SWEET GLOBE,Clam
Unknown Exporter,24A8229613,01/31/2025,Sale,-480.0,160.0,13,SWEET GLOBE,Clam
Unknown Exporter,24A8229613,02/03/2025,Sale,-83.0,77.0,16,SWEET GLOBE,Clam
Unknown Exporter,24A8229613,02/03/2025,Sale,-5.0,72.0,16,SWEET GLOBE,Clam
Unknown Exporter,24A8229613,02/04/2025,Sale,-73.0,-1.0,17,SWEET GLOBE,Clam
Unknown Exporter,24A8785802,01/18/2025,Entry,1280.0,1280.0,0,SWEET GLOBE,Clam
Unknown Exporter,24A8785802,01/18/2025,Entry,80.0,1360.0,0,SWEET GLOBE,Clam
Unknown Exporter,24A8785802,01/18/2025,Entry,240.0,1600.0,0,SWEET GLOBE,Clam
Unknown Exporter,24A8785802,02/06/2025,Sale,-80.0,1520.0,19,SWEET GLOBE,Clam
Unknown Exporter,24A8785802,02/06/2025,Sale,-160.0,1360.0,19,SWEET GLOBE,Clam
Unknown Exporter,24A8785802,02/06/2025,Sale,-320.0,1040.0,19,SWEET GLOBE,Clam
Unknown Exporter,24A8785802,02/07/2025,Sale,-240.0,800.0,20,SWEET GLOBE,Clam
Unknown Exporter,24A8785802,02/07/2025,Sale,-80.0,720.0,20,SWEET GLOBE,Clam
Unknown Exporter,24A8785802,02/07/2025,Sale,-160.0,560.0,20,SWEET GLOBE,Clam
Unknown Exporter,24A8785802,02/07/2025,Sale,-80.0,480.0,20,SWEET GLOBE,Clam
Unknown Exporter,24A8785802,02/07/2025,Sale,-80.0,400.0,20,SWEET GLOBE,Clam
Unknown Exporter,24A8785802,02/10/2025,Sale,-80.0,320.0,23,SWEET GLOBE,Clam
Unknown Exporter,24A8785802,02/12/2025,Sale,-80.0,240.0,25,SWEET GLOBE,Clam
Unknown Exporter,24A8785802,02/12/2025,Sale,-80.0,160.0,25,SWEET GLOBE,Clam
Unknown Exporter,24A8785802,02/15/2025,Sale,-80.0,80.0,28,SWEET GLOBE,Clam
Unknown Exporter,24A8785802,02/21/2025,Sale,-80.0,0.0,34,SWEET GLOBE,Clam
Unknown Exporter,24A9028204,01/18/2025,Entry,1280.0,1280.0,0,ALLISON,Clam
Unknown Exporter,24A9028204,01/18/2025,Entry,160.0,1440.0,0,ALLISON,Clam
Unknown Exporter,24A9028204,01/18/2025,Entry,160.0,1600.0,0,ALLISON,Clam
Unknown Exporter,24A9028204,01/27/2025,Sale,-80.0,1520.0,9,ALLISON,Clam
Unknown Exporter,24A9028204,01/30/2025,Sale,-1040.0,480.0,12,ALLISON,Clam
Unknown Exporter,24A9028204,02/01/2025,Sale,-80.0,400.0,14,ALLISON,Clam
Unknown Exporter,24A9028204,02/05/2025,Sale,-80.0,320.0,18,ALLISON,Clam
Unknown Exporter,24A9028204,02/06/2025,Sale,-80.0,240.0,19,ALLISON,Clam
Unknown Exporter,24A9028204,02/13/2025,Sale,-160.0,80.0,26,ALLISON,Clam
Unknown Exporter,24A9028204,02/27/2025,Sale,-80.0,0.0,40,ALLISON,Clam
Unknown Exporter,24A9035905,01/18/2025,Entry,1520.0,1520.0,0,CANDY SNAP,Clam
Unknown Exporter,24A9035905,01/18/2025,Entry,80.0,1600.0,0,CANDY SNAP,Clam
Unknown Exporter,24A9035905,02/10/2025,Sale,-990.0,610.0,23,CANDY SNAP,Clam
Unknown Exporter,24A9035905,02/12/2025,Sale,-361.0,249.0,25,CANDY SNAP,Clam
Unknown Exporter,24A9035905,03/27/2025,Sale,-80.0,169.0,68,CANDY SNAP,Clam
Unknown Exporter,24A9045351,01/18/2025,Entry,1520.0,1520.0,0,SWEET GLOBE,Clam
Unknown Exporter,24A9045351,01/18/2025,Entry,80.0,1600.0,0,SWEET GLOBE,Clam
Unknown Exporter,24A9045351,02/06/2025,Sale,-80.0,1520.0,19,SWEET GLOBE,Clam
Unknown Exporter,24A9045351,02/06/2025,Sale,-240.0,1280.0,19,SWEET GLOBE,Clam
Unknown Exporter,24A9045351,02/06/2025,Sale,-80.0,1200.0,19,SWEET GLOBE,Clam
Unknown Exporter,24A9045351,02/08/2025,Sale,-80.0,1120.0,21,SWEET GLOBE,Clam
Unknown Exporter,24A9045351,02/08/2025,Sale,-240.0,880.0,21,SWEET GLOBE,Clam
Unknown Exporter,24A9045351,02/08/2025,Sale,-174.0,706.0,21,SWEET GLOBE,Clam
Unknown Exporter,24A9045351,02/10/2025,Sale,-480.0,226.0,23,SWEET GLOBE,Clam
Unknown Exporter,24A9045351,02/11/2025,Sale,-66.0,160.0,24,SWEET GLOBE,Clam
Unknown Exporter,24A9045351,02/21/2025,Sale,-80.0,80.0,34,SWEET GLOBE,Clam
Unknown Exporter,24A9045351,02/25/2025,Sale,-50.0,30.0,38,SWEET GLOBE,Clam
Unknown Exporter,24A9074060,01/18/2025,Entry,1440.0,1440.0,0,SWEET GLOBE,Clam
Unknown Exporter,24A9074060,01/18/2025,Entry,80.0,1520.0,0,SWEET GLOBE,Clam
Unknown Exporter,24A9074060,01/18/2025,Entry,80.0,1600.0,0,SWEET GLOBE,Clam
Unknown Exporter,24A9074060,01/21/2025,Sale,-80.0,1520.0,3,SWEET GLOBE,Clam
Unknown Exporter,24A9074060,01/21/2025,Sale,-80.0,1440.0,3,SWEET GLOBE,Clam
Unknown Exporter,24A9074060,01/23/2025,Sale,-1120.0,320.0,5,SWEET GLOBE,Clam
Unknown Exporter,24A9074060,01/23/2025,Sale,-320.0,0.0,5,SWEET GLOBE,Clam
Unknown Exporter,24A9115832,01/17/2025,Sale,-560.0,-560.0,0,ALLISON,Clam
Unknown Exporter,24A9115832,01/18/2025,Entry,1040.0,480.0,1,ALLISON,Clam
Unknown Exporter,24A9115832,01/18/2025,Entry,560.0,1040.0,1,ALLISON,Clam
Unknown Exporter,24A9115832,01/18/2025,Sale,-560.0,480.0,1,ALLISON,Clam
Unknown Exporter,24A9115832,01/18/2025,Sale,-480.0,0.0,1,ALLISON,Clam
Unknown Exporter,24A9117460,01/17/2025,Sale,-640.0,-640.0,0,IVORY,Clam
Unknown Exporter,24A9117460,01/18/2025,Entry,960.0,320.0,1,IVORY,Clam
Unknown Exporter,24A9117460,01/18/2025,Entry,640.0,960.0,1,IVORY,Clam
Unknown Exporter,24A9117460,01/23/2025,Sale,-960.0,0.0,6,IVORY,Clam
Unknown Exporter,24A9120320,01/17/2025,Sale,-480.0,-480.0,0,IVORY,Clam
Unknown Exporter,24A9120320,01/18/2025,Entry,1120.0,640.0,1,IVORY,Clam
Unknown Exporter,24A9120320,01/18/2025,Entry,480.0,1120.0,1,IVORY,Clam
Unknown Exporter,24A9120320,01/18/2025,Sale,-640.0,480.0,1,IVORY,Clam
Unknown Exporter,24A9120320,01/23/2025,Sale,-480.0,0.0,6,IVORY,Clam
Unknown Exporter,24A9162603,01/21/2025,Entry,1440.0,1440.0,0,CANDY SNAP,Clam
Unknown Exporter,24A9162603,01/21/2025,Entry,160.0,1600.0,0,CANDY SNAP,Clam
Unknown Exporter,24A9162603,01/29/2025,Sale,-80.0,1520.0,8,CANDY SNAP,Clam
Unknown Exporter,24A9162603,01/29/2025,Sale,-320.0,1200.0,8,CANDY SNAP,Clam
Unknown Exporter,24A9162603,02/03/2025,Sale,-160.0,1040.0,13,CANDY SNAP,Clam
Unknown Exporter,24A9162603,03/03/2025,Sale,-780.0,260.0,41,CANDY SNAP,Clam
Unknown Exporter,24A9162603,03/04/2025,Sale,-40.0,220.0,42,CANDY SNAP,Clam
Unknown Exporter,24A9162603,03/06/2025,Sale,-40.0,180.0,44,CANDY SNAP,Clam
Unknown Exporter,24A9179728,01/18/2025,Entry,1440.0,1440.0,0,ALLISON,Clam
Unknown Exporter,24A9179728,01/18/2025,Entry,160.0,1600.0,0,ALLISON,Clam
Unknown Exporter,24A9179728,01/29/2025,Sale,-400.0,1200.0,11,ALLISON,Clam
Unknown Exporter,24A9179728,01/30/2025,Sale,-80.0,1120.0,12,ALLISON,Clam
Unknown Exporter,24A9179728,01/31/2025,Sale,-80.0,1040.0,13,ALLISON,Clam
Unknown Exporter,24A9179728,02/01/2025,Sale,-640.0,400.0,14,ALLISON,Clam
Unknown Exporter,24A9179728,02/04/2025,Sale,-80.0,320.0,17,ALLISON,Clam
Unknown Exporter,24A9179728,02/05/2025,Sale,-80.0,240.0,18,ALLISON,Clam
Unknown Exporter,24A9179728,02/06/2025,Sale,-169.0,71.0,19,ALLISON,Clam
Unknown Exporter,24A9179728,02/13/2025,Sale,-80.0,-9.0,26,ALLISON,Clam
Unknown Exporter,24A9179728,03/14/2025,Sale,-50.0,-59.0,55,ALLISON,Clam
Unknown Exporter,24A9182402,01/18/2025,Entry,1440.0,1440.0,0,ALLISON,Clam
Unknown Exporter,24A9182402,01/18/2025,Entry,160.0,1600.0,0,ALLISON,Clam
Unknown Exporter,24A9182402,02/13/2025,Sale,-80.0,1520.0,26,ALLISON,Clam
Unknown Exporter,24A9182402,02/19/2025,Sale,-80.0,1440.0,32,ALLISON,Clam
Unknown Exporter,24A9182402,02/20/2025,Sale,-240.0,1200.0,33,ALLISON,Clam
Unknown Exporter,24A9182402,02/22/2025,Sale,-320.0,880.0,35,ALLISON,Clam
Unknown Exporter,24A9182402,02/24/2025,Sale,-320.0,560.0,37,ALLISON,Clam
Unknown Exporter,24A9182402,02/25/2025,Sale,-320.0,240.0,38,ALLISON,Clam
Unknown Exporter,24A9182402,02/27/2025,Sale,-80.0,160.0,40,ALLISON,Clam
Unknown Exporter,24A9182402,03/04/2025,Sale,-80.0,80.0,45,ALLISON,Clam
Unknown Exporter,24A9182402,03/07/2025,Sale,-80.0,0.0,48,ALLISON,Clam
Unknown Exporter,24A9185783,01/18/2025,Entry,1520.0,1520.0,0,SWEET GLOBE,Clam
Unknown Exporter,24A9185783,01/18/2025,Entry,80.0,1600.0,0,SWEET GLOBE,Clam
Unknown Exporter,24A9185783,01/29/2025,Sale,-80.0,1520.0,11,SWEET GLOBE,Clam
Unknown Exporter,24A9185783,01/29/2025,Sale,-240.0,1280.0,11,SWEET GLOBE,Clam
Unknown Exporter,24A9185783,01/30/2025,Sale,-480.0,800.0,12,SWEET GLOBE,Clam
Unknown Exporter,24A9185783,01/30/2025,Sale,-320.0,480.0,12,SWEET GLOBE,Clam
Unknown Exporter,24A9185783,01/30/2025,Sale,-80.0,400.0,12,SWEET GLOBE,Clam
Unknown Exporter,24A9185783,02/03/2025,Sale,-320.0,80.0,16,SWEET GLOBE,Clam
Unknown Exporter,24A9185783,02/04/2025,Sale,-80.0,0.0,17,SWEET GLOBE,Clam
Unknown Exporter,24A9231999,01/21/2025,Entry,1200.0,1200.0,0,ALLISON,Clam
Unknown Exporter,24A9231999,01/21/2025,Entry,400.0,1600.0,0,ALLISON,Clam
Unknown Exporter,24A9231999,02/03/2025,Sale,-400.0,1200.0,13,ALLISON,Clam
Unknown Exporter,24A9231999,02/06/2025,Sale,-80.0,1120.0,16,ALLISON,Clam
Unknown Exporter,24A9231999,02/11/2025,Sale,-80.0,1040.0,21,ALLISON,Clam
Unknown Exporter,24A9231999,02/12/2025,Sale,-400.0,640.0,22,ALLISON,Clam
Unknown Exporter,24A9231999,02/13/2025,Sale,-160.0,480.0,23,ALLISON,Clam
Unknown Exporter,24A9231999,02/13/2025,Sale,-80.0,400.0,23,ALLISON,Clam
Unknown Exporter,24A9231999,02/14/2025,Sale,-320.0,80.0,24,ALLISON,Clam
Unknown Exporter,24A9231999,02/17/2025,Sale,-80.0,0.0,27,ALLISON,Clam
Unknown Exporter,24A9241830,01/18/2025,Entry,1440.0,1440.0,0,SWEET GLOBE,Clam
Unknown Exporter,24A9241830,01/18/2025,Entry,80.0,1520.0,0,SWEET GLOBE,Clam
Unknown Exporter,24A9241830,01/18/2025,Entry,80.0,1600.0,0,SWEET GLOBE,Clam
Unknown Exporter,24A9241830,02/07/2025,Sale,-240.0,1360.0,20,SWEET GLOBE,Clam
Unknown Exporter,24A9241830,02/07/2025,Sale,-80.0,1280.0,20,SWEET GLOBE,Clam
Unknown Exporter,24A9241830,02/08/2025,Sale,-640.0,640.0,21,SWEET GLOBE,Clam
Unknown Exporter,24A9241830,02/10/2025,Sale,-80.0,560.0,23,SWEET GLOBE,Clam
Unknown Exporter,24A9241830,02/10/2025,Sale,-80.0,480.0,23,SWEET GLOBE,Clam
Unknown Exporter,24A9241830,02/10/2025,Sale,-80.0,400.0,23,SWEET GLOBE,Clam
Unknown Exporter,24A9241830,02/10/2025,Sale,-80.0,320.0,23,SWEET GLOBE,Clam
Unknown Exporter,24A9241830,02/11/2025,Sale,-80.0,240.0,24,SWEET GLOBE,Clam
Unknown Exporter,24A9241830,02/15/2025,Sale,-80.0,160.0,28,SWEET GLOBE,Clam
Unknown Exporter,24A9241830,02/21/2025,Sale,-80.0,80.0,34,SWEET GLOBE,Clam
Unknown Exporter,24A9241830,02/28/2025,Sale,-40.0,40.0,41,SWEET GLOBE,Clam
Unknown Exporter,24A9314793,01/18/2025,Entry,1440.0,1440.0,0,IVORY,Clam
Unknown Exporter,24A9314793,01/18/2025,Entry,80.0,1520.0,0,IVORY,Clam
Unknown Exporter,24A9314793,01/18/2025,Entry,80.0,1600.0,0,SWEET GLOBE,Clam
Unknown Exporter,24A9314793,01/21/2025,Sale,-480.0,1120.0,3,IVORY,Clam
Unknown Exporter,24A9314793,01/21/2025,Sale,-880.0,240.0,3,IVORY,Clam
Unknown Exporter,24A9314793,01/21/2025,Sale,-80.0,160.0,3,IVORY,Clam
Unknown Exporter,24A9314793,01/21/2025,Sale,-80.0,80.0,3,SWEET GLOBE,Clam
Unknown Exporter,24A9314793,01/31/2025,Sale,-80.0,0.0,13,IVORY,Clam
Unknown Exporter,24A9329664,01/18/2025,Entry,1280.0,1280.0,0,SWEET GLOBE,Clam
Unknown Exporter,24A9329664,01/18/2025,Entry,80.0,1360.0,0,SWEET GLOBE,Clam
Unknown Exporter,24A9329664,01/18/2025,Entry,240.0,1600.0,0,SWEET GLOBE,Clam
Unknown Exporter,24A9329664,01/28/2025,Sale,-560.0,1040.0,10,SWEET GLOBE,Clam
Unknown Exporter,24A9329664,01/28/2025,Sale,-560.0,480.0,10,SWEET GLOBE,Clam
Unknown Exporter,24A9329664,01/28/2025,Sale,-160.0,320.0,10,SWEET GLOBE,Clam
Unknown Exporter,24A9329664,01/28/2025,Sale,-80.0,240.0,10,SWEET GLOBE,Clam
Unknown Exporter,24A9329664,01/29/2025,Sale,-80.0,160.0,11,SWEET GLOBE,Clam
Unknown Exporter,24A9329664,01/30/2025,Sale,-80.0,80.0,12,SWEET GLOBE,Clam
Unknown Exporter,24A9329664,02/07/2025,Sale,-80.0,0.0,20,SWEET GLOBE,Clam
Unknown Exporter,24A9394206,01/18/2025,Entry,80.0,80.0,0,IVORY,Clam
Unknown Exporter,24A9394206,01/18/2025,Entry,1280.0,1360.0,0,SWEET GLOBE,Clam
Unknown Exporter,24A9394206,01/18/2025,Entry,80.0,1440.0,0,SWEET GLOBE,Clam
Unknown Exporter,24A9394206,01/18/2025,Entry,160.0,1600.0,0,SWEET GLOBE,Clam
Unknown Exporter,24A9394206,01/20/2025,Sale,-80.0,1520.0,2,SWEET GLOBE,Clam
Unknown Exporter,24A9394206,01/21/2025,Sale,-80.0,1440.0,3,IVORY,Clam
Unknown Exporter,24A9394206,01/21/2025,Sale,-400.0,1040.0,3,SWEET GLOBE,Clam
Unknown Exporter,24A9394206,01/21/2025,Sale,-160.0,880.0,3,SWEET GLOBE,Clam
Unknown Exporter,24A9394206,01/29/2025,Sale,-80.0,800.0,11,SWEET GLOBE,Clam
Unknown Exporter,24A9394206,01/30/2025,Sale,-400.0,400.0,12,SWEET GLOBE,Clam
Unknown Exporter,24A9394206,02/03/2025,Sale,-240.0,160.0,16,SWEET GLOBE,Clam
Unknown Exporter,24A9394206,02/04/2025,Sale,-160.0,0.0,17,SWEET GLOBE,Clam
Unknown Exporter,24A9436294,03/04/2025,Entry,1360.0,1360.0,0,IVORY,Clam
Unknown Exporter,24A9436294,03/04/2025,Entry,240.0,1600.0,0,IVORY,Clam
Unknown Exporter,24A9436294,03/04/2025,Sale,-160.0,1440.0,0,IVORY,Clam
Unknown Exporter,24A9436294,03/04/2025,Sale,-160.0,1280.0,0,IVORY,Clam
Unknown Exporter,24A9436294,03/12/2025,Sale,-800.0,480.0,8,IVORY,Clam
Unknown Exporter,24A9436294,03/22/2025,Sale,-160.0,320.0,18,IVORY,Clam
Unknown Exporter,24A9436294,03/29/2025,Sale,-20.0,300.0,25,IVORY,Clam
Unknown Exporter,24A9436294,03/29/2025,Sale,-120.0,180.0,25,IVORY,Clam
Unknown Exporter,24A9467829,01/18/2025,Entry,1200.0,1200.0,0,IVORY,Clam
Unknown Exporter,24A9467829,01/18/2025,Entry,240.0,1440.0,0,IVORY,Clam
Unknown Exporter,24A9467829,01/18/2025,Entry,160.0,1600.0,0,IVORY,Clam
Unknown Exporter,24A9467829,02/10/2025,Sale,-160.0,1440.0,23,IVORY,Clam
Unknown Exporter,24A9467829,02/10/2025,Sale,-80.0,1360.0,23,IVORY,Clam
Unknown Exporter,24A9467829,02/12/2025,Sale,-160.0,1200.0,25,IVORY,Clam
Unknown Exporter,24A9467829,02/12/2025,Sale,-80.0,1120.0,25,IVORY,Clam
Unknown Exporter,24A9467829,02/13/2025,Sale,-560.0,560.0,26,IVORY,Clam
Unknown Exporter,24A9467829,02/15/2025,Sale,-13.0,547.0,28,IVORY,Clam
Unknown Exporter,24A9467829,02/15/2025,Sale,-65.0,482.0,28,IVORY,Clam
Unknown Exporter,24A9542882,01/18/2025,Entry,1360.0,1360.0,0,ALLISON,Clam
Unknown Exporter,24A9542882,01/18/2025,Entry,240.0,1600.0,0,ALLISON,Clam
Unknown Exporter,24A9542882,02/12/2025,Sale,-80.0,1520.0,25,ALLISON,Clam
Unknown Exporter,24A9542882,02/14/2025,Sale,-80.0,1440.0,27,ALLISON,Clam
Unknown Exporter,24A9542882,02/19/2025,Sale,-80.0,1360.0,32,ALLISON,Clam
Unknown Exporter,24A9542882,02/20/2025,Sale,-160.0,1200.0,33,ALLISON,Clam
Unknown Exporter,24A9542882,02/27/2025,Sale,-80.0,1120.0,40,ALLISON,Clam
Unknown Exporter,24A9542882,03/03/2025,Sale,-160.0,960.0,44,ALLISON,Clam
Unknown Exporter,24A9542882,03/04/2025,Sale,-80.0,880.0,45,ALLISON,Clam
Unknown Exporter,24A9542882,03/06/2025,Sale,-160.0,720.0,47,ALLISON,Clam
Unknown Exporter,24A9542882,03/07/2025,Sale,-560.0,160.0,48,ALLISON,Clam
Unknown Exporter,24A9542882,03/07/2025,Sale,-80.0,80.0,48,ALLISON,Clam
Unknown Exporter,24A9542882,03/08/2025,Sale,-80.0,0.0,49,ALLISON,Clam
Unknown Exporter,24A9558209,01/18/2025,Entry,1440.0,1440.0,0,SWEET GLOBE,Clam
Unknown Exporter,24A9558209,01/18/2025,Entry,80.0,1520.0,0,SWEET GLOBE,Clam
Unknown Exporter,24A9558209,01/18/2025,Entry,80.0,1600.0,0,SWEET GLOBE,Clam
Unknown Exporter,24A9558209,01/21/2025,Sale,-720.0,880.0,3,SWEET GLOBE,Clam
Unknown Exporter,24A9558209,01/21/2025,Sale,-160.0,720.0,3,SWEET GLOBE,Clam
Unknown Exporter,24A9558209,01/21/2025,Sale,-80.0,640.0,3,SWEET GLOBE,Clam
Unknown Exporter,24A9558209,01/21/2025,Sale,-80.0,560.0,3,SWEET GLOBE,Clam
Unknown Exporter,24A9558209,01/23/2025,Sale,-560.0,0.0,5,SWEET GLOBE,Clam
Unknown Exporter,24A9563000,01/18/2025,Entry,1120.0,1120.0,0,IVORY,Clam
Unknown Exporter,24A9563000,01/18/2025,Entry,160.0,1280.0,0,IVORY,Clam
Unknown Exporter,24A9563000,01/18/2025,Entry,320.0,1600.0,0,IVORY,Clam
Unknown Exporter,24A9563000,01/25/2025,Sale,-80.0,1520.0,7,IVORY,Clam
Unknown Exporter,24A9563000,01/28/2025,Sale,-80.0,1440.0,10,IVORY,Clam
Unknown Exporter,24A9563000,01/31/2025,Sale,-919.0,521.0,13,IVORY,Clam
Unknown Exporter,24A9563000,02/03/2025,Sale,-135.0,386.0,16,IVORY,Clam
Unknown Exporter,24A9563000,02/03/2025,Sale,-160.0,226.0,16,IVORY,Clam
Unknown Exporter,24A9593553,01/18/2025,Entry,1440.0,1440.0,0,SWEET GLOBE,Clam
Unknown Exporter,24A9593553,01/18/2025,Entry,160.0,1600.0,0,SWEET GLOBE,Clam
Unknown Exporter,24A9593553,02/07/2025,Sale,-160.0,1440.0,20,SWEET GLOBE,Clam
Unknown Exporter,24A9593553,02/10/2025,Sale,-80.0,1360.0,23,SWEET GLOBE,Clam
Unknown Exporter,24A9593553,02/10/2025,Sale,-400.0,960.0,23,SWEET GLOBE,Clam
Unknown Exporter,24A9593553,02/10/2025,Sale,-160.0,800.0,23,SWEET GLOBE,Clam
Unknown Exporter,24A9593553,02/10/2025,Sale,-320.0,480.0,23,SWEET GLOBE,Clam
Unknown Exporter,24A9593553,02/10/2025,Sale,-80.0,400.0,23,SWEET GLOBE,Clam
Unknown Exporter,24A9593553,02/10/2025,Sale,-80.0,320.0,23,SWEET GLOBE,Clam
Unknown Exporter,24A9593553,02/11/2025,Sale,-80.0,240.0,24,SWEET GLOBE,Clam
Unknown Exporter,24A9593553,02/14/2025,Sale,-80.0,160.0,27,SWEET GLOBE,Clam
Unknown Exporter,24A9593553,02/15/2025,Sale,-80.0,80.0,28,SWEET GLOBE,Clam
Unknown Exporter,24A9593553,03/05/2025,Sale,-40.0,40.0,46,SWEET GLOBE,Clam
Unknown Exporter,24A9707545,01/18/2025,Entry,1440.0,1440.0,0,ALLISON,Clam
Unknown Exporter,24A9707545,01/18/2025,Entry,160.0,1600.0,0,ALLISON,Clam
Unknown Exporter,24A9707545,01/28/2025,Sale,-240.0,1360.0,10,ALLISON,Clam
Unknown Exporter,24A9707545,01/28/2025,Sale,-80.0,1280.0,10,ALLISON,Clam
Unknown Exporter,24A9707545,01/30/2025,Sale,-320.0,960.0,12,ALLISON,Clam
Unknown Exporter,24A9707545,02/03/2025,Sale,-160.0,800.0,16,ALLISON,Clam
Unknown Exporter,24A9707545,02/05/2025,Sale,-80.0,720.0,18,ALLISON,Clam
Unknown Exporter,24A9707545,02/06/2025,Sale,-80.0,640.0,19,ALLISON,Clam
Unknown Exporter,24A9707545,02/10/2025,Sale,-80.0,560.0,23,ALLISON,Clam
Unknown Exporter,24A9707545,02/12/2025,Sale,-320.0,240.0,25,ALLISON,Clam
Unknown Exporter,24A9707545,02/14/2025,Sale,-160.0,80.0,27,ALLISON,Clam
Unknown Exporter,24A9707545,02/27/2025,Sale,-80.0,0.0,40,ALLISON,Clam
Unknown Exporter,24A9728202,01/21/2025,Entry,1360.0,1360.0,0,ALLISON,Clam
Unknown Exporter,24A9728202,01/21/2025,Entry,240.0,1600.0,0,ALLISON,Clam
Unknown Exporter,24A9728202,01/30/2025,Sale,-480.0,1120.0,9,ALLISON,Clam
Unknown Exporter,24A9728202,02/01/2025,Sale,-80.0,1040.0,11,ALLISON,Clam
Unknown Exporter,24A9728202,02/01/2025,Sale,-80.0,960.0,11,ALLISON,Clam
Unknown Exporter,24A9728202,02/03/2025,Sale,-240.0,720.0,13,ALLISON,Clam
Unknown Exporter,24A9728202,02/05/2025,Sale,-80.0,640.0,15,ALLISON,Clam
Unknown Exporter,24A9728202,02/06/2025,Sale,-80.0,560.0,16,ALLISON,Clam
Unknown Exporter,24A9728202,02/07/2025,Sale,-160.0,400.0,17,ALLISON,Clam
Unknown Exporter,24A9728202,02/10/2025,Sale,-80.0,320.0,20,ALLISON,Clam
Unknown Exporter,24A9728202,02/11/2025,Sale,-80.0,240.0,21,ALLISON,Clam
Unknown Exporter,24A9728202,02/14/2025,Sale,-240.0,0.0,24,ALLISON,Clam
Unknown Exporter,24A9820170,01/18/2025,Entry,1200.0,1200.0,0,CANDY SNAP,Clam
Unknown Exporter,24A9820170,01/18/2025,Entry,400.0,1600.0,0,CANDY SNAP,Clam
Unknown Exporter,24A9820170,01/29/2025,Sale,-640.0,960.0,11,CANDY SNAP,Clam
Unknown Exporter,24A9820170,01/29/2025,Sale,-320.0,640.0,11,CANDY SNAP,Clam
Unknown Exporter,24A9820170,01/29/2025,Sale,-240.0,400.0,11,CANDY SNAP,Clam
Unknown Exporter,24A9820170,01/30/2025,Sale,-240.0,160.0,12,CANDY SNAP,Clam
Unknown Exporter,24A9820170,02/03/2025,Sale,-80.0,80.0,16,CANDY SNAP,Clam
Unknown Exporter,24A9820170,02/18/2025,Sale,-6.0,74.0,31,CANDY SNAP,Clam
Unknown Exporter,24A9820170,02/19/2025,Sale,-64.0,10.0,32,CANDY SNAP,Clam
Unknown Exporter,24A9884658,01/18/2025,Entry,1280.0,1280.0,0,IVORY,Clam
Unknown Exporter,24A9884658,01/18/2025,Entry,320.0,1600.0,0,IVORY,Clam
Unknown Exporter,24A9884658,01/20/2025,Sale,-960.0,640.0,2,IVORY,Clam
Unknown Exporter,24A9884658,01/21/2025,Sale,-320.0,320.0,3,IVORY,Clam
Unknown Exporter,24A9884658,01/21/2025,Sale,-320.0,0.0,3,IVORY,Clam
Unknown Exporter,24A9891773,01/17/2025,Sale,-160.0,-160.0,0,ALLISON,Clam
Unknown Exporter,24A9891773,01/18/2025,Entry,1440.0,1280.0,1,ALLISON,Clam
Unknown Exporter,24A9891773,01/18/2025,Entry,160.0,1440.0,1,ALLISON,Clam
Unknown Exporter,24A9891773,01/18/2025,Sale,-160.0,1280.0,1,ALLISON,Clam
Unknown Exporter,24A9891773,01/20/2025,Sale,-960.0,320.0,3,ALLISON,Clam
Unknown Exporter,24A9891773,01/21/2025,Sale,-160.0,160.0,4,ALLISON,Clam
Unknown Exporter,24A9891773,02/03/2025,Sale,-160.0,0.0,17,ALLISON,Clam
Unknown Exporter,24A9946858,01/21/2025,Entry,1120.0,1120.0,0,ALLISON,Clam
Unknown Exporter,24A9946858,01/21/2025,Entry,480.0,1600.0,0,ALLISON,Clam
Unknown Exporter,24A9946858,01/28/2025,Sale,-160.0,1440.0,7,ALLISON,Clam
Unknown Exporter,24A9946858,01/30/2025,Sale,-80.0,1360.0,9,ALLISON,Clam
Unknown Exporter,24A9946858,02/01/2025,Sale,-80.0,1280.0,11,ALLISON,Clam
Unknown Exporter,24A9946858,02/01/2025,Sale,-2.0,1278.0,11,ALLISON,Clam
Unknown Exporter,24A9946858,02/03/2025,Sale,-320.0,958.0,13,ALLISON,Clam
Unknown Exporter,24A9946858,02/04/2025,Sale,-80.0,878.0,14,ALLISON,Clam
Unknown Exporter,24A9946858,02/04/2025,Sale,-80.0,798.0,14,ALLISON,Clam
Unknown Exporter,24A9946858,02/05/2025,Sale,-80.0,718.0,15,ALLISON,Clam
Unknown Exporter,24A9946858,02/06/2025,Sale,-240.0,478.0,16,ALLISON,Clam
Unknown Exporter,24A9946858,02/07/2025,Sale,-80.0,398.0,17,ALLISON,Clam
Unknown Exporter,24A9946858,02/10/2025,Sale,-80.0,318.0,20,ALLISON,Clam
Unknown Exporter,24A9946858,02/12/2025,Sale,-80.0,238.0,22,ALLISON,Clam
Unknown Exporter,24A9946858,02/14/2025,Sale,-240.0,-2.0,24,ALLISON,Clam
Unknown Exporter,24V850559,03/13/2025,Sale,-96.0,-96.0,0,JACK SALUTE,Bag
VIDEXPORT,25E22252,05/13/2025,Entry,1760.0,1760.0,0,EARLY SWEET,
VIDEXPORT,25E22252,05/13/2025,Entry,400.0,2160.0,0,EARLY SWEET,
VIDEXPORT,25E22254,05/13/2025,Entry,1440.0,1440.0,0,EARLY SWEET,
